"","Name","Sex","Count2015","Count2016","total"
"1","Aaban","M",15,9,24
"2","Aabha","F",7,7,14
"3","Aabriella","F",5,11,16
"4","Aadam","M",22,18,40
"5","Aadarsh","M",15,11,26
"6","Aaden","M",297,194,491
"7","Aadhav","M",31,28,59
"8","Aadhavan","M",5,6,11
"9","Aadhi","M",11,5,16
"10","Aadhira","F",8,14,22
"11","Aadhvik","M",9,19,28
"12","Aadhya","F",265,284,549
"13","Aadi","M",43,55,98
"14","Aadil","M",14,15,29
"15","Aadit","M",23,23,46
"16","Aadith","M",11,11,22
"17","Aadithya","M",6,5,11
"18","Aaditya","M",33,34,67
"19","Aadon","M",8,9,17
"20","Aadvik","M",28,83,111
"21","Aadvika","F",7,13,20
"22","Aadya","F",159,159,318
"23","Aadyn","M",29,51,80
"24","Aagam","M",5,7,12
"25","Aahaan","M",10,5,15
"26","Aahan","M",26,36,62
"27","Aahana","F",31,51,82
"28","Aahil","M",78,81,159
"29","Aaiden","M",89,71,160
"30","Aaidyn","M",11,5,16
"31","Aaila","F",7,11,18
"32","Aailyah","F",6,6,12
"33","Aaima","F",12,21,33
"34","Aaira","F",24,31,55
"35","Aairah","F",19,28,47
"36","Aaisha","F",11,7,18
"37","Aakash","M",17,21,38
"38","Aakriti","F",8,5,13
"39","Aala","F",6,9,15
"40","Aalaiyah","F",11,10,21
"41","Aalani","F",17,16,33
"42","Aalaya","F",9,7,16
"43","Aalayah","F",70,66,136
"44","Aalayiah","F",8,5,13
"45","Aalaysia","F",9,9,18
"46","Aaleah","F",11,16,27
"47","Aaleeyah","F",11,9,20
"48","Aaleigha","F",9,7,16
"49","Aaleyah","F",153,104,257
"50","Aalia","F",33,46,79
"51","Aaliah","F",46,32,78
"52","Aaliana","F",6,5,11
"53","Aalijah","F",12,8,20
"54","Aalijah","M",17,11,28
"55","Aalina","F",9,6,15
"56","Aaliya","F",64,57,121
"57","Aaliyah","F",4850,4611,9461
"58","Aaliyahrose","F",5,5,10
"59","Aaliyana","F",6,8,14
"60","Aaliyiah","F",5,5,10
"61","Aalyah","F",23,14,37
"62","Aalyiah","F",23,23,46
"63","Aamanee","F",5,5,10
"64","Aamani","F",7,23,30
"65","Aamari","F",9,5,14
"66","Aamari","M",7,14,21
"67","Aamilah","F",12,15,27
"68","Aamina","F",24,24,48
"69","Aaminah","F",42,27,69
"70","Aamir","M",143,132,275
"71","Aamira","F",37,25,62
"72","Aamirah","F",15,10,25
"73","Aamiya","F",5,8,13
"74","Aamiyah","F",25,30,55
"75","Aamna","F",6,11,17
"76","Aamori","F",7,6,13
"77","Aanaya","F",8,14,22
"78","Aania","F",5,6,11
"79","Aanika","F",24,20,44
"80","Aaniya","F",17,27,44
"81","Aaniyah","F",54,48,102
"82","Aanshi","F",12,13,25
"83","Aanvi","F",47,41,88
"84","Aanya","F",240,214,454
"85","Aaqil","M",7,7,14
"86","Aara","F",15,13,28
"87","Aaradhana","F",8,13,21
"88","Aaradhya","F",81,102,183
"89","Aaralyn","F",72,73,145
"90","Aaralynn","F",22,13,35
"91","Aaran","M",17,9,26
"92","Aarav","M",539,519,1058
"93","Aaravi","F",7,5,12
"94","Aaren","M",22,31,53
"95","Aaria","F",36,62,98
"96","Aariah","F",26,32,58
"97","Aarian","F",8,5,13
"98","Aarian","M",13,17,30
"99","Aariana","F",27,16,43
"100","Aarianna","F",10,18,28
"101","Aarib","M",10,12,22
"102","Aaric","M",28,35,63
"103","Aariel","F",11,11,22
"104","Aarielle","F",11,7,18
"105","Aarik","M",6,14,20
"106","Aarika","F",23,9,32
"107","Aarilyn","F",14,9,23
"108","Aarilynn","F",5,5,10
"109","Aarin","M",27,31,58
"110","Aarini","F",8,9,17
"111","Aarion","M",15,8,23
"112","Aariona","F",9,7,16
"113","Aaris","F",6,7,13
"114","Aarish","M",33,21,54
"115","Aarit","M",22,7,29
"116","Aariv","M",50,61,111
"117","Aariya","F",14,16,30
"118","Aariyah","F",57,69,126
"119","Aariyana","F",11,7,18
"120","Aariz","M",63,62,125
"121","Aarjav","M",6,7,13
"122","Aarna","F",147,148,295
"123","Aarnav","M",45,26,71
"124","Aarnavi","F",5,8,13
"125","Aaro","M",10,8,18
"126","Aarohi","F",88,84,172
"127","Aaron","F",19,22,41
"128","Aaron","M",7144,7118,14262
"129","Aarron","M",7,8,15
"130","Aaruhi","F",5,7,12
"131","Aarush","M",211,191,402
"132","Aarushi","F",35,29,64
"133","Aarvi","F",30,25,55
"134","Aarya","F",180,189,369
"135","Aarya","M",20,18,38
"136","Aaryah","F",10,7,17
"137","Aaryahi","F",5,7,12
"138","Aaryan","M",125,142,267
"139","Aaryana","F",11,8,19
"140","Aaryav","M",21,18,39
"141","Aaryn","F",46,57,103
"142","Aaryn","M",29,13,42
"143","Aasha","F",15,9,24
"144","Aashi","F",50,50,100
"145","Aashika","F",7,11,18
"146","Aashir","M",7,12,19
"147","Aashka","F",7,9,16
"148","Aashna","F",31,34,65
"149","Aashrith","M",8,12,20
"150","Aashritha","F",5,10,15
"151","Aashvi","F",72,63,135
"152","Aasia","F",11,5,16
"153","Aasim","M",15,21,36
"154","Aasir","M",16,17,33
"155","Aasiya","F",20,5,25
"156","Aasiyah","F",20,38,58
"157","Aason","M",7,8,15
"158","Aastha","F",7,7,14
"159","Aava","F",11,10,21
"160","Aavah","F",7,8,15
"161","Aavash","M",5,5,10
"162","Aavin","M",6,6,12
"163","Aavya","F",24,80,104
"164","Aayaan","M",7,6,13
"165","Aayam","M",6,9,15
"166","Aayan","M",144,170,314
"167","Aayana","F",6,9,15
"168","Aayansh","M",42,34,76
"169","Aayat","F",16,21,37
"170","Aayden","M",179,135,314
"171","Aayla","F",27,36,63
"172","Aaylah","F",10,11,21
"173","Aayra","F",7,9,16
"174","Aayush","M",88,63,151
"175","Aayushi","F",11,9,20
"176","Aaziyah","F",5,5,10
"177","Abaan","M",6,8,14
"178","Abagail","F",103,72,175
"179","Abaigeal","F",5,9,14
"180","Abanoub","M",13,8,21
"181","Abas","M",5,6,11
"182","Abass","M",6,6,12
"183","Abba","M",5,5,10
"184","Abbagail","F",19,9,28
"185","Abbas","M",74,75,149
"186","Abbey","F",163,139,302
"187","Abbi","F",24,27,51
"188","Abbie","F",212,176,388
"189","Abbigail","F",258,223,481
"190","Abbigale","F",46,39,85
"191","Abbigayle","F",17,24,41
"192","Abbott","M",45,58,103
"193","Abby","F",721,724,1445
"194","Abbygail","F",149,110,259
"195","Abbygale","F",19,21,40
"196","Abbygayle","F",5,16,21
"197","Abcde","F",16,12,28
"198","Abdalla","M",12,13,25
"199","Abdallah","M",56,60,116
"200","Abdalrahman","M",11,11,22
"201","Abdel","M",17,19,36
"202","Abdelaziz","M",7,5,12
"203","Abdelrahman","M",26,21,47
"204","Abdi","M",10,8,18
"205","Abdias","M",33,48,81
"206","Abdiaziz","M",16,15,31
"207","Abdiel","M",254,328,582
"208","Abdifatah","M",16,20,36
"209","Abdihakim","M",6,6,12
"210","Abdikadir","M",13,5,18
"211","Abdimalik","M",20,22,42
"212","Abdinasir","M",14,7,21
"213","Abdirahim","M",8,5,13
"214","Abdirahman","M",117,108,225
"215","Abdirashid","M",5,5,10
"216","Abdirizak","M",9,6,15
"217","Abdishakur","M",8,6,14
"218","Abdou","M",7,13,20
"219","Abdoul","M",27,23,50
"220","Abdoulaye","M",36,29,65
"221","Abdul","M",122,127,249
"222","Abdulahad","M",9,12,21
"223","Abdulahi","M",25,25,50
"224","Abdulaziz","M",99,87,186
"225","Abdulhadi","M",18,8,26
"226","Abdulhamid","M",5,9,14
"227","Abdulkadir","M",8,7,15
"228","Abdulkareem","M",7,10,17
"229","Abdulkarim","M",8,9,17
"230","Abdulkhaliq","M",5,8,13
"231","Abdulla","M",5,15,20
"232","Abdullah","M",394,406,800
"233","Abdullahi","M",83,98,181
"234","Abdulloh","M",6,6,12
"235","Abdulmalik","M",36,32,68
"236","Abdulqadir","M",6,6,12
"237","Abdulraheem","M",9,9,18
"238","Abdulrahman","M",138,154,292
"239","Abdulsamad","M",9,6,15
"240","Abdulwahab","M",15,6,21
"241","Abdur","M",6,10,16
"242","Abdurahman","M",18,19,37
"243","Abdurrahman","M",38,40,78
"244","Abe","M",80,60,140
"245","Abeeha","F",9,15,24
"246","Abeer","F",10,8,18
"247","Abeer","M",9,11,20
"248","Abeera","F",11,6,17
"249","Abel","F",10,6,16
"250","Abel","M",3228,3015,6243
"251","Abela","F",6,5,11
"252","Abelardo","M",58,74,132
"253","Abelina","F",6,8,14
"254","Abelino","M",6,6,12
"255","Abella","F",73,78,151
"256","Abena","F",13,11,24
"257","Abenezer","M",20,13,33
"258","Aberdeen","F",18,12,30
"259","Abhay","M",38,49,87
"260","Abhi","M",14,13,27
"261","Abhigna","F",6,7,13
"262","Abhijot","M",6,6,12
"263","Abhimanyu","M",15,18,33
"264","Abhinav","M",57,67,124
"265","Abhiraj","M",6,8,14
"266","Abhiram","M",64,104,168
"267","Abhyuday","M",5,5,10
"268","Abi","F",15,25,40
"269","Abia","F",5,14,19
"270","Abiageal","F",7,6,13
"271","Abiah","F",6,9,15
"272","Abid","M",8,10,18
"273","Abie","M",6,7,13
"274","Abiel","M",71,62,133
"275","Abigael","F",42,56,98
"276","Abigaelle","F",17,17,34
"277","Abigail","F",12371,11699,24070
"278","Abigail","M",10,10,20
"279","Abigaile","F",19,17,36
"280","Abigal","F",15,12,27
"281","Abigale","F",114,106,220
"282","Abigayl","F",8,5,13
"283","Abigayle","F",108,68,176
"284","Abiha","F",11,13,24
"285","Abijah","M",10,17,27
"286","Abilene","F",69,92,161
"287","Abimael","M",46,41,87
"288","Abinav","M",6,5,11
"289","Abiola","F",6,5,11
"290","Abir","M",25,37,62
"291","Abisai","F",13,25,38
"292","Abisai","M",30,30,60
"293","Abisha","F",5,12,17
"294","Abishai","M",10,18,28
"295","Abisola","F",7,7,14
"296","Able","M",40,38,78
"297","Abner","M",199,198,397
"298","Aboubacar","M",25,17,42
"299","Abra","F",8,12,20
"300","Abrah","F",8,5,13
"301","Abraham","M",2438,2559,4997
"302","Abrahan","M",15,20,35
"303","Abrahim","M",18,25,43
"304","Abrahm","M",40,26,66
"305","Abram","M",835,856,1691
"306","Abran","M",27,20,47
"307","Abrar","F",16,15,31
"308","Abrar","M",17,15,32
"309","Abree","F",44,32,76
"310","Abri","F",15,15,30
"311","Abria","F",15,19,34
"312","Abrian","M",16,20,36
"313","Abriana","F",72,47,119
"314","Abrianna","F",128,103,231
"315","Abrie","F",22,16,38
"316","Abriel","F",16,13,29
"317","Abriel","M",39,35,74
"318","Abriela","F",5,5,10
"319","Abriella","F",139,127,266
"320","Abrielle","F",260,260,520
"321","Abril","F",274,316,590
"322","Abrina","F",6,6,12
"323","Abrish","F",29,14,43
"324","Abryana","F",9,7,16
"325","Abryanna","F",16,15,31
"326","Absalat","F",12,9,21
"327","Abshir","M",6,7,13
"328","Abu","M",7,5,12
"329","Abubakar","M",43,53,96
"330","Abubakr","M",33,33,66
"331","Aby","F",16,6,22
"332","Abyan","M",11,8,19
"333","Abygail","F",111,116,227
"334","Abygale","F",15,10,25
"335","Acacia","F",103,85,188
"336","Acadia","F",45,33,78
"337","Ace","F",7,6,13
"338","Ace","M",737,1034,1771
"339","Acelin","M",5,7,12
"340","Acelyn","F",29,24,53
"341","Acelynn","F",74,56,130
"342","Acen","M",30,39,69
"343","Aceson","M",20,51,71
"344","Acesyn","M",5,7,12
"345","Aceton","M",13,5,18
"346","Acey","F",5,6,11
"347","Aceyn","M",8,19,27
"348","Acheron","M",6,10,16
"349","Achilles","M",212,226,438
"350","Achillies","M",14,7,21
"351","Achol","F",10,5,15
"352","Achyut","M",5,9,14
"353","Achyuth","M",5,5,10
"354","Acie","M",7,7,14
"355","Ackley","M",7,7,14
"356","Acsa","F",6,7,13
"357","Acxel","M",6,8,14
"358","Ada","F",916,959,1875
"359","Adabella","F",13,12,25
"360","Adabelle","F",24,21,45
"361","Adael","M",24,32,56
"362","Adaeze","F",24,16,40
"363","Adah","F",90,81,171
"364","Adahlia","F",15,16,31
"365","Adaia","F",17,23,40
"366","Adaiah","F",31,24,55
"367","Adain","M",9,5,14
"368","Adair","F",20,20,40
"369","Adair","M",56,33,89
"370","Adaira","F",10,15,25
"371","Adalae","F",34,17,51
"372","Adalai","F",8,10,18
"373","Adalaide","F",20,29,49
"374","Adalay","F",14,22,36
"375","Adalaya","F",17,10,27
"376","Adalberto","M",29,22,51
"377","Adalea","F",6,9,15
"378","Adaleah","F",14,15,29
"379","Adalee","F",225,217,442
"380","Adaleen","F",13,14,27
"381","Adaleena","F",14,12,26
"382","Adalei","F",16,13,29
"383","Adaleia","F",6,5,11
"384","Adaleigh","F",126,128,254
"385","Adalen","F",7,6,13
"386","Adalena","F",42,38,80
"387","Adalene","F",46,34,80
"388","Adaley","F",30,27,57
"389","Adaleyza","F",7,8,15
"390","Adali","F",28,38,66
"391","Adalia","F",111,85,196
"392","Adaliah","F",18,12,30
"393","Adalida","F",12,24,36
"394","Adalie","F",150,143,293
"395","Adalin","F",33,40,73
"396","Adalina","F",131,153,284
"397","Adalind","F",89,123,212
"398","Adaline","F",902,1873,2775
"399","Adalinn","F",9,8,17
"400","Adalis","F",12,6,18
"401","Adalise","F",9,9,18
"402","Adaliyah","F",8,7,15
"403","Adaliz","F",22,13,35
"404","Adaly","F",61,58,119
"405","Adalyn","F",2452,2176,4628
"406","Adalyna","F",17,6,23
"407","Adalynd","F",12,14,26
"408","Adalyne","F",67,94,161
"409","Adalynn","F",2614,2585,5199
"410","Adalynne","F",107,107,214
"411","Adam","F",6,6,12
"412","Adam","M",5380,5176,10556
"413","Adama","F",24,19,43
"414","Adama","M",15,15,30
"415","Adamae","F",10,9,19
"416","Adamari","F",63,43,106
"417","Adamarie","F",10,6,16
"418","Adamaris","F",64,39,103
"419","Adamariz","F",8,12,20
"420","Adamary","F",8,12,20
"421","Adams","M",11,18,29
"422","Adan","F",12,7,19
"423","Adan","M",784,815,1599
"424","Adanna","F",17,31,48
"425","Adannaya","F",10,5,15
"426","Adanya","F",16,8,24
"427","Adaora","F",12,12,24
"428","Adar","M",5,5,10
"429","Adara","F",74,56,130
"430","Adarian","M",9,13,22
"431","Adarius","M",20,25,45
"432","Adarsh","M",20,23,43
"433","Adasyn","F",15,9,24
"434","Adaya","F",31,35,66
"435","Adayah","F",15,10,25
"436","Addalee","F",18,22,40
"437","Addaleigh","F",7,19,26
"438","Addalie","F",9,13,22
"439","Addaline","F",18,41,59
"440","Addalyn","F",255,256,511
"441","Addalyne","F",12,15,27
"442","Addalynn","F",218,216,434
"443","Addalynne","F",22,14,36
"444","Addasyn","F",6,6,12
"445","Addeline","F",36,51,87
"446","Addelyn","F",214,193,407
"447","Addelynn","F",81,84,165
"448","Addi","F",13,23,36
"449","Addicus","M",8,12,20
"450","Addie","F",226,181,407
"451","Addiel","M",12,6,18
"452","Addielynn","F",7,5,12
"453","Addilee","F",14,17,31
"454","Addileigh","F",5,5,10
"455","Addiline","F",6,7,13
"456","Addilyn","F",972,1033,2005
"457","Addilyne","F",8,12,20
"458","Addilynn","F",386,486,872
"459","Addilynne","F",15,10,25
"460","Addis","M",7,13,20
"461","Addisen","F",27,43,70
"462","Addison","F",6706,6295,13001
"463","Addison","M",153,153,306
"464","Addisyn","F",515,498,1013
"465","Addisynn","F",11,17,28
"466","Addley","F",19,24,43
"467","Addlyn","F",7,8,15
"468","Addlynn","F",8,7,15
"469","Addy","F",41,53,94
"470","Addylin","F",17,21,38
"471","Addyline","F",6,11,17
"472","Addylyn","F",6,9,15
"473","Addylynn","F",11,11,22
"474","Addysen","F",46,40,86
"475","Addysin","F",12,9,21
"476","Addyson","F",708,677,1385
"477","Addysyn","F",8,8,16
"478","Ade","M",11,15,26
"479","Adea","F",7,10,17
"480","Adebayo","M",6,8,14
"481","Adedamola","M",13,8,21
"482","Adedayo","M",11,8,19
"483","Adeeb","M",14,12,26
"484","Adeel","M",5,12,17
"485","Adeena","F",13,21,34
"486","Adel","F",24,16,40
"487","Adel","M",41,39,80
"488","Adela","F",226,202,428
"489","Adelae","F",10,13,23
"490","Adelai","F",15,16,31
"491","Adelaida","F",46,48,94
"492","Adelaide","F",1157,1227,2384
"493","Adelaine","F",22,28,50
"494","Adelay","F",5,5,10
"495","Adelaya","F",5,5,10
"496","Adelayda","F",6,5,11
"497","Adelayde","F",6,7,13
"498","Adele","F",442,443,885
"499","Adelei","F",8,5,13
"500","Adeleigh","F",11,9,20
"501","Adeleine","F",30,29,59
"502","Adelena","F",22,33,55
"503","Adelene","F",32,28,60
"504","Adelheid","F",10,16,26
"505","Adelia","F",83,91,174
"506","Adelie","F",40,35,75
"507","Adelin","F",43,40,83
"508","Adelina","F",569,624,1193
"509","Adelind","F",10,12,22
"510","Adeline","F",2403,4103,6506
"511","Adelinne","F",6,9,15
"512","Adelis","F",5,6,11
"513","Adelise","F",35,20,55
"514","Adelita","F",16,17,33
"515","Adeliz","F",8,6,14
"516","Adell","F",9,13,22
"517","Adella","F",70,69,139
"518","Adelle","F",85,84,169
"519","Adellyn","F",10,6,16
"520","Adely","F",9,17,26
"521","Adelyn","F",1677,1659,3336
"522","Adelyna","F",14,14,28
"523","Adelyne","F",56,84,140
"524","Adelynn","F",1138,1123,2261
"525","Adelynne","F",76,59,135
"526","Adem","M",49,48,97
"527","Ademide","M",7,12,19
"528","Ademola","M",7,8,15
"529","Aden","F",15,21,36
"530","Aden","M",867,692,1559
"531","Adena","F",11,11,22
"532","Adeola","F",15,12,27
"533","Adeoluwa","M",7,5,12
"534","Adesewa","F",7,5,12
"535","Adessa","F",16,21,37
"536","Adesuwa","F",6,10,16
"537","Adewale","M",5,8,13
"538","Adham","M",23,33,56
"539","Adhara","F",10,10,20
"540","Adhav","M",6,5,11
"541","Adhira","F",13,34,47
"542","Adhiraj","M",5,7,12
"543","Adhithi","F",8,5,13
"544","Adhrit","M",32,32,64
"545","Adhrith","M",7,5,12
"546","Adhvaith","M",5,5,10
"547","Adhvik","M",36,73,109
"548","Adhvika","F",11,11,22
"549","Adhya","F",36,32,68
"550","Adhyan","M",6,5,11
"551","Adi","F",24,38,62
"552","Adi","M",28,21,49
"553","Adia","F",68,50,118
"554","Adian","M",36,27,63
"555","Adiana","F",8,7,15
"556","Adianna","F",13,6,19
"557","Adib","M",5,8,13
"558","Adiba","F",10,13,23
"559","Adiel","F",5,6,11
"560","Adiel","M",130,166,296
"561","Adiela","F",10,6,16
"562","Adiella","F",6,10,16
"563","Adien","M",26,18,44
"564","Adil","M",46,34,80
"565","Adila","F",6,7,13
"566","Adilee","F",26,19,45
"567","Adileigh","F",7,10,17
"568","Adilena","F",5,6,11
"569","Adilene","F",221,215,436
"570","Adilenne","F",12,10,22
"571","Adileny","F",6,15,21
"572","Adiley","F",6,6,12
"573","Adilyn","F",217,224,441
"574","Adilynn","F",347,271,618
"575","Adilynne","F",8,18,26
"576","Adin","M",79,80,159
"577","Adina","F",135,136,271
"578","Adir","M",18,13,31
"579","Adira","F",62,69,131
"580","Adis","M",6,6,12
"581","Adison","F",62,65,127
"582","Adisyn","F",42,28,70
"583","Adit","M",12,6,18
"584","Adith","M",8,13,21
"585","Adithi","F",20,16,36
"586","Adithya","M",20,18,38
"587","Aditi","F",104,129,233
"588","Aditri","F",19,16,35
"589","Aditya","M",159,157,316
"590","Adiya","F",19,14,33
"591","Adiyah","F",6,7,13
"592","Adlai","M",18,9,27
"593","Adlee","F",74,81,155
"594","Adleigh","F",108,88,196
"595","Adlen","F",6,6,12
"596","Adler","F",22,27,49
"597","Adler","M",154,169,323
"598","Adley","F",337,482,819
"599","Adley","M",10,17,27
"600","Adlie","F",7,14,21
"601","Adlin","F",7,6,13
"602","Adlyn","F",13,13,26
"603","Adlynn","F",8,11,19
"604","Adna","F",29,12,41
"605","Adnaan","M",6,6,12
"606","Adnan","M",86,66,152
"607","Adolfo","M",155,132,287
"608","Adolphus","M",6,7,13
"609","Adom","M",11,8,19
"610","Adon","M",49,33,82
"611","Adonai","F",5,12,17
"612","Adonai","M",64,59,123
"613","Adonay","M",20,20,40
"614","Adonia","F",6,6,12
"615","Adoniah","M",6,5,11
"616","Adonias","M",26,13,39
"617","Adonijah","M",22,12,34
"618","Adonis","M",357,800,1157
"619","Adonnis","M",13,23,36
"620","Adora","F",37,53,90
"621","Adorable","F",5,5,10
"622","Adore","F",36,42,78
"623","Adorian","M",6,9,15
"624","Adrain","M",15,25,40
"625","Adream","F",6,7,13
"626","Adrean","M",19,6,25
"627","Adreana","F",12,9,21
"628","Adreanna","F",23,14,37
"629","Adri","F",13,13,26
"630","Adria","F",73,60,133
"631","Adrian","F",83,107,190
"632","Adrian","M",6513,6303,12816
"633","Adriana","F",1723,1489,3212
"634","Adriane","F",12,11,23
"635","Adriann","F",6,10,16
"636","Adrianna","F",1098,947,2045
"637","Adriannah","F",9,6,15
"638","Adrianne","F",68,60,128
"639","Adriano","M",59,75,134
"640","Adric","M",18,15,33
"641","Adrick","M",12,8,20
"642","Adrie","F",13,13,26
"643","Adriel","F",47,37,84
"644","Adriel","M",1286,1593,2879
"645","Adriell","M",8,6,14
"646","Adriella","F",10,13,23
"647","Adrielle","F",53,65,118
"648","Adrien","F",12,10,22
"649","Adrien","M",261,245,506
"650","Adriene","F",7,8,15
"651","Adrienna","F",9,10,19
"652","Adrienne","F",327,340,667
"653","Adrijana","F",7,5,12
"654","Adrik","M",16,22,38
"655","Adrika","F",6,12,18
"656","Adrina","F",49,33,82
"657","Adrion","M",17,18,35
"658","Adrionna","F",9,20,29
"659","Adrita","F",8,9,17
"660","Adriyanna","F",6,7,13
"661","Adryan","M",63,51,114
"662","Adryana","F",13,15,28
"663","Adryanna","F",14,13,27
"664","Adryel","M",13,9,22
"665","Adut","F",6,5,11
"666","Advait","M",35,35,70
"667","Advaita","F",9,7,16
"668","Advaith","M",43,56,99
"669","Advay","M",32,30,62
"670","Advik","M",93,124,217
"671","Advika","F",40,73,113
"672","Advit","M",11,16,27
"673","Advita","F",8,7,15
"674","Advith","M",21,23,44
"675","Advitha","F",5,8,13
"676","Adya","F",24,17,41
"677","Adyan","M",19,44,63
"678","Adyen","M",7,9,16
"679","Adylee","F",11,10,21
"680","Adylen","F",5,6,11
"681","Adylene","F",13,15,28
"682","Adylin","F",15,14,29
"683","Adyline","F",7,20,27
"684","Adylyn","F",12,5,17
"685","Adylynn","F",12,7,19
"686","Adyn","M",59,39,98
"687","Adysen","F",31,19,50
"688","Adyson","F",129,106,235
"689","Aedan","M",167,162,329
"690","Aeden","M",44,34,78
"691","Aedin","M",6,5,11
"692","Aedyn","F",8,6,14
"693","Aedyn","M",20,26,46
"694","Aela","F",35,34,69
"695","Aeliana","F",18,19,37
"696","Aella","F",20,22,42
"697","Aelyn","F",5,5,10
"698","Aemilia","F",14,13,27
"699","Aemon","M",10,13,23
"700","Aeneas","M",11,7,18
"701","Aengus","M",9,18,27
"702","Aeon","M",12,16,28
"703","Aerabella","F",24,19,43
"704","Aerial","F",36,18,54
"705","Aeriana","F",17,9,26
"706","Aerianna","F",12,7,19
"707","Aeric","M",7,10,17
"708","Aerie","F",10,8,18
"709","Aeriel","F",11,8,19
"710","Aeriella","F",10,5,15
"711","Aerilyn","F",25,32,57
"712","Aerin","F",18,27,45
"713","Aerion","M",10,8,18
"714","Aeris","F",96,96,192
"715","Aerith","F",20,28,48
"716","Aero","F",10,5,15
"717","Aero","M",34,30,64
"718","Aeron","M",20,19,39
"719","Aeryn","F",43,49,92
"720","Aeson","M",29,40,69
"721","Aesop","M",6,6,12
"722","Aeva","F",30,28,58
"723","Aevah","F",7,9,16
"724","Affan","M",39,29,68
"725","Afia","F",23,11,34
"726","Afifa","F",7,11,18
"727","Afiya","F",7,5,12
"728","Afnan","F",27,23,50
"729","Afnan","M",8,15,23
"730","Afomia","F",14,12,26
"731","Afrah","F",13,11,24
"732","Afreen","F",5,8,13
"733","Africa","F",9,10,19
"734","Afsa","F",9,7,16
"735","Afsheen","F",8,10,18
"736","Afton","F",96,83,179
"737","Afton","M",7,16,23
"738","Aftyn","F",12,12,24
"739","Agam","F",8,6,14
"740","Agam","M",18,43,61
"741","Agamjot","M",10,7,17
"742","Agamveer","M",6,6,12
"743","Agasthya","M",8,10,18
"744","Agastya","M",76,63,139
"745","Agata","F",9,16,25
"746","Agatha","F",87,76,163
"747","Aggie","F",6,6,12
"748","Agnes","F",190,229,419
"749","Agostino","M",5,6,11
"750","Agustin","M",224,210,434
"751","Agustina","F",18,14,32
"752","Agustine","M",6,7,13
"753","Ahaan","M",62,56,118
"754","Ahaana","F",15,11,26
"755","Ahad","M",28,20,48
"756","Ahadu","M",7,8,15
"757","Ahan","M",15,13,28
"758","Ahana","F",63,64,127
"759","Aharon","M",85,75,160
"760","Ahava","F",18,17,35
"761","Ahavah","F",8,7,15
"762","Ahdia","F",7,7,14
"763","Ahil","M",9,16,25
"764","Ahilyn","F",7,6,13
"765","Ahkeem","M",17,14,31
"766","Ahking","M",7,6,13
"767","Ahlam","F",42,38,80
"768","Ahlana","F",9,11,20
"769","Ahlani","F",16,28,44
"770","Ahlaya","F",14,14,28
"771","Ahlayah","F",14,7,21
"772","Ahleah","F",7,8,15
"773","Ahlina","F",9,7,16
"774","Ahliyah","F",9,14,23
"775","Ahmaad","M",9,10,19
"776","Ahmad","M",496,465,961
"777","Ahmadou","M",11,6,17
"778","Ahmani","F",16,16,32
"779","Ahmar","M",16,14,30
"780","Ahmari","F",15,17,32
"781","Ahmari","M",69,68,137
"782","Ahmaya","F",6,10,16
"783","Ahmed","M",588,579,1167
"784","Ahmeer","M",9,8,17
"785","Ahmeir","M",7,10,17
"786","Ahmere","M",12,15,27
"787","Ahmet","M",38,27,65
"788","Ahmia","F",13,14,27
"789","Ahmier","M",13,8,21
"790","Ahmina","F",9,11,20
"791","Ahmir","M",189,218,407
"792","Ahmira","F",10,9,19
"793","Ahmiracle","F",7,11,18
"794","Ahmirah","F",10,5,15
"795","Ahmire","M",5,6,11
"796","Ahmiya","F",13,13,26
"797","Ahmiyah","F",21,16,37
"798","Ahmod","M",7,7,14
"799","Ahmoni","F",9,5,14
"800","Ahmya","F",19,15,34
"801","Ahmyah","F",7,8,15
"802","Ahna","F",52,47,99
"803","Ahnaf","M",18,24,42
"804","Ahnalia","F",7,5,12
"805","Ahnesti","F",5,7,12
"806","Ahnesty","F",8,6,14
"807","Ahni","F",7,8,15
"808","Ahnika","F",5,14,19
"809","Ahniya","F",9,7,16
"810","Ahniyah","F",14,9,23
"811","Ahnna","F",11,11,22
"812","Ahnya","F",7,5,12
"813","Ahnyla","F",8,8,16
"814","Ahonesty","F",7,11,18
"815","Ahren","M",19,23,42
"816","Ahri","F",44,44,88
"817","Ahria","F",18,20,38
"818","Ahrianna","F",15,6,21
"819","Ahriya","F",12,8,20
"820","Ahriyah","F",12,12,24
"821","Ahron","M",45,45,90
"822","Ahsan","M",26,18,44
"823","Ahsha","F",15,21,36
"824","Ahsoka","F",5,5,10
"825","Ahtziri","F",31,34,65
"826","Ahtziry","F",5,9,14
"827","Ahuva","F",62,77,139
"828","Ahyan","M",19,35,54
"829","Ahzab","M",5,6,11
"830","Ai","F",7,6,13
"831","Aiana","F",9,5,14
"832","Aibhlinn","F",18,18,36
"833","Aicha","F",42,40,82
"834","Aida","F",184,194,378
"835","Aidah","F",13,12,25
"836","Aidaly","F",7,5,12
"837","Aidan","F",24,20,44
"838","Aidan","M",2252,2102,4354
"839","Aidana","F",16,17,33
"840","Aidden","M",21,18,39
"841","Aide","F",19,23,42
"842","Aidee","F",9,7,16
"843","Aidel","F",9,15,24
"844","Aidelyn","F",5,11,16
"845","Aiden","F",60,42,102
"846","Aiden","M",13429,12158,25587
"847","Aidenn","M",13,16,29
"848","Aidin","M",14,14,28
"849","Aidon","M",16,12,28
"850","Aidrian","M",8,5,13
"851","Aidric","M",30,22,52
"852","Aidy","F",7,9,16
"853","Aidyn","F",29,20,49
"854","Aidyn","M",176,192,368
"855","Aidynn","M",8,5,13
"856","Aiesha","F",9,6,15
"857","Aija","F",9,7,16
"858","Aika","F",9,7,16
"859","Aiken","M",15,19,34
"860","Aiko","F",24,25,49
"861","Aila","F",140,153,293
"862","Ailah","F",16,12,28
"863","Ailana","F",15,11,26
"864","Ailani","F",206,300,506
"865","Ailanie","F",7,10,17
"866","Ailany","F",39,50,89
"867","Aileana","F",12,6,18
"868","Ailed","F",8,18,26
"869","Ailee","F",51,49,100
"870","Aileen","F",609,499,1108
"871","Ailen","F",15,35,50
"872","Ailene","F",19,19,38
"873","Ailey","F",52,60,112
"874","Aili","F",34,38,72
"875","Ailin","F",59,33,92
"876","Ailis","F",12,10,22
"877","Ailish","F",11,38,49
"878","Ailsa","F",9,12,21
"879","Aily","F",10,13,23
"880","Ailyn","F",236,183,419
"881","Ailynn","F",43,33,76
"882","Aima","F",6,22,28
"883","Aiman","M",13,8,21
"884","Aimar","M",13,10,23
"885","Aime","F",22,18,40
"886","Aimee","F",299,259,558
"887","Aimen","F",5,5,10
"888","Aimi","F",7,10,17
"889","Aina","F",9,21,30
"890","Ainara","F",77,67,144
"891","Aine","F",44,32,76
"892","Ainhoa","F",36,45,81
"893","Ainslee","F",78,69,147
"894","Ainsleigh","F",39,34,73
"895","Ainsley","F",963,963,1926
"896","Ainsley","M",17,14,31
"897","Ainslie","F",23,17,40
"898","Ainzley","F",7,9,16
"899","Aira","F",24,42,66
"900","Airabella","F",38,46,84
"901","Airah","F",5,12,17
"902","Airalynn","F",11,5,16
"903","Airam","F",39,43,82
"904","Airam","M",15,18,33
"905","Aireanna","F",7,6,13
"906","Aireon","M",6,6,12
"907","Airi","F",12,19,31
"908","Airiana","F",13,24,37
"909","Airianna","F",16,17,33
"910","Airis","F",8,9,17
"911","Airlie","F",16,9,25
"912","Airyana","F",9,14,23
"913","Airyanna","F",10,15,25
"914","Airyn","F",8,6,14
"915","Aisha","F",649,617,1266
"916","Aishah","F",31,32,63
"917","Aishani","F",27,35,62
"918","Aishini","F",5,5,10
"919","Aishleen","F",6,7,13
"920","Aishwarya","F",29,29,58
"921","Aislee","F",14,12,26
"922","Aisleigh","F",7,7,14
"923","Aisley","F",76,84,160
"924","Aislin","F",55,44,99
"925","Aisling","F",48,47,95
"926","Aislinn","F",281,276,557
"927","Aislyn","F",111,81,192
"928","Aislynn","F",159,116,275
"929","Aison","M",9,9,18
"930","Aisosa","F",5,7,12
"931","Aissa","F",7,9,16
"932","Aissata","F",21,23,44
"933","Aissatou","F",28,28,56
"934","Aitana","F",299,564,863
"935","Aitanna","F",14,26,40
"936","Aithan","M",12,11,23
"937","Aithana","F",14,16,30
"938","Aithen","M",9,8,17
"939","Aitiana","F",5,16,21
"940","Aiva","F",53,46,99
"941","Aivah","F",31,38,69
"942","Aiven","M",24,31,55
"943","Aivy","F",15,13,28
"944","Aixa","F",22,19,41
"945","Aiya","F",40,31,71
"946","Aiyah","F",13,8,21
"947","Aiyana","F",333,355,688
"948","Aiyanah","F",19,14,33
"949","Aiyanna","F",192,237,429
"950","Aiyannah","F",5,10,15
"951","Aiyden","M",94,75,169
"952","Aiyla","F",20,42,62
"953","Aiyonna","F",7,9,16
"954","Aiza","F",116,104,220
"955","Aizah","F",63,79,142
"956","Aizen","M",79,94,173
"957","Aizik","M",7,13,20
"958","Aizlee","F",10,5,15
"959","Aizley","F",12,8,20
"960","Aizlyn","F",10,10,20
"961","Aizlynn","F",21,13,34
"962","Aj","F",7,7,14
"963","Aj","M",71,80,151
"964","Aja","F",84,62,146
"965","Ajah","F",33,26,59
"966","Ajai","M",8,9,17
"967","Ajan","M",12,7,19
"968","Ajanae","F",12,12,24
"969","Ajani","M",46,33,79
"970","Ajax","M",17,33,50
"971","Ajay","M",118,87,205
"972","Ajdin","M",24,10,34
"973","Ajeet","M",8,6,14
"974","Ajit","M",12,8,20
"975","Ajla","F",28,19,47
"976","Ajmal","M",5,5,10
"977","Ajna","F",5,8,13
"978","Ajooni","F",8,10,18
"979","Ajwa","F",14,16,30
"980","Akachukwu","M",5,5,10
"981","Akai","M",29,35,64
"982","Akaiya","F",8,6,14
"983","Akane","F",11,13,24
"984","Akari","F",27,38,65
"985","Akari","M",19,22,41
"986","Akash","M",44,36,80
"987","Akasha","F",40,27,67
"988","Akayla","F",27,18,45
"989","Akbar","M",16,11,27
"990","Akeelah","F",37,33,70
"991","Akeem","M",115,137,252
"992","Akeira","F",9,13,22
"993","Akela","F",11,9,20
"994","Akemi","F",33,26,59
"995","Akeria","F",5,7,12
"996","Akhil","M",66,49,115
"997","Akhila","F",6,10,16
"998","Akhilles","M",6,7,13
"999","Akhilleus","M",5,6,11
"1000","Aki","F",6,7,13
"1001","Aki","M",10,15,25
"1002","Akiem","M",8,6,14
"1003","Akif","M",11,11,22
"1004","Akiko","F",8,5,13
"1005","Akil","M",32,29,61
"1006","Akila","F",21,16,37
"1007","Akilah","F",20,38,58
"1008","Akilan","M",5,5,10
"1009","Akili","M",8,7,15
"1010","Akim","M",13,20,33
"1011","Akina","F",12,15,27
"1012","Aking","M",27,32,59
"1013","Akio","M",11,17,28
"1014","Akira","F",260,260,520
"1015","Akira","M",34,23,57
"1016","Akirah","F",18,19,37
"1017","Akito","M",9,5,14
"1018","Akiva","M",70,88,158
"1019","Akiya","F",9,5,14
"1020","Akiyah","F",16,12,28
"1021","Akoni","M",9,13,22
"1022","Akosua","F",9,5,14
"1023","Akram","M",48,52,100
"1024","Akriti","F",6,7,13
"1025","Aksa","F",5,6,11
"1026","Aksel","M",127,176,303
"1027","Aksha","F",6,7,13
"1028","Akshaj","M",51,36,87
"1029","Akshar","M",21,17,38
"1030","Akshara","F",133,146,279
"1031","Akshat","M",15,7,22
"1032","Akshay","M",40,44,84
"1033","Akshaya","F",28,34,62
"1034","Akshita","F",16,13,29
"1035","Akshith","M",5,6,11
"1036","Aksil","M",5,7,12
"1037","Akua","F",5,16,21
"1038","Akul","M",10,5,15
"1039","Akyah","F",5,6,11
"1040","Akyla","F",11,8,19
"1041","Akylah","F",13,7,20
"1042","Akyra","F",11,20,31
"1043","Al","M",19,17,36
"1044","Ala","F",22,14,36
"1045","Alaa","F",56,52,108
"1046","Alabama","F",22,14,36
"1047","Aladdin","M",8,9,17
"1048","Alaena","F",12,11,23
"1049","Alaeyah","F",7,6,13
"1050","Alahia","F",22,25,47
"1051","Alahna","F",44,29,73
"1052","Alahni","F",25,20,45
"1053","Alaia","F",427,486,913
"1054","Alaiah","F",38,46,84
"1055","Alaiia","F",6,14,20
"1056","Alaijah","F",19,22,41
"1057","Alaila","F",20,20,40
"1058","Alailah","F",12,5,17
"1059","Alain","M",57,54,111
"1060","Alaina","F",1817,1760,3577
"1061","Alainah","F",38,25,63
"1062","Alaine","F",19,21,40
"1063","Alainna","F",19,26,45
"1064","Alaira","F",11,7,18
"1065","Alaisha","F",17,23,40
"1066","Alaiya","F",54,64,118
"1067","Alaiyah","F",85,71,156
"1068","Alaiyna","F",10,5,15
"1069","Alaiza","F",13,7,20
"1070","Alajah","F",26,18,44
"1071","Alakai","M",16,20,36
"1072","Alam","M",8,7,15
"1073","Alameen","M",6,7,13
"1074","Alamin","M",9,12,21
"1075","Alan","F",13,5,18
"1076","Alan","M",2478,2626,5104
"1077","Alana","F",1616,1564,3180
"1078","Alanah","F",162,157,319
"1079","Alandra","F",11,9,20
"1080","Alanee","F",7,11,18
"1081","Alani","F",593,634,1227
"1082","Alania","F",17,24,41
"1083","Alanie","F",37,51,88
"1084","Alanii","F",10,9,19
"1085","Alanis","F",140,98,238
"1086","Alanna","F",618,549,1167
"1087","Alannah","F",370,318,688
"1088","Alanni","F",35,26,61
"1089","Alannie","F",16,10,26
"1090","Alannis","F",16,10,26
"1091","Alanny","F",17,8,25
"1092","Alannys","F",11,5,16
"1093","Alano","M",8,8,16
"1094","Alanoud","F",8,8,16
"1095","Alany","F",36,36,72
"1096","Alanys","F",15,22,37
"1097","Alanzo","M",23,25,48
"1098","Alara","F",44,38,82
"1099","Alaria","F",5,6,11
"1100","Alaric","M",182,179,361
"1101","Alarick","M",12,6,18
"1102","Alarik","M",20,15,35
"1103","Alasdair","M",36,22,58
"1104","Alashia","F",5,7,12
"1105","Alasia","F",38,36,74
"1106","Alaska","F",61,51,112
"1107","Alassane","M",7,6,13
"1108","Alastair","M",47,49,96
"1109","Alastor","M",10,16,26
"1110","Alauna","F",36,24,60
"1111","Alaura","F",60,58,118
"1112","Alaya","F",389,405,794
"1113","Alayah","F",537,576,1113
"1114","Alayasia","F",5,8,13
"1115","Alayha","F",12,17,29
"1116","Alayia","F",26,22,48
"1117","Alayiah","F",45,30,75
"1118","Alayja","F",10,15,25
"1119","Alayjah","F",20,15,35
"1120","Alayla","F",84,87,171
"1121","Alaylah","F",25,35,60
"1122","Alayna","F",1456,1431,2887
"1123","Alaynah","F",66,43,109
"1124","Alaynna","F",51,46,97
"1125","Alaysha","F",44,50,94
"1126","Alayshia","F",24,9,33
"1127","Alaysia","F",249,225,474
"1128","Alaysiah","F",9,7,16
"1129","Alayssa","F",8,7,15
"1130","Alayza","F",15,19,34
"1131","Alayzia","F",7,6,13
"1132","Alazar","M",16,11,27
"1133","Alazay","F",6,9,15
"1134","Alazne","F",12,19,31
"1135","Alba","F",157,122,279
"1136","Alban","M",18,9,27
"1137","Albany","F",22,20,42
"1138","Albaraa","M",10,10,20
"1139","Albert","M",691,642,1333
"1140","Alberta","F",9,7,16
"1141","Alberto","M",518,513,1031
"1142","Albin","M",19,9,28
"1143","Albina","F",10,12,22
"1144","Albino","M",5,6,11
"1145","Albion","M",8,8,16
"1146","Alcides","M",12,8,20
"1147","Aldair","M",37,39,76
"1148","Aldan","M",5,6,11
"1149","Aldana","F",5,6,11
"1150","Alden","F",16,16,32
"1151","Alden","M",340,388,728
"1152","Alder","M",36,73,109
"1153","Aldin","M",13,29,42
"1154","Aldina","F",6,5,11
"1155","Aldo","M",430,391,821
"1156","Aldon","M",20,26,46
"1157","Aldous","M",12,13,25
"1158","Aldric","M",8,9,17
"1159","Aldrich","M",9,13,22
"1160","Aldrick","M",12,7,19
"1161","Aldrin","M",9,15,24
"1162","Alea","F",68,48,116
"1163","Aleah","F",709,697,1406
"1164","Aleaha","F",16,16,32
"1165","Aleana","F",33,34,67
"1166","Aleanna","F",13,6,19
"1167","Alec","M",662,612,1274
"1168","Alecia","F",45,38,83
"1169","Aleck","M",19,17,36
"1170","Alecxander","M",10,7,17
"1171","Aleczander","M",49,43,92
"1172","Aleda","F",8,9,17
"1173","Alee","F",6,7,13
"1174","Aleea","F",19,12,31
"1175","Aleeah","F",107,97,204
"1176","Aleece","F",12,14,26
"1177","Aleecia","F",16,9,25
"1178","Aleem","M",18,17,35
"1179","Aleen","F",71,49,120
"1180","Aleena","F",687,611,1298
"1181","Aleenah","F",33,23,56
"1182","Aleera","F",8,5,13
"1183","Aleesa","F",24,12,36
"1184","Aleese","F",11,7,18
"1185","Aleesha","F",12,12,24
"1186","Aleesia","F",6,18,24
"1187","Aleeya","F",37,39,76
"1188","Aleeyah","F",71,59,130
"1189","Aleeza","F",40,58,98
"1190","Aleezah","F",5,7,12
"1191","Alegra","F",7,7,14
"1192","Alegria","F",6,6,12
"1193","Aleia","F",64,83,147
"1194","Aleiah","F",32,32,64
"1195","Aleida","F",59,51,110
"1196","Aleigh","F",21,11,32
"1197","Aleigha","F",218,178,396
"1198","Aleighna","F",10,9,19
"1199","Aleighya","F",6,5,11
"1200","Aleila","F",5,10,15
"1201","Aleina","F",49,55,104
"1202","Aleira","F",7,7,14
"1203","Aleisa","F",6,15,21
"1204","Aleisha","F",23,22,45
"1205","Aleister","M",28,24,52
"1206","Aleix","M",6,11,17
"1207","Aleiya","F",21,14,35
"1208","Aleiyah","F",19,26,45
"1209","Aleiza","F",12,11,23
"1210","Alejandra","F",701,717,1418
"1211","Alejandro","M",2310,2196,4506
"1212","Alejo","M",16,7,23
"1213","Alek","M",134,113,247
"1214","Alekai","M",7,9,16
"1215","Aleks","M",23,21,44
"1216","Aleksa","F",10,29,39
"1217","Aleksandar","M",47,28,75
"1218","Aleksander","M",144,144,288
"1219","Aleksandr","M",51,72,123
"1220","Aleksandra","F",112,84,196
"1221","Aleksei","M",7,19,26
"1222","Aleksey","M",24,23,47
"1223","Aleksia","F",10,8,18
"1224","Alekzander","M",62,50,112
"1225","Alem","M",16,9,25
"1226","Alen","M",51,47,98
"1227","Alena","F",496,465,961
"1228","Alenah","F",15,9,24
"1229","Alene","F",11,10,21
"1230","Aleni","F",6,6,12
"1231","Alenna","F",35,24,59
"1232","Aleph","M",5,6,11
"1233","Alera","F",10,17,27
"1234","Aleria","F",6,7,13
"1235","Aleric","M",11,10,21
"1236","Alesana","F",29,21,50
"1237","Alesandra","F",15,16,31
"1238","Alesandro","M",7,9,16
"1239","Alese","F",14,6,20
"1240","Alesha","F",38,32,70
"1241","Aleshia","F",6,7,13
"1242","Aleshka","F",9,9,18
"1243","Alesia","F",38,33,71
"1244","Alessa","F",130,170,300
"1245","Alessandra","F",1137,1066,2203
"1246","Alessandria","F",8,12,20
"1247","Alessandro","M",370,364,734
"1248","Alessia","F",214,344,558
"1249","Alessio","M",50,85,135
"1250","Alesso","M",10,13,23
"1251","Aleta","F",14,11,25
"1252","Aletha","F",5,6,11
"1253","Alethea","F",39,28,67
"1254","Aletheia","F",47,43,90
"1255","Alethia","F",17,18,35
"1256","Aletta","F",12,17,29
"1257","Alette","F",6,8,14
"1258","Alex","F",185,173,358
"1259","Alex","M",3096,2826,5922
"1260","Alexa","F",6049,4760,10809
"1261","Alexah","F",28,32,60
"1262","Alexandar","M",12,12,24
"1263","Alexander","F",22,18,40
"1264","Alexander","M",14507,13321,27828
"1265","Alexanderjames","M",9,6,15
"1266","Alexandr","M",17,13,30
"1267","Alexandra","F",2998,2831,5829
"1268","Alexandre","M",111,94,205
"1269","Alexandrea","F",68,58,126
"1270","Alexandria","F",1529,1460,2989
"1271","Alexandro","M",92,83,175
"1272","Alexandros","M",47,25,72
"1273","Alexandru","M",26,20,46
"1274","Alexandrya","F",5,6,11
"1275","Alexavier","M",100,101,201
"1276","Alexcia","F",11,11,22
"1277","Alexei","M",39,34,73
"1278","Alexey","M",26,27,53
"1279","Alexi","F",77,76,153
"1280","Alexi","M",29,25,54
"1281","Alexia","F",1016,865,1881
"1282","Alexiah","F",19,11,30
"1283","Alexiana","F",26,19,45
"1284","Alexianna","F",17,15,32
"1285","Alexie","F",28,23,51
"1286","Alexio","M",7,12,19
"1287","Alexis","F",3406,2662,6068
"1288","Alexis","M",994,961,1955
"1289","Alexius","F",6,5,11
"1290","Alexsa","F",15,13,28
"1291","Alexsander","M",18,26,44
"1292","Alexsandra","F",33,18,51
"1293","Alexsia","F",9,9,18
"1294","Alexus","F",85,55,140
"1295","Alexx","F",5,5,10
"1296","Alexx","M",5,9,14
"1297","Alexxa","F",52,34,86
"1298","Alexxander","M",11,13,24
"1299","Alexxis","F",8,13,21
"1300","Alexya","F",12,5,17
"1301","Alexys","F",45,30,75
"1302","Alexza","F",11,9,20
"1303","Alexzander","M",283,239,522
"1304","Alexzandra","F",17,7,24
"1305","Alexzandria","F",28,18,46
"1306","Aleya","F",48,51,99
"1307","Aleyah","F",107,88,195
"1308","Aleyda","F",117,64,181
"1309","Aleyla","F",5,5,10
"1310","Aleyna","F",112,114,226
"1311","Aleynah","F",9,10,19
"1312","Aleynna","F",8,5,13
"1313","Aleysa","F",12,8,20
"1314","Aleysha","F",12,23,35
"1315","Aleyssa","F",17,8,25
"1316","Aleyza","F",42,48,90
"1317","Alezander","M",8,14,22
"1318","Alfie","M",19,26,45
"1319","Alfonso","M",292,229,521
"1320","Alfonzo","M",31,31,62
"1321","Alfred","M",232,263,495
"1322","Alfredo","M",470,482,952
"1323","Algernon","M",5,5,10
"1324","Alhasan","M",10,9,19
"1325","Alhassan","M",5,16,21
"1326","Ali","F",188,151,339
"1327","Ali","M",1060,1083,2143
"1328","Alia","F",471,449,920
"1329","Aliaa","F",6,11,17
"1330","Aliah","F",264,6,270
"1331","Aliah","F",264,210,474
"1332","Aliahna","F",8,9,17
"1333","Aliana","F",381,375,756
"1334","Alianah","F",14,23,37
"1335","Aliani","F",15,15,30
"1336","Alianna","F",267,263,530
"1337","Aliannah","F",57,41,98
"1338","Alianny","F",9,14,23
"1339","Aliany","F",8,10,18
"1340","Alianys","F",16,12,28
"1341","Alias","M",29,29,58
"1342","Alic","M",5,6,11
"1343","Alice","F",3412,3669,7081
"1344","Alicea","F",12,5,17
"1345","Alicen","F",31,29,60
"1346","Alicia","F",904,859,1763
"1347","Aliciana","F",12,19,31
"1348","Alicja","F",12,17,29
"1349","Alicyn","F",6,7,13
"1350","Alida","F",27,37,64
"1351","Alie","F",6,10,16
"1352","Aliena","F",10,7,17
"1353","Alif","M",6,6,12
"1354","Aliha","F",9,11,20
"1355","Alijah","F",83,56,139
"1356","Alijah","M",620,582,1202
"1357","Alik","M",5,14,19
"1358","Alika","F",14,13,27
"1359","Alika","M",13,21,34
"1360","Alila","F",7,6,13
"1361","Alilah","F",9,8,17
"1362","Alilyana","F",6,6,12
"1363","Alim","M",21,20,41
"1364","Alima","F",20,15,35
"1365","Alimah","F",6,7,13
"1366","Alin","F",15,19,34
"1367","Alina","F",1855,1814,3669
"1368","Alinah","F",50,36,86
"1369","Aline","F",51,43,94
"1370","Alinna","F",29,43,72
"1371","Aliona","F",8,7,15
"1372","Alionna","F",7,6,13
"1373","Aliou","M",10,9,19
"1374","Alioune","M",5,7,12
"1375","Alira","F",10,14,24
"1376","Alireza","M",5,6,11
"1377","Alis","F",18,17,35
"1378","Alisa","F",257,256,513
"1379","Alisandra","F",19,17,36
"1380","Alise","F",61,68,129
"1381","Alisha","F",296,269,565
"1382","Alishba","F",16,14,30
"1383","Alisia","F",31,26,57
"1384","Alison","F",964,966,1930
"1385","Aliss","F",6,5,11
"1386","Alissa","F",286,223,509
"1387","Alissandra","F",25,13,38
"1388","Alisse","F",7,5,12
"1389","Alissia","F",11,12,23
"1390","Alisson","F",300,261,561
"1391","Alistair","M",196,247,443
"1392","Alistar","M",6,8,14
"1393","Alister","M",81,99,180
"1394","Alisyn","F",17,16,33
"1395","Alita","F",9,8,17
"1396","Alithea","F",8,10,18
"1397","Alithia","F",5,7,12
"1398","Alitza","F",30,21,51
"1399","Alitzel","F",28,13,41
"1400","Alius","M",7,6,13
"1401","Alivea","F",20,12,32
"1402","Aliveah","F",13,6,19
"1403","Alivia","F",1517,1452,2969
"1404","Aliviah","F",74,59,133
"1405","Aliviana","F",12,9,21
"1406","Aliviya","F",12,9,21
"1407","Aliviyah","F",9,14,23
"1408","Alivya","F",13,15,28
"1409","Alix","F",37,26,63
"1410","Alix","M",10,17,27
"1411","Alixander","M",8,9,17
"1412","Alixandra","F",9,7,16
"1413","Alixandria","F",13,10,23
"1414","Aliya","F",290,331,621
"1415","Aliyaah","F",6,5,11
"1416","Aliyah","F",1964,1993,3957
"1417","Aliyan","M",9,8,17
"1418","Aliyana","F",194,189,383
"1419","Aliyanah","F",9,14,23
"1420","Aliyanna","F",61,62,123
"1421","Aliyannah","F",8,7,15
"1422","Aliz","F",15,17,32
"1423","Aliza","F",421,422,843
"1424","Alizabeth","F",44,65,109
"1425","Alizae","F",41,49,90
"1426","Alizah","F",48,54,102
"1427","Alizandra","F",8,6,14
"1428","Alizay","F",36,41,77
"1429","Alize","F",61,55,116
"1430","Alizea","F",5,7,12
"1431","Alizee","F",24,27,51
"1432","Alizeh","F",6,7,13
"1433","Alizon","F",18,19,37
"1434","Aljawhara","F",5,8,13
"1435","Alla","F",5,12,17
"1436","Allaina","F",13,9,22
"1437","Allan","M",391,328,719
"1438","Allana","F",56,57,113
"1439","Allanah","F",31,20,51
"1440","Allani","F",9,8,17
"1441","Allanna","F",12,5,17
"1442","Allante","M",7,9,16
"1443","Allayah","F",13,13,26
"1444","Allayna","F",10,10,20
"1445","Alle","F",6,5,11
"1446","Alleah","F",6,11,17
"1447","Allee","F",34,21,55
"1448","Allegra","F",78,52,130
"1449","Alleigh","F",18,23,41
"1450","Alleigha","F",6,6,12
"1451","Allen","M",969,889,1858
"1452","Allena","F",25,40,65
"1453","Allene","F",5,8,13
"1454","Alley","F",25,23,48
"1455","Alleyah","F",13,12,25
"1456","Alli","F",89,59,148
"1457","Allia","F",10,9,19
"1458","Alliah","F",14,9,23
"1459","Alliana","F",29,30,59
"1460","Allianna","F",20,22,42
"1461","Allie","F",1257,1035,2292
"1462","Allina","F",10,10,20
"1463","Allinson","F",6,5,11
"1464","Allis","F",10,14,24
"1465","Allisen","F",11,6,17
"1466","Allison","F",5342,4762,10104
"1467","Allison","M",10,5,15
"1468","Allisson","F",95,81,176
"1469","Allistair","M",8,9,17
"1470","Allister","M",46,65,111
"1471","Allisyn","F",31,25,56
"1472","Alliya","F",6,7,13
"1473","Alliyah","F",63,48,111
"1474","Allizon","F",17,10,27
"1475","Allora","F",11,13,24
"1476","Allura","F",18,30,48
"1477","Allure","F",20,17,37
"1478","Ally","F",318,271,589
"1479","Allyana","F",28,24,52
"1480","Allyanna","F",25,19,44
"1481","Allyce","F",5,6,11
"1482","Allyn","F",21,12,33
"1483","Allyn","M",7,11,18
"1484","Allyna","F",9,9,18
"1485","Allysa","F",18,11,29
"1486","Allyse","F",15,10,25
"1487","Allysen","F",6,7,13
"1488","Allyson","F",907,770,1677
"1489","Allyssa","F",53,44,97
"1490","Allysson","F",13,15,28
"1491","Alma","F",413,390,803
"1492","Alma","M",8,8,16
"1493","Almas","F",5,12,17
"1494","Almendra","F",5,8,13
"1495","Almir","M",14,16,30
"1496","Almira","F",15,20,35
"1497","Alo","M",5,5,10
"1498","Aloe","F",5,5,10
"1499","Alon","M",12,31,43
"1500","Alona","F",75,65,140
"1501","Alonah","F",23,16,39
"1502","Alondra","F",945,843,1788
"1503","Aloni","F",30,29,59
"1504","Alonna","F",97,102,199
"1505","Alonnah","F",11,9,20
"1506","Alonni","F",13,14,27
"1507","Alonnie","F",6,12,18
"1508","Alonso","M",332,319,651
"1509","Alontae","M",7,7,14
"1510","Alonte","M",9,9,18
"1511","Alonzo","M",540,496,1036
"1512","Alora","F",206,227,433
"1513","Alorah","F",19,20,39
"1514","Aloria","F",5,7,12
"1515","Aloysius","M",18,15,33
"1516","Alp","M",16,21,37
"1517","Alpha","M",43,60,103
"1518","Alphonse","M",23,44,67
"1519","Alphonso","M",23,31,54
"1520","Alphonzo","M",8,6,14
"1521","Alreem","F",7,6,13
"1522","Alric","M",11,13,24
"1523","Alson","M",8,8,16
"1524","Alston","M",58,60,118
"1525","Alta","F",24,32,56
"1526","Altair","F",13,13,26
"1527","Altair","M",18,12,30
"1528","Altan","M",8,13,21
"1529","Althea","F",130,127,257
"1530","Altin","M",5,6,11
"1531","Alton","M",146,147,293
"1532","Alucard","M",14,12,26
"1533","Aluel","F",11,5,16
"1534","Aluna","F",20,27,47
"1535","Alura","F",17,9,26
"1536","Alva","F",19,26,45
"1537","Alva","M",6,9,15
"1538","Alvah","M",5,6,11
"1539","Alvaro","M",237,284,521
"1540","Alveena","F",14,12,26
"1541","Alvin","M",451,463,914
"1542","Alvina","F",26,30,56
"1543","Alvino","M",12,10,22
"1544","Alvis","M",20,12,32
"1545","Alwaleed","M",10,12,22
"1546","Alwin","M",6,9,15
"1547","Aly","F",68,76,144
"1548","Aly","M",22,23,45
"1549","Alya","F",61,69,130
"1550","Alyaan","M",14,21,35
"1551","Alyah","F",47,29,76
"1552","Alyan","M",15,21,36
"1553","Alyana","F",95,98,193
"1554","Alyanah","F",6,16,22
"1555","Alyanna","F",123,122,245
"1556","Alyannah","F",9,7,16
"1557","Alyas","M",10,20,30
"1558","Alyce","F",79,54,133
"1559","Alycia","F",59,76,135
"1560","Alyda","F",8,8,16
"1561","Alydia","F",20,16,36
"1562","Alyena","F",9,9,18
"1563","Alyia","F",11,12,23
"1564","Alyiah","F",30,24,54
"1565","Alyjah","M",6,12,18
"1566","Alyla","F",11,13,24
"1567","Alylah","F",11,13,24
"1568","Alyn","F",18,9,27
"1569","Alyna","F",121,95,216
"1570","Alynah","F",11,18,29
"1571","Alynn","F",17,6,23
"1572","Alynna","F",64,36,100
"1573","Alyona","F",18,17,35
"1574","Alyonna","F",6,6,12
"1575","Alyra","F",12,21,33
"1576","Alyria","F",5,12,17
"1577","Alyric","F",24,28,52
"1578","Alyrica","F",7,14,21
"1579","Alys","F",16,7,23
"1580","Alysa","F",51,36,87
"1581","Alysandra","F",9,6,15
"1582","Alyse","F",124,126,250
"1583","Alysen","F",6,10,16
"1584","Alysha","F",54,47,101
"1585","Alyshia","F",5,6,11
"1586","Alysia","F",48,53,101
"1587","Alyson","F",418,354,772
"1588","Alyss","F",15,14,29
"1589","Alyssa","F",3242,2662,5904
"1590","Alyssah","F",16,12,28
"1591","Alyssandra","F",47,29,76
"1592","Alysse","F",9,26,35
"1593","Alyssia","F",46,63,109
"1594","Alysson","F",71,72,143
"1595","Alyus","M",8,11,19
"1596","Alyvia","F",258,295,553
"1597","Alyviah","F",19,15,34
"1598","Alyx","F",28,23,51
"1599","Alyxander","M",6,6,12
"1600","Alyxandra","F",14,6,20
"1601","Alyxandria","F",9,11,20
"1602","Alyza","F",83,68,151
"1603","Alyzabeth","F",9,12,21
"1604","Alyzah","F",24,18,42
"1605","Alyzza","F",9,10,19
"1606","Ama","F",13,16,29
"1607","Amaad","M",5,9,14
"1608","Amaal","F",7,11,18
"1609","Amaan","M",32,45,77
"1610","Amaar","M",21,19,40
"1611","Amabel","F",8,9,17
"1612","Amabelle","F",6,5,11
"1613","Amada","F",21,24,45
"1614","Amadea","F",5,7,12
"1615","Amadeo","M",24,33,57
"1616","Amadeus","M",67,63,130
"1617","Amadi","F",6,7,13
"1618","Amadi","M",9,8,17
"1619","Amado","M",42,47,89
"1620","Amador","M",28,26,54
"1621","Amadou","M",56,37,93
"1622","Amahia","F",12,16,28
"1623","Amai","F",8,5,13
"1624","Amaia","F",162,189,351
"1625","Amaiah","F",26,47,73
"1626","Amair","M",10,15,25
"1627","Amaira","F",48,63,111
"1628","Amairah","F",6,5,11
"1629","Amairani","F",30,33,63
"1630","Amairany","F",59,53,112
"1631","Amaiya","F",51,55,106
"1632","Amaiyah","F",30,27,57
"1633","Amal","F",117,135,252
"1634","Amal","M",13,8,21
"1635","Amala","F",14,6,20
"1636","Amalee","F",6,13,19
"1637","Amali","F",5,6,11
"1638","Amalia","F",339,357,696
"1639","Amalie","F",43,45,88
"1640","Amaliya","F",6,8,14
"1641","Amalya","F",18,13,31
"1642","Aman","M",55,49,104
"1643","Amana","F",9,11,20
"1644","Amanat","F",6,10,16
"1645","Amanda","F",1020,992,2012
"1646","Amando","M",8,9,17
"1647","Amani","F",385,395,780
"1648","Amani","M",79,72,151
"1649","Amanii","F",11,7,18
"1650","Amante","M",7,8,15
"1651","Amanuel","M",28,22,50
"1652","Amar","F",13,15,28
"1653","Amar","M",157,138,295
"1654","Amara","F",689,1078,1767
"1655","Amara","M",15,11,26
"1656","Amarachi","F",30,32,62
"1657","Amarachukwu","F",9,11,20
"1658","Amarah","F",91,124,215
"1659","Amare","F",20,19,39
"1660","Amare","M",267,207,474
"1661","Amaree","F",33,25,58
"1662","Amaree","M",39,23,62
"1663","Amarey","M",6,9,15
"1664","Amari","F",675,695,1370
"1665","Amari","M",1364,1351,2715
"1666","Amaria","F",93,90,183
"1667","Amariah","F",127,137,264
"1668","Amarian","M",19,20,39
"1669","Amariana","F",42,36,78
"1670","Amarianna","F",32,25,57
"1671","Amarie","F",89,98,187
"1672","Amarie","M",18,15,33
"1673","Amarielle","F",6,5,11
"1674","Amarien","M",7,8,15
"1675","Amarii","F",26,27,53
"1676","Amarii","M",37,35,72
"1677","Amarilis","F",9,10,19
"1678","Amarion","M",141,144,285
"1679","Amariona","F",19,6,25
"1680","Amarionna","F",13,10,23
"1681","Amarious","M",7,5,12
"1682","Amaris","F",356,376,732
"1683","Amaris","M",31,28,59
"1684","Amarise","F",10,5,15
"1685","Amariss","F",6,7,13
"1686","Amarissa","F",19,30,49
"1687","Amarius","M",28,15,43
"1688","Amariya","F",23,16,39
"1689","Amariyah","F",35,48,83
"1690","Amaro","M",5,7,12
"1691","Amarra","F",17,21,38
"1692","Amarrah","F",18,8,26
"1693","Amarri","F",13,14,27
"1694","Amarri","M",30,16,46
"1695","Amaru","M",26,29,55
"1696","Amaryah","F",13,12,25
"1697","Amarylis","F",5,5,10
"1698","Amaryllis","F",69,47,116
"1699","Amarys","F",10,8,18
"1700","Amatullah","F",9,6,15
"1701","Amaura","F",8,8,16
"1702","Amauri","F",26,22,48
"1703","Amauri","M",111,103,214
"1704","Amauria","F",7,8,15
"1705","Amaury","M",34,33,67
"1706","Amay","M",24,24,48
"1707","Amaya","F",1525,1571,3096
"1708","Amayah","F",250,271,521
"1709","Amayiah","F",12,22,34
"1710","Amayra","F",19,27,46
"1711","Amayrani","F",32,24,56
"1712","Amaziah","M",45,41,86
"1713","Amazin","F",14,6,20
"1714","Amazing","F",14,8,22
"1715","Ambar","F",62,47,109
"1716","Ambellina","F",8,9,17
"1717","Amber","F",973,865,1838
"1718","Amberlee","F",38,39,77
"1719","Amberleigh","F",16,11,27
"1720","Amberley","F",16,20,36
"1721","Amberlie","F",9,8,17
"1722","Amberlin","F",7,9,16
"1723","Amberly","F",117,117,234
"1724","Amberlyn","F",40,56,96
"1725","Amberlynn","F",48,55,103
"1726","Ambika","F",8,5,13
"1727","Ambre","F",8,5,13
"1728","Ambree","F",17,16,33
"1729","Ambria","F",28,16,44
"1730","Ambriella","F",7,6,13
"1731","Ambrielle","F",24,20,44
"1732","Ambrose","M",101,96,197
"1733","Ambrosia","F",16,17,33
"1734","Ambry","F",6,8,14
"1735","Amea","F",6,5,11
"1736","Ameah","F",16,6,22
"1737","Amedeo","M",5,5,10
"1738","Amee","F",6,8,14
"1739","Ameelah","F",12,8,20
"1740","Ameelia","F",6,6,12
"1741","Ameen","M",50,60,110
"1742","Ameena","F",87,87,174
"1743","Ameenah","F",32,42,74
"1744","Ameer","M",267,284,551
"1745","Ameera","F",115,126,241
"1746","Ameerah","F",81,101,182
"1747","Ameeyah","F",6,6,12
"1748","Ameia","F",10,22,32
"1749","Ameila","F",22,27,49
"1750","Ameilia","F",10,19,29
"1751","Ameina","F",7,7,14
"1752","Ameir","M",48,39,87
"1753","Ameira","F",10,9,19
"1754","Amel","F",17,15,32
"1755","Amel","M",17,15,32
"1756","Amela","F",18,13,31
"1757","Ameli","F",9,10,19
"1758","Amelia","F",9838,10702,20540
"1759","Ameliah","F",50,63,113
"1760","Ameliana","F",23,31,54
"1761","Amelianna","F",9,9,18
"1762","Ameliarose","F",14,19,33
"1763","Amelie","F",445,438,883
"1764","Amelio","M",12,13,25
"1765","Ameliya","F",21,23,44
"1766","Ameliyah","F",12,16,28
"1767","Amellia","F",35,34,69
"1768","Amely","F",15,9,24
"1769","Amelya","F",34,33,67
"1770","Amen","F",52,50,102
"1771","Amen","M",78,72,150
"1772","Amena","F",41,43,84
"1773","Amenah","F",16,7,23
"1774","Amenia","F",7,6,13
"1775","Amer","M",40,28,68
"1776","Amera","F",33,31,64
"1777","Amerah","F",15,18,33
"1778","Amere","F",9,5,14
"1779","Amere","M",55,65,120
"1780","Ameri","F",9,16,25
"1781","Ameria","F",30,25,55
"1782","Ameriah","F",18,10,28
"1783","America","F",282,256,538
"1784","Americo","M",8,9,17
"1785","Americus","F",13,9,22
"1786","Amerie","F",94,101,195
"1787","Amerika","F",25,9,34
"1788","Ameris","F",16,12,28
"1789","Amery","F",26,25,51
"1790","Amery","M",5,5,10
"1791","Ames","M",51,86,137
"1792","Amethyst","F",125,159,284
"1793","Ameya","F",63,56,119
"1794","Ameyaa","F",10,7,17
"1795","Ameyah","F",20,14,34
"1796","Ami","F",39,40,79
"1797","Ami","M",10,18,28
"1798","Amia","F",358,351,709
"1799","Amiah","F",206,212,418
"1800","Amias","M",100,116,216
"1801","Amiaya","F",9,14,23
"1802","Amiayah","F",9,5,14
"1803","Amichai","M",7,5,12
"1804","Amie","F",49,59,108
"1805","Amiee","F",8,10,18
"1806","Amiel","M",20,18,38
"1807","Amier","M",35,22,57
"1808","Amiera","F",9,11,20
"1809","Amiere","M",10,10,20
"1810","Amiir","M",13,10,23
"1811","Amiira","F",5,8,13
"1812","Amika","F",6,8,14
"1813","Amil","M",20,23,43
"1814","Amila","F",58,51,109
"1815","Amilah","F",32,26,58
"1816","Amilcar","M",17,19,36
"1817","Amileah","F",7,13,20
"1818","Amilee","F",7,5,12
"1819","Amilia","F",139,145,284
"1820","Amiliah","F",12,16,28
"1821","Amiliana","F",26,28,54
"1822","Amilio","M",20,22,42
"1823","Amiliyah","F",7,5,12
"1824","Amilli","F",6,6,12
"1825","Amillia","F",53,33,86
"1826","Amilliana","F",24,19,43
"1827","Amillion","M",6,5,11
"1828","Amillya","F",12,8,20
"1829","Amily","F",10,11,21
"1830","Amilya","F",53,48,101
"1831","Amilyah","F",18,23,41
"1832","Amin","M",81,82,163
"1833","Amina","F",1061,1100,2161
"1834","Aminah","F",303,258,561
"1835","Aminata","F",99,83,182
"1836","Amine","M",19,15,34
"1837","Amir","F",14,17,31
"1838","Amir","M",2212,2429,4641
"1839","Amira","F",857,867,1724
"1840","Amiracle","F",78,89,167
"1841","Amirah","F",424,399,823
"1842","Amirali","M",6,7,13
"1843","Amire","M",35,30,65
"1844","Amiri","F",5,12,17
"1845","Amiri","M",22,22,44
"1846","Amiria","F",11,16,27
"1847","Amirjon","M",5,8,13
"1848","Amirr","M",12,9,21
"1849","Amirra","F",16,16,32
"1850","Amirrah","F",19,19,38
"1851","Amirykal","F",9,7,16
"1852","Amisha","F",15,9,24
"1853","Amit","F",5,7,12
"1854","Amit","M",16,17,33
"1855","Amita","F",8,7,15
"1856","Amitai","M",11,7,18
"1857","Amitiel","F",6,6,12
"1858","Amity","F",39,42,81
"1859","Amius","M",8,7,15
"1860","Amiya","F",402,384,786
"1861","Amiyah","F",1060,1228,2288
"1862","Amiyla","F",10,5,15
"1863","Amiyrah","F",10,5,15
"1864","Amjad","M",10,20,30
"1865","Amma","F",7,11,18
"1866","Ammaar","M",13,15,28
"1867","Ammanuel","M",5,5,10
"1868","Ammar","M",135,130,265
"1869","Ammara","F",9,11,20
"1870","Ammie","F",5,6,11
"1871","Ammon","M",75,62,137
"1872","Ammy","F",37,25,62
"1873","Amna","F",66,66,132
"1874","Amnah","F",6,8,14
"1875","Amogh","M",19,22,41
"1876","Amon","M",29,47,76
"1877","Amoni","F",46,52,98
"1878","Amoni","M",16,8,24
"1879","Amonie","F",9,14,23
"1880","Amontae","M",6,5,11
"1881","Amonte","M",21,11,32
"1882","Amor","F",87,96,183
"1883","Amor","M",25,33,58
"1884","Amora","F",255,258,513
"1885","Amorah","F",32,24,56
"1886","Amore","F",41,44,85
"1887","Amore","M",13,19,32
"1888","Amoree","F",14,6,20
"1889","Amorette","F",23,17,40
"1890","Amori","F",26,28,54
"1891","Amori","M",17,11,28
"1892","Amorian","M",5,5,10
"1893","Amoriana","F",5,6,11
"1894","Amorie","F",32,21,53
"1895","Amory","F",18,26,44
"1896","Amory","M",23,24,47
"1897","Amos","M",336,373,709
"1898","Amour","F",36,32,68
"1899","Amour","M",13,6,19
"1900","Amoura","F",27,35,62
"1901","Amparo","F",14,9,23
"1902","Amr","M",34,22,56
"1903","Amra","F",15,15,30
"1904","Amran","F",26,21,47
"1905","Amreen","F",18,30,48
"1906","Amri","F",23,23,46
"1907","Amrie","F",6,7,13
"1908","Amrit","F",8,16,24
"1909","Amrit","M",11,13,24
"1910","Amrita","F",16,10,26
"1911","Amrom","M",8,12,20
"1912","Amron","M",10,10,20
"1913","Amrutha","F",8,11,19
"1914","Amry","F",5,5,10
"1915","Amulya","F",14,16,30
"1916","Amun","M",10,12,22
"1917","Amy","F",2037,1828,3865
"1918","Amya","F",303,286,589
"1919","Amyah","F",127,113,240
"1920","Amyas","M",6,6,12
"1921","Amyia","F",27,36,63
"1922","Amyiah","F",72,48,120
"1923","Amyla","F",35,27,62
"1924","Amylah","F",16,30,46
"1925","Amylee","F",8,6,14
"1926","Amylia","F",29,20,49
"1927","Amyna","F",5,6,11
"1928","Amyr","M",9,17,26
"1929","Amyra","F",145,114,259
"1930","Amyrah","F",53,56,109
"1931","Amyri","F",12,10,22
"1932","Amyria","F",12,7,19
"1933","Amyriah","F",7,6,13
"1934","Amyrical","F",5,5,10
"1935","Amyrie","F",6,12,18
"1936","Amzie","F",19,20,39
"1937","An","F",47,46,93
"1938","An","M",24,27,51
"1939","Ana","F",1540,1425,2965
"1940","Anaaya","F",11,17,28
"1941","Anab","F",5,8,13
"1942","Anabel","F",164,143,307
"1943","Anabela","F",23,14,37
"1944","Anabell","F",38,31,69
"1945","Anabella","F",321,287,608
"1946","Anabelle","F",380,348,728
"1947","Anabeth","F",11,9,20
"1948","Anabia","F",32,54,86
"1949","Anael","F",6,6,12
"1950","Anaeli","F",15,14,29
"1951","Anaelle","F",17,36,53
"1952","Anagha","F",29,28,57
"1953","Anah","F",15,17,32
"1954","Anahi","F",466,535,1001
"1955","Anahit","F",7,7,14
"1956","Anahita","F",19,18,37
"1957","Anahla","F",7,6,13
"1958","Anahli","F",11,7,18
"1959","Anahlia","F",10,6,16
"1960","Anahy","F",24,26,50
"1961","Anai","F",35,31,66
"1962","Anaia","F",16,22,38
"1963","Anaiah","F",125,108,233
"1964","Anaid","F",14,18,32
"1965","Anaiis","F",6,5,11
"1966","Anaika","F",10,16,26
"1967","Anaily","F",6,6,12
"1968","Anaira","F",23,19,42
"1969","Anais","F",256,224,480
"1970","Anaise","F",18,18,36
"1971","Anaisha","F",32,60,92
"1972","Anaiya","F",75,68,143
"1973","Anaiyah","F",75,60,135
"1974","Anaiza","F",8,6,14
"1975","Anajah","F",6,8,14
"1976","Anakaren","F",8,5,13
"1977","Anakin","M",236,303,539
"1978","Anala","F",20,12,32
"1979","Analaya","F",18,12,30
"1980","Analayah","F",11,12,23
"1981","Analea","F",18,13,31
"1982","Analeah","F",100,118,218
"1983","Analee","F",93,96,189
"1984","Analei","F",5,8,13
"1985","Analeia","F",16,19,35
"1986","Analeigh","F",85,97,182
"1987","Analeigha","F",18,18,36
"1988","Analena","F",12,10,22
"1989","Analeya","F",8,16,24
"1990","Analeyah","F",9,10,19
"1991","Anali","F",65,86,151
"1992","Analia","F",322,381,703
"1993","Analiah","F",60,59,119
"1994","Analicia","F",48,47,95
"1995","Analie","F",25,29,54
"1996","Analiese","F",52,45,97
"1997","Analina","F",13,14,27
"1998","Analis","F",21,24,45
"1999","Analisa","F",64,59,123
"2000","Analise","F",154,152,306
"2001","Analisia","F",12,9,21
"2002","Analissa","F",13,8,21
"2003","Analisse","F",10,12,22
"2004","Analiya","F",10,13,23
"2005","Analiyah","F",72,81,153
"2006","Analiz","F",23,25,48
"2007","Analucia","F",39,33,72
"2008","Analuisa","F",5,6,11
"2009","Analy","F",67,95,162
"2010","Analya","F",14,11,25
"2011","Analyn","F",26,15,41
"2012","Analynn","F",29,27,56
"2013","Analysa","F",5,8,13
"2014","Analyse","F",20,13,33
"2015","Analysia","F",9,7,16
"2016","Analyssa","F",12,9,21
"2017","Analysse","F",5,10,15
"2018","Anam","F",11,19,30
"2019","Anamaria","F",60,49,109
"2020","Anamarie","F",46,19,65
"2021","Anamta","F",9,13,22
"2022","Anand","M",31,32,63
"2023","Ananda","F",17,13,30
"2024","Ananda","M",10,5,15
"2025","Anandi","F",5,8,13
"2026","Anani","F",15,9,24
"2027","Ananiah","F",8,8,16
"2028","Ananias","M",27,36,63
"2029","Anant","M",8,6,14
"2030","Ananth","M",12,5,17
"2031","Ananya","F",173,167,340
"2032","Anapaola","F",5,8,13
"2033","Anapaula","F",30,26,56
"2034","Anar","M",6,6,12
"2035","Anara","F",21,22,43
"2036","Anari","F",43,49,92
"2037","Anaria","F",6,8,14
"2038","Anarie","F",7,5,12
"2039","Anarosa","F",6,9,15
"2040","Anas","M",100,151,251
"2041","Anasia","F",18,11,29
"2042","Anasofia","F",80,71,151
"2043","Anasophia","F",23,20,43
"2044","Anastacia","F",72,85,157
"2045","Anastacio","M",11,12,23
"2046","Anastasia","F",1499,1694,3193
"2047","Anastasija","F",7,11,18
"2048","Anastasios","M",19,15,34
"2049","Anastasiya","F",30,22,52
"2050","Anastassia","F",7,5,12
"2051","Anastasya","F",5,10,15
"2052","Anastazia","F",31,26,57
"2053","Anastazja","F",6,9,15
"2054","Anaston","F",5,5,10
"2055","Anastyn","F",13,16,29
"2056","Anav","M",13,8,21
"2057","Anavey","F",9,13,22
"2058","Anavi","F",12,12,24
"2059","Anavictoria","F",24,20,44
"2060","Anay","F",8,9,17
"2061","Anay","M",78,87,165
"2062","Anaya","F",788,836,1624
"2063","Anayah","F",197,193,390
"2064","Anayeli","F",90,70,160
"2065","Anayelli","F",5,5,10
"2066","Anayia","F",5,5,10
"2067","Anayiah","F",7,7,14
"2068","Anayla","F",21,28,49
"2069","Anayra","F",5,5,10
"2070","Anaysha","F",11,9,20
"2071","Anberlin","F",20,11,31
"2072","Anberlyn","F",5,7,12
"2073","Anchor","M",14,17,31
"2074","Andalyn","F",11,8,19
"2075","Andee","F",41,39,80
"2076","Andelyn","F",11,12,23
"2077","Anden","M",28,17,45
"2078","Ander","M",132,152,284
"2079","Anders","M",291,277,568
"2080","Andersen","F",16,21,37
"2081","Andersen","M",50,49,99
"2082","Anderson","F",74,62,136
"2083","Anderson","M",1183,1155,2338
"2084","Andersson","M",5,8,13
"2085","Andersyn","F",16,16,32
"2086","Andi","F",300,321,621
"2087","Andi","M",25,21,46
"2088","Andie","F",166,165,331
"2089","Andilyn","F",14,11,25
"2090","Andilynn","F",6,8,14
"2091","Andon","M",17,13,30
"2092","Andra","F",10,19,29
"2093","Andra","M",10,9,19
"2094","Andrae","M",25,22,47
"2095","Andraya","F",32,27,59
"2096","Andre","M",1315,1389,2704
"2097","Andrea","F",2702,2473,5175
"2098","Andrea","M",11,17,28
"2099","Andreah","F",12,7,19
"2100","Andreana","F",14,8,22
"2101","Andreanna","F",8,11,19
"2102","Andreas","M",143,165,308
"2103","Andree","M",26,19,45
"2104","Andreea","F",5,11,16
"2105","Andrei","M",75,66,141
"2106","Andreia","F",13,9,22
"2107","Andreina","F",7,6,13
"2108","Andrej","M",9,10,19
"2109","Andres","M",1671,1779,3450
"2110","Andressa","F",6,6,12
"2111","Andreu","M",9,8,17
"2112","Andrew","F",10,15,25
"2113","Andrew","M",10080,9324,19404
"2114","Andrews","M",11,8,19
"2115","Andrey","M",94,79,173
"2116","Andreya","F",23,15,38
"2117","Andreyah","F",9,8,17
"2118","Andrez","M",16,22,38
"2119","Andria","F",26,30,56
"2120","Andrian","M",14,8,22
"2121","Andriana","F",19,20,39
"2122","Andrianna","F",12,5,17
"2123","Andrick","M",16,29,45
"2124","Andriel","M",19,13,32
"2125","Andrik","M",18,41,59
"2126","Andrina","F",8,7,15
"2127","Andriy","M",9,10,19
"2128","Andromeda","F",63,64,127
"2129","Andru","M",12,18,30
"2130","Andry","M",8,8,16
"2131","Andrzej","M",6,8,14
"2132","Andy","F",35,25,60
"2133","Andy","M",1066,1056,2122
"2134","Andyn","M",7,6,13
"2135","Anea","F",10,6,16
"2136","Anees","M",5,5,10
"2137","Aneesa","F",29,23,52
"2138","Aneesah","F",6,6,12
"2139","Aneesh","M",32,19,51
"2140","Aneira","F",15,6,21
"2141","Anel","F",15,13,28
"2142","Anela","F",41,53,94
"2143","Aneli","F",11,13,24
"2144","Anelia","F",6,11,17
"2145","Aneliese","F",7,8,15
"2146","Anelis","F",8,7,15
"2147","Anelise","F",22,14,36
"2148","Anelisse","F",13,10,23
"2149","Anella","F",9,14,23
"2150","Anelle","F",6,8,14
"2151","Anely","F",19,18,37
"2152","Aneri","F",6,12,18
"2153","Anesa","F",7,8,15
"2154","Anessa","F",54,53,107
"2155","Aneta","F",5,5,10
"2156","Aneth","F",10,5,15
"2157","Anette","F",18,35,53
"2158","Anevay","F",19,30,49
"2159","Aneya","F",8,5,13
"2160","Anfal","F",11,5,16
"2161","Anfernee","M",8,5,13
"2162","Angad","M",33,36,69
"2163","Angel","F",1107,1001,2108
"2164","Angel","M",6085,5523,11608
"2165","Angela","F",1485,1503,2988
"2166","Angele","F",6,9,15
"2167","Angelea","F",7,5,12
"2168","Angeleah","F",10,7,17
"2169","Angelee","F",22,14,36
"2170","Angelena","F",22,10,32
"2171","Angelene","F",11,12,23
"2172","Angeles","F",40,40,80
"2173","Angelgabriel","M",11,12,23
"2174","Angeli","F",31,29,60
"2175","Angelia","F",64,64,128
"2176","Angelic","F",24,26,50
"2177","Angelica","F",749,609,1358
"2178","Angelie","F",77,60,137
"2179","Angelika","F",46,40,86
"2180","Angelin","F",20,16,36
"2181","Angelina","F",1963,1843,3806
"2182","Angeline","F",284,240,524
"2183","Angelino","M",11,7,18
"2184","Angelique","F",540,434,974
"2185","Angelis","F",17,9,26
"2186","Angelisa","F",19,17,36
"2187","Angelise","F",22,17,39
"2188","Angelisse","F",9,15,24
"2189","Angelita","F",30,29,59
"2190","Angelito","M",12,8,20
"2191","Angeliyah","F",15,7,22
"2192","Angeliz","F",19,24,43
"2193","Angella","F",15,17,32
"2194","Angelle","F",9,9,18
"2195","Angellica","F",5,5,10
"2196","Angello","M",14,22,36
"2197","Angelly","F",12,21,33
"2198","Angelo","M",1205,1040,2245
"2199","Angelus","M",12,8,20
"2200","Angely","F",99,112,211
"2201","Angelyn","F",56,49,105
"2202","Angelyna","F",13,11,24
"2203","Angelyne","F",7,15,22
"2204","Angelynn","F",29,25,54
"2205","Angelys","F",10,8,18
"2206","Angie","F",510,480,990
"2207","Angus","M",88,75,163
"2208","Angy","F",10,12,22
"2209","Anh","F",30,32,62
"2210","Anh","M",17,19,36
"2211","Anhad","M",13,10,23
"2212","Anhar","F",6,7,13
"2213","Ani","F",78,91,169
"2214","Ania","F",80,77,157
"2215","Aniah","F",91,101,192
"2216","Anias","M",5,16,21
"2217","Anibal","M",39,41,80
"2218","Anica","F",21,15,36
"2219","Anicia","F",9,5,14
"2220","Aniela","F",29,40,69
"2221","Aniella","F",5,8,13
"2222","Anijah","F",30,22,52
"2223","Anik","M",20,17,37
"2224","Anika","F",522,516,1038
"2225","Aniken","M",7,11,18
"2226","Aniket","M",9,11,20
"2227","Aniketh","M",14,8,22
"2228","Anikin","M",5,9,14
"2229","Anila","F",24,27,51
"2230","Anilah","F",28,28,56
"2231","Anina","F",17,24,41
"2232","Anique","F",6,6,12
"2233","Anira","F",8,6,14
"2234","Anirudh","M",67,50,117
"2235","Anis","M",10,13,23
"2236","Anisa","F",116,87,203
"2237","Anisah","F",10,12,22
"2238","Anise","F",14,13,27
"2239","Anish","M",81,81,162
"2240","Anisha","F",82,89,171
"2241","Anishka","F",20,14,34
"2242","Anisia","F",6,6,12
"2243","Anissa","F",85,106,191
"2244","Aniston","F",153,140,293
"2245","Anistyn","F",80,72,152
"2246","Anita","F",147,171,318
"2247","Aniv","M",11,5,16
"2248","Aniya","F",498,429,927
"2249","Aniyah","F",1296,1159,2455
"2250","Aniyha","F",9,7,16
"2251","Aniyla","F",53,35,88
"2252","Aniylah","F",69,61,130
"2253","Anja","F",73,71,144
"2254","Anjali","F",149,122,271
"2255","Anjana","F",16,16,32
"2256","Anjani","F",6,11,17
"2257","Anjel","M",27,19,46
"2258","Anjelica","F",14,18,32
"2259","Anjelina","F",9,10,19
"2260","Anjolaoluwa","F",25,18,43
"2261","Anjolie","F",9,8,17
"2262","Anker","M",6,6,12
"2263","Ankit","M",5,12,17
"2264","Ankita","F",10,8,18
"2265","Anmarie","F",9,6,15
"2266","Anmol","F",6,6,12
"2267","Anmol","M",19,17,36
"2268","Ann","F",306,264,570
"2269","Anna","F",5119,4749,9868
"2270","Anna","M",6,5,11
"2271","Annabel","F",461,406,867
"2272","Annabell","F",161,115,276
"2273","Annabella","F",817,746,1563
"2274","Annabelle","F",3262,2974,6236
"2275","Annabellee","F",11,7,18
"2276","Annabeth","F",201,178,379
"2277","Annaclaire","F",9,26,35
"2278","Annaelle","F",10,16,26
"2279","Annagrace","F",31,26,57
"2280","Annah","F",38,33,71
"2281","Annahi","F",10,12,22
"2282","Annais","F",12,16,28
"2283","Annaka","F",15,14,29
"2284","Annakate","F",14,15,29
"2285","Annalaya","F",9,10,19
"2286","Annalea","F",29,24,53
"2287","Annaleah","F",87,77,164
"2288","Annalee","F",307,311,618
"2289","Annaleese","F",6,7,13
"2290","Annalei","F",6,9,15
"2291","Annaleia","F",5,8,13
"2292","Annaleigh","F",178,186,364
"2293","Annaleigha","F",7,23,30
"2294","Annaleise","F",21,14,35
"2295","Annalena","F",8,11,19
"2296","Annalese","F",7,6,13
"2297","Annaley","F",5,12,17
"2298","Annali","F",22,28,50
"2299","Annalia","F",80,88,168
"2300","Annaliah","F",13,18,31
"2301","Annalice","F",5,5,10
"2302","Annalicia","F",31,30,61
"2303","Annalie","F",72,69,141
"2304","Annaliese","F",178,192,370
"2305","Annalina","F",17,18,35
"2306","Annalis","F",7,8,15
"2307","Annalisa","F",108,115,223
"2308","Annalise","F",779,816,1595
"2309","Annalisia","F",12,9,21
"2310","Annalisse","F",15,12,27
"2311","Annaliyah","F",21,30,51
"2312","Annaliz","F",13,8,21
"2313","Annaliza","F",5,5,10
"2314","Annalucia","F",11,6,17
"2315","Annaly","F",28,27,55
"2316","Annalya","F",6,5,11
"2317","Annalyce","F",7,11,18
"2318","Annalyn","F",72,65,137
"2319","Annalynn","F",103,104,207
"2320","Annalynne","F",22,12,34
"2321","Annalysa","F",11,8,19
"2322","Annalyse","F",78,61,139
"2323","Annalysia","F",6,5,11
"2324","Annalyssa","F",10,8,18
"2325","Annamae","F",32,33,65
"2326","Annamaria","F",34,40,74
"2327","Annamarie","F",132,104,236
"2328","Annapurna","F",6,5,11
"2329","Annarae","F",6,6,12
"2330","Annarose","F",24,26,50
"2331","Annas","M",6,6,12
"2332","Annasofia","F",13,10,23
"2333","Annasophia","F",32,15,47
"2334","Annastacia","F",9,7,16
"2335","Annastasia","F",48,80,128
"2336","Annaston","F",9,9,18
"2337","Annastyn","F",29,21,50
"2338","Annaya","F",13,14,27
"2339","Annayah","F",5,6,11
"2340","Anndrea","F",6,5,11
"2341","Anne","F",541,560,1101
"2342","Annebelle","F",19,11,30
"2343","Anneka","F",18,7,25
"2344","Anneke","F",20,16,36
"2345","Annel","F",15,8,23
"2346","Anneli","F",20,21,41
"2347","Annelie","F",9,22,31
"2348","Anneliese","F",195,152,347
"2349","Annelisa","F",8,8,16
"2350","Annelise","F",209,197,406
"2351","Annelle","F",8,7,15
"2352","Annely","F",5,7,12
"2353","Annelyse","F",19,11,30
"2354","Annemarie","F",84,71,155
"2355","Anneth","F",5,5,10
"2356","Annetta","F",5,11,16
"2357","Annette","F",176,199,375
"2358","Anni","F",6,10,16
"2359","Annia","F",19,14,33
"2360","Anniah","F",12,14,26
"2361","Annica","F",10,9,19
"2362","Annie","F",1002,1113,2115
"2363","Annika","F",540,454,994
"2364","Annikah","F",5,7,12
"2365","Annilee","F",8,9,17
"2366","Annisa","F",7,7,14
"2367","Annisten","F",9,7,16
"2368","Anniston","F",256,272,528
"2369","Annistyn","F",130,132,262
"2370","Anniyah","F",30,35,65
"2371","Annlee","F",12,12,24
"2372","Annleigh","F",16,10,26
"2373","Annmarie","F",106,101,207
"2374","Annora","F",38,85,123
"2375","Annslee","F",24,30,54
"2376","Annsleigh","F",20,12,32
"2377","Annsley","F",65,50,115
"2378","Anny","F",40,32,72
"2379","Annya","F",8,9,17
"2380","Anoop","F",6,5,11
"2381","Anora","F",55,78,133
"2382","Anorah","F",15,21,36
"2383","Anouk","F",14,14,28
"2384","Anoushka","F",20,12,32
"2385","Anquan","M",7,8,15
"2386","Ansel","M",158,158,316
"2387","Anselm","M",9,12,21
"2388","Anselmo","M",16,13,29
"2389","Ansen","M",11,13,24
"2390","Ansh","M",111,109,220
"2391","Anshika","F",15,21,36
"2392","Anshuman","M",6,5,11
"2393","Anslee","F",77,69,146
"2394","Ansleigh","F",97,86,183
"2395","Ansley","F",464,409,873
"2396","Anslie","F",12,8,20
"2397","Anson","M",286,302,588
"2398","Anta","F",10,7,17
"2399","Antara","F",6,6,12
"2400","Antares","M",6,6,12
"2401","Antavious","M",9,6,15
"2402","Anthea","F",11,9,20
"2403","Anthem","M",10,8,18
"2404","Anthonella","F",7,18,25
"2405","Anthoney","M",9,6,15
"2406","Anthoni","M",17,12,29
"2407","Anthonia","F",6,5,11
"2408","Anthonie","M",9,18,27
"2409","Anthony","F",12,11,23
"2410","Anthony","M",10596,9815,20411
"2411","Antione","M",26,38,64
"2412","Antionette","F",12,5,17
"2413","Antjuan","M",6,7,13
"2414","Antoine","M",203,195,398
"2415","Antoinette","F",78,68,146
"2416","Anton","M",214,204,418
"2417","Antone","M",17,14,31
"2418","Antonela","F",5,5,10
"2419","Antonella","F",261,370,631
"2420","Antonette","F",7,7,14
"2421","Antoni","M",36,47,83
"2422","Antonia","F",261,264,525
"2423","Antonin","M",5,7,12
"2424","Antonina","F",31,29,60
"2425","Antonino","M",33,24,57
"2426","Antonio","M",2720,2540,5260
"2427","Antonios","M",17,9,26
"2428","Antonius","M",13,12,25
"2429","Antony","M",125,110,235
"2430","Antonyo","M",6,8,14
"2431","Antrell","M",5,6,11
"2432","Antron","M",7,6,13
"2433","Antuan","M",16,13,29
"2434","Antwain","M",14,16,30
"2435","Antwan","M",112,109,221
"2436","Antwaun","M",16,16,32
"2437","Antwoine","M",8,10,18
"2438","Antwon","M",69,64,133
"2439","Antwone","M",27,22,49
"2440","Antwuan","M",9,5,14
"2441","Anuar","M",5,15,20
"2442","Anuhea","F",37,30,67
"2443","Anuj","M",20,19,39
"2444","Anum","F",19,11,30
"2445","Anuoluwapo","F",5,10,15
"2446","Anusha","F",26,19,45
"2447","Anushka","F",53,37,90
"2448","Anvay","M",16,12,28
"2449","Anvi","F",80,66,146
"2450","Anvika","F",67,56,123
"2451","Anvita","F",24,20,44
"2452","Anvith","M",9,12,21
"2453","Anvitha","F",33,24,57
"2454","Anwar","M",43,43,86
"2455","Anwen","F",12,6,18
"2456","Anwita","F",34,24,58
"2457","Anwyn","F",5,6,11
"2458","Anya","F",561,507,1068
"2459","Anyah","F",45,38,83
"2460","Anyela","F",8,10,18
"2461","Anyeli","F",26,27,53
"2462","Anyelin","F",20,11,31
"2463","Anyelo","M",7,9,16
"2464","Anyely","F",7,6,13
"2465","Anyi","F",6,7,13
"2466","Anyia","F",20,13,33
"2467","Anyiah","F",25,21,46
"2468","Anyla","F",124,139,263
"2469","Anylah","F",98,102,200
"2470","Anysia","F",6,9,15
"2471","Anyssa","F",28,17,45
"2472","Anzal","F",18,19,37
"2473","Anzar","M",8,7,15
"2474","Anze","M",6,7,13
"2475","Anzel","M",12,12,24
"2476","Anzlee","F",11,8,19
"2477","Anzleigh","F",9,8,17
"2478","Anzley","F",6,9,15
"2479","Aodhan","M",12,13,25
"2480","Aoi","F",8,11,19
"2481","Aoife","F",98,104,202
"2482","Aoki","F",7,9,16
"2483","Aolani","F",21,33,54
"2484","Aolanis","F",16,26,42
"2485","Aous","M",5,8,13
"2486","Aparna","F",7,5,12
"2487","Aphrodite","F",16,12,28
"2488","Apolline","F",8,10,18
"2489","Apollo","M",320,468,788
"2490","Apollonia","F",25,17,42
"2491","Apollos","M",13,16,29
"2492","Apolo","M",10,10,20
"2493","Apolonia","F",12,12,24
"2494","Aponi","F",6,7,13
"2495","Apphia","F",9,7,16
"2496","Apple","F",14,11,25
"2497","April","F",801,820,1621
"2498","Apryl","F",35,38,73
"2499","Apsara","F",5,6,11
"2500","Aqeel","M",8,6,14
"2501","Aqib","M",8,10,18
"2502","Aqil","M",8,6,14
"2503","Aqsa","F",14,15,29
"2504","Aqua","F",6,7,13
"2505","Aquarius","M",8,5,13
"2506","Aquila","F",9,12,21
"2507","Aquiles","M",18,31,49
"2508","Aquinnah","F",5,5,10
"2509","Ara","F",49,53,102
"2510","Ara","M",10,13,23
"2511","Arabel","F",16,11,27
"2512","Arabela","F",11,5,16
"2513","Arabell","F",8,12,20
"2514","Arabella","F",1674,1723,3397
"2515","Arabelle","F",132,124,256
"2516","Araceli","F",247,207,454
"2517","Aracelis","F",7,11,18
"2518","Aracelli","F",8,10,18
"2519","Aracely","F",151,128,279
"2520","Arad","M",13,13,26
"2521","Aradhana","F",11,12,23
"2522","Aradhya","F",24,40,64
"2523","Arael","M",5,5,10
"2524","Araeya","F",5,7,12
"2525","Araf","M",10,13,23
"2526","Arafat","M",6,12,18
"2527","Arah","F",5,11,16
"2528","Arai","F",6,5,11
"2529","Araia","F",6,8,14
"2530","Araina","F",19,21,40
"2531","Araiya","F",33,23,56
"2532","Araiyah","F",17,9,26
"2533","Aralyn","F",56,49,105
"2534","Aralynn","F",64,57,121
"2535","Aram","F",5,6,11
"2536","Aram","M",66,75,141
"2537","Aramis","M",47,60,107
"2538","Aran","M",22,22,44
"2539","Arantxa","F",76,34,110
"2540","Arantza","F",173,103,276
"2541","Aranza","F",289,303,592
"2542","Aras","M",23,20,43
"2543","Arash","M",12,16,28
"2544","Arath","M",19,28,47
"2545","Arav","M",46,43,89
"2546","Araya","F",173,170,343
"2547","Arayah","F",105,67,172
"2548","Arayia","F",8,6,14
"2549","Arayla","F",8,6,14
"2550","Arayna","F",16,16,32
"2551","Arber","M",10,10,20
"2552","Arbor","F",25,43,68
"2553","Arbor","M",6,11,17
"2554","Arcadia","F",21,17,38
"2555","Arcangel","M",11,10,21
"2556","Arcelia","F",8,6,14
"2557","Archer","F",21,33,54
"2558","Archer","M",1272,1379,2651
"2559","Archibald","M",50,51,101
"2560","Archie","M",146,132,278
"2561","Archimedes","M",10,12,22
"2562","Archit","M",9,11,20
"2563","Archivaldo","M",14,12,26
"2564","Arda","M",32,20,52
"2565","Arden","F",300,275,575
"2566","Arden","M",92,104,196
"2567","Ardian","M",7,5,12
"2568","Ardis","F",6,5,11
"2569","Ardit","M",7,5,12
"2570","Ardyn","F",21,23,44
"2571","Areana","F",5,5,10
"2572","Areanna","F",9,5,14
"2573","Areeb","M",13,13,26
"2574","Areeba","F",8,14,22
"2575","Areebah","F",5,5,10
"2576","Areej","F",29,24,53
"2577","Areen","F",14,17,31
"2578","Areesha","F",13,18,31
"2579","Areeya","F",5,5,10
"2580","Areia","F",7,7,14
"2581","Arek","M",14,16,30
"2582","Arel","M",8,14,22
"2583","Areli","F",168,152,320
"2584","Arelis","F",7,16,23
"2585","Arella","F",21,14,35
"2586","Arelly","F",7,8,15
"2587","Arely","F",361,369,730
"2588","Arelyn","F",9,8,17
"2589","Arelys","F",5,9,14
"2590","Aren","M",44,64,108
"2591","Arena","F",5,7,12
"2592","Areni","F",5,9,14
"2593","Ares","F",5,15,20
"2594","Ares","M",339,356,695
"2595","Areya","F",19,13,32
"2596","Areyah","F",5,7,12
"2597","Arfa","F",14,14,28
"2598","Arfan","M",5,9,14
"2599","Argelia","F",10,7,17
"2600","Argenis","M",21,16,37
"2601","Arhaan","M",29,35,64
"2602","Arham","M",113,130,243
"2603","Arhan","M",15,8,23
"2604","Arhianna","F",5,7,12
"2605","Arhum","M",14,15,29
"2606","Ari","F",265,274,539
"2607","Ari","M",766,742,1508
"2608","Aria","F",6392,6904,13296
"2609","Aria","M",21,16,37
"2610","Ariabella","F",19,16,35
"2611","Ariadna","F",128,172,300
"2612","Ariadne","F",366,387,753
"2613","Ariadnne","F",6,11,17
"2614","Ariah","F",607,1040,1647
"2615","Ariah","M",8,7,15
"2616","Ariahna","F",13,15,28
"2617","Arial","F",29,17,46
"2618","Ariam","F",18,28,46
"2619","Arian","F",39,38,77
"2620","Arian","M",347,324,671
"2621","Ariana","F",4944,4577,9521
"2622","Ariana","M",7,5,12
"2623","Arianah","F",39,28,67
"2624","Ariane","F",129,84,213
"2625","Ariani","F",28,29,57
"2626","Arianis","F",7,5,12
"2627","Ariann","F",9,15,24
"2628","Arianna","F",4519,3869,8388
"2629","Ariannah","F",71,48,119
"2630","Arianne","F",81,67,148
"2631","Arianni","F",27,26,53
"2632","Ariannie","F",9,10,19
"2633","Arianny","F",143,140,283
"2634","Ariany","F",28,41,69
"2635","Ariarose","F",6,8,14
"2636","Arias","M",16,9,25
"2637","Ariauna","F",10,10,20
"2638","Ariayah","F",5,5,10
"2639","Ariba","F",6,5,11
"2640","Aribella","F",80,85,165
"2641","Aribelle","F",15,12,27
"2642","Aric","M",60,62,122
"2643","Aricela","F",11,9,20
"2644","Arick","M",13,21,34
"2645","Ariday","F",5,5,10
"2646","Arie","F",105,93,198
"2647","Arie","M",64,58,122
"2648","Ariea","F",13,6,19
"2649","Arieah","F",5,6,11
"2650","Arieal","F",6,5,11
"2651","Arieana","F",22,15,37
"2652","Arieanna","F",39,21,60
"2653","Ariel","F",2339,2177,4516
"2654","Ariel","M",455,595,1050
"2655","Ariela","F",158,149,307
"2656","Ariele","F",8,7,15
"2657","Arielis","F",15,14,29
"2658","Arieliz","F",7,9,16
"2659","Ariell","F",19,12,31
"2660","Ariella","F",812,981,1793
"2661","Ariellah","F",9,13,22
"2662","Arielle","F",928,1068,1996
"2663","Arielly","F",5,10,15
"2664","Ariely","F",16,16,32
"2665","Arielys","F",19,12,31
"2666","Arien","F",10,16,26
"2667","Arien","M",28,12,40
"2668","Arienne","F",16,8,24
"2669","Arieon","M",7,7,14
"2670","Arieonna","F",10,9,19
"2671","Aries","F",65,70,135
"2672","Aries","M",154,175,329
"2673","Arietta","F",14,21,35
"2674","Arieya","F",5,5,10
"2675","Ariez","M",6,5,11
"2676","Arif","M",12,10,22
"2677","Arihaan","M",14,8,22
"2678","Arihana","F",10,5,15
"2679","Arihanna","F",20,23,43
"2680","Arihant","M",7,9,16
"2681","Arij","F",6,7,13
"2682","Arijana","F",7,9,16
"2683","Arik","M",62,67,129
"2684","Arika","F",12,29,41
"2685","Arilyn","F",25,21,46
"2686","Arilynn","F",22,23,45
"2687","Arin","F",23,34,57
"2688","Arin","M",60,56,116
"2689","Arina","F",59,74,133
"2690","Ario","M",18,16,34
"2691","Arion","F",9,6,15
"2692","Arion","M",83,67,150
"2693","Ariona","F",24,20,44
"2694","Arionna","F",96,70,166
"2695","Aris","F",32,56,88
"2696","Aris","M",60,85,145
"2697","Arisa","F",19,19,38
"2698","Arisbeth","F",42,32,74
"2699","Arish","M",12,12,24
"2700","Arisha","F",39,37,76
"2701","Arison","M",7,6,13
"2702","Arissa","F",68,58,126
"2703","Arista","F",13,17,30
"2704","Aristeo","M",6,6,12
"2705","Aristides","M",9,12,21
"2706","Ariston","M",20,16,36
"2707","Aristotle","M",21,31,52
"2708","Aritza","F",9,7,16
"2709","Arius","M",76,48,124
"2710","Ariv","M",13,15,28
"2711","Ariya","F",408,424,832
"2712","Ariyah","F",478,707,1185
"2713","Ariyan","F",18,8,26
"2714","Ariyan","M",26,27,53
"2715","Ariyana","F",130,88,218
"2716","Ariyanah","F",25,15,40
"2717","Ariyanna","F",118,104,222
"2718","Ariyel","F",13,9,22
"2719","Ariyelle","F",5,6,11
"2720","Ariyiah","F",5,5,10
"2721","Ariyon","M",9,15,24
"2722","Ariyonna","F",20,19,39
"2723","Ariz","M",13,7,20
"2724","Ariza","F",28,30,58
"2725","Arizbeth","F",39,25,64
"2726","Arizona","F",88,115,203
"2727","Arjan","M",28,28,56
"2728","Arjay","M",7,8,15
"2729","Arjen","M",42,30,72
"2730","Arjun","M",575,576,1151
"2731","Arjuna","M",14,9,23
"2732","Arkan","M",8,5,13
"2733","Arkham","M",9,14,23
"2734","Arkin","M",12,7,19
"2735","Arla","F",9,7,16
"2736","Arlan","M",24,25,49
"2737","Arlana","F",5,7,12
"2738","Arland","M",6,8,14
"2739","Arlando","M",5,5,10
"2740","Arlee","F",26,28,54
"2741","Arleen","F",58,50,108
"2742","Arleigh","F",20,39,59
"2743","Arlen","F",22,12,34
"2744","Arlen","M",57,59,116
"2745","Arlena","F",6,8,14
"2746","Arlene","F",170,145,315
"2747","Arlenis","F",5,5,10
"2748","Arlenne","F",8,8,16
"2749","Arleny","F",10,5,15
"2750","Arlet","F",39,127,166
"2751","Arleth","F",116,256,372
"2752","Arlett","F",32,42,74
"2753","Arlette","F",128,254,382
"2754","Arley","F",32,22,54
"2755","Arley","M",61,51,112
"2756","Arlie","F",28,27,55
"2757","Arlie","M",6,9,15
"2758","Arlin","F",10,12,22
"2759","Arlin","M",30,17,47
"2760","Arlind","M",13,8,21
"2761","Arline","F",8,9,17
"2762","Arlington","F",8,10,18
"2763","Arlington","M",12,13,25
"2764","Arlis","M",15,9,24
"2765","Arliss","M",7,9,16
"2766","Arlo","F",32,56,88
"2767","Arlo","M",576,968,1544
"2768","Arlon","M",5,6,11
"2769","Arlow","F",5,8,13
"2770","Arly","F",9,7,16
"2771","Arlyn","F",44,38,82
"2772","Arlyn","M",8,13,21
"2773","Arlyne","F",8,5,13
"2774","Arlynn","F",16,17,33
"2775","Armaan","M",145,161,306
"2776","Armahni","F",9,10,19
"2777","Arman","M",105,104,209
"2778","Armand","M",47,41,88
"2779","Armando","M",750,680,1430
"2780","Armani","F",429,447,876
"2781","Armani","M",558,515,1073
"2782","Armanii","F",15,14,29
"2783","Armanii","M",10,12,22
"2784","Armany","M",8,6,14
"2785","Armari","M",8,7,15
"2786","Armarion","M",5,5,10
"2787","Armel","M",11,11,22
"2788","Armen","M",22,32,54
"2789","Armin","M",63,70,133
"2790","Armina","F",10,7,17
"2791","Armiyah","F",10,10,20
"2792","Armon","M",58,47,105
"2793","Armond","M",28,16,44
"2794","Armondo","M",6,5,11
"2795","Armoni","F",110,93,203
"2796","Armoni","M",53,43,96
"2797","Armonie","F",22,27,49
"2798","Armonie","M",7,8,15
"2799","Armonii","F",21,9,30
"2800","Armor","M",5,5,10
"2801","Armstrong","M",8,6,14
"2802","Arna","F",15,18,33
"2803","Arnaldo","M",14,11,25
"2804","Arnav","M",103,126,229
"2805","Arne","M",5,7,12
"2806","Arnel","M",7,7,14
"2807","Arnell","M",18,6,24
"2808","Arnez","M",17,16,33
"2809","Arnika","F",9,14,23
"2810","Arno","M",9,10,19
"2811","Arnold","M",95,98,193
"2812","Arnoldo","M",25,21,46
"2813","Arnulfo","M",31,39,70
"2814","Arohi","F",23,12,35
"2815","Aron","M",332,307,639
"2816","Arora","F",22,9,31
"2817","Aroura","F",6,11,17
"2818","Aroush","F",7,8,15
"2819","Arpan","M",7,8,15
"2820","Arpi","F",10,15,25
"2821","Arrabella","F",15,17,32
"2822","Arraya","F",8,9,17
"2823","Arrayah","F",9,16,25
"2824","Arren","M",8,5,13
"2825","Arria","F",22,18,40
"2826","Arriah","F",9,22,31
"2827","Arriana","F",43,36,79
"2828","Arrianna","F",43,32,75
"2829","Arrie","F",11,18,29
"2830","Arriella","F",5,6,11
"2831","Arrielle","F",8,12,20
"2832","Arrietty","F",12,9,21
"2833","Arrington","F",8,10,18
"2834","Arrington","M",13,10,23
"2835","Arrion","M",5,7,12
"2836","Arriyah","F",14,8,22
"2837","Arron","M",46,38,84
"2838","Arrow","F",61,71,132
"2839","Arrow","M",95,119,214
"2840","Arsal","M",6,7,13
"2841","Arsalan","M",11,18,29
"2842","Arsema","F",60,39,99
"2843","Arsen","M",36,34,70
"2844","Arsenio","M",18,14,32
"2845","Arsh","M",31,38,69
"2846","Arshaan","M",9,7,16
"2847","Arshad","M",7,6,13
"2848","Arshan","M",21,22,43
"2849","Arshi","F",12,12,24
"2850","Arshia","F",7,19,26
"2851","Arshika","F",8,10,18
"2852","Arshiya","F",24,14,38
"2853","Arslan","M",7,14,21
"2854","Arson","M",9,10,19
"2855","Art","M",20,17,37
"2856","Artavious","M",11,6,17
"2857","Arteen","M",7,6,13
"2858","Artem","M",48,49,97
"2859","Artemio","M",21,23,44
"2860","Artemis","F",104,149,253
"2861","Artemis","M",19,28,47
"2862","Artemisia","F",8,12,20
"2863","Artez","M",10,12,22
"2864","Arthas","M",5,6,11
"2865","Arthur","M",1242,1333,2575
"2866","Artin","M",33,24,57
"2867","Artis","M",15,14,29
"2868","Artur","M",24,18,42
"2869","Arturo","M",556,537,1093
"2870","Artyom","M",13,11,24
"2871","Arun","M",18,21,39
"2872","Arush","M",20,18,38
"2873","Arushi","F",17,9,26
"2874","Arvin","M",78,82,160
"2875","Arwa","F",45,50,95
"2876","Arwen","F",115,128,243
"2877","Arwin","M",11,10,21
"2878","Arwyn","F",25,37,62
"2879","Ary","F",9,8,17
"2880","Ary","M",8,8,16
"2881","Arya","F",1639,1890,3529
"2882","Arya","M",90,54,144
"2883","Aryaa","F",5,8,13
"2884","Aryaan","M",6,14,20
"2885","Aryah","F",105,129,234
"2886","Aryahi","F",13,15,28
"2887","Aryam","F",25,23,48
"2888","Aryaman","M",5,6,11
"2889","Aryan","F",29,31,60
"2890","Aryan","M",359,345,704
"2891","Aryana","F",335,264,599
"2892","Aryanah","F",18,13,31
"2893","Aryani","F",10,10,20
"2894","Aryanna","F",393,361,754
"2895","Aryannah","F",20,20,40
"2896","Aryash","M",11,8,19
"2897","Aryav","M",11,19,30
"2898","Arybella","F",7,6,13
"2899","Arye","M",8,16,24
"2900","Aryeh","M",110,90,200
"2901","Aryel","F",19,19,38
"2902","Aryella","F",13,17,30
"2903","Aryelle","F",28,22,50
"2904","Aryen","M",7,11,18
"2905","Aryia","F",53,55,108
"2906","Aryiah","F",27,48,75
"2907","Aryian","F",8,6,14
"2908","Aryiana","F",12,11,23
"2909","Aryianna","F",23,14,37
"2910","Aryn","F",38,64,102
"2911","Aryn","M",8,7,15
"2912","Arynn","F",16,33,49
"2913","Aryon","M",8,7,15
"2914","Aryonna","F",15,16,31
"2915","Aryssa","F",13,15,28
"2916","Arzu","F",11,6,17
"2917","Asa","F",65,53,118
"2918","Asa","M",538,566,1104
"2919","Asaad","M",17,18,35
"2920","Asad","M",36,38,74
"2921","Asadbek","M",9,7,16
"2922","Asael","M",66,38,104
"2923","Asaf","M",6,8,14
"2924","Asahel","M",9,5,14
"2925","Asaiah","F",7,8,15
"2926","Asaiah","M",62,61,123
"2927","Asal","F",8,11,19
"2928","Asani","F",7,18,25
"2929","Asani","M",6,9,15
"2930","Asante","M",17,15,32
"2931","Asaph","M",15,18,33
"2932","Asar","M",6,16,22
"2933","Ascher","M",29,35,64
"2934","Aseda","M",5,5,10
"2935","Aseel","F",52,73,125
"2936","Aseel","M",12,13,25
"2937","Asees","F",8,14,22
"2938","Asenat","F",11,8,19
"2939","Asenath","F",13,16,29
"2940","Aseneth","F",11,8,19
"2941","Aser","M",15,15,30
"2942","Aseret","F",5,6,11
"2943","Aset","F",5,6,11
"2944","Asfiya","F",5,6,11
"2945","Ash","M",99,139,238
"2946","Asha","F",180,183,363
"2947","Ashaad","M",8,7,15
"2948","Ashad","M",6,7,13
"2949","Ashai","M",10,5,15
"2950","Ashani","F",5,8,13
"2951","Ashanti","F",156,161,317
"2952","Ashanty","F",14,11,25
"2953","Ashar","M",20,27,47
"2954","Ashari","F",12,12,24
"2955","Ashawn","M",8,6,14
"2956","Ashaz","M",9,10,19
"2957","Ashby","F",23,16,39
"2958","Ashby","M",17,31,48
"2959","Ashden","M",8,11,19
"2960","Ashdon","M",14,16,30
"2961","Ashe","M",15,18,33
"2962","Ashely","F",22,20,42
"2963","Asher","F",74,71,145
"2964","Asher","M",5102,5466,10568
"2965","Ashford","M",9,10,19
"2966","Ashia","F",12,16,28
"2967","Ashika","F",5,8,13
"2968","Ashir","M",7,12,19
"2969","Ashira","F",11,17,28
"2970","Ashiya","F",10,6,16
"2971","Ashiyah","F",7,5,12
"2972","Ashlan","F",8,9,17
"2973","Ashland","F",23,15,38
"2974","Ashland","M",11,5,16
"2975","Ashlee","F",105,94,199
"2976","Ashleen","F",22,19,41
"2977","Ashleigh","F",113,88,201
"2978","Ashlen","F",13,13,26
"2979","Ashley","F",3419,3024,6443
"2980","Ashley","M",26,34,60
"2981","Ashli","F",9,10,19
"2982","Ashlie","F",21,20,41
"2983","Ashlin","F",56,36,92
"2984","Ashlinn","F",13,8,21
"2985","Ashly","F",113,117,230
"2986","Ashlyn","F",981,830,1811
"2987","Ashlynn","F",869,759,1628
"2988","Ashlynne","F",40,28,68
"2989","Ashmi","F",6,6,12
"2990","Ashna","F",15,13,28
"2991","Ashonti","F",8,5,13
"2992","Ashot","M",6,10,16
"2993","Ashraf","M",21,13,34
"2994","Ashtan","M",8,10,18
"2995","Ashten","F",9,6,15
"2996","Ashten","M",61,43,104
"2997","Ashtin","F",17,10,27
"2998","Ashtin","M",46,43,89
"2999","Ashton","F",191,195,386
"3000","Ashton","M",3002,3078,6080
"3001","Ashtyn","F",199,194,393
"3002","Ashtyn","M",74,89,163
"3003","Ashtynn","F",16,13,29
"3004","Ashur","M",43,21,64
"3005","Ashvath","M",6,6,12
"3006","Ashvik","M",17,26,43
"3007","Ashvika","F",10,13,23
"3008","Ashwath","M",6,14,20
"3009","Ashwin","M",72,70,142
"3010","Ashya","F",6,5,11
"3011","Ashyr","M",11,9,20
"3012","Asia","F",301,229,530
"3013","Asiah","F",28,28,56
"3014","Asiah","M",23,17,40
"3015","Asiana","F",10,5,15
"3016","Asiel","M",35,60,95
"3017","Asier","M",8,6,14
"3018","Asim","M",30,29,59
"3019","Asir","M",18,14,32
"3020","Asiya","F",113,133,246
"3021","Asiyah","F",77,90,167
"3022","Askari","M",6,19,25
"3023","Aslan","F",6,7,13
"3024","Aslan","M",40,49,89
"3025","Asli","F",11,12,23
"3026","Aslyn","F",13,17,30
"3027","Aslynn","F",12,12,24
"3028","Asma","F",93,104,197
"3029","Asmaa","F",37,28,65
"3030","Asmi","F",18,16,34
"3031","Asna","F",5,9,14
"3032","Ason","M",8,5,13
"3033","Aspen","F",874,896,1770
"3034","Aspen","M",87,94,181
"3035","Aspyn","F",132,145,277
"3036","Aspynn","F",17,19,36
"3037","Asra","F",16,18,34
"3038","Asriel","M",17,14,31
"3039","Assata","F",29,23,52
"3040","Asser","M",13,14,27
"3041","Astella","F",5,17,22
"3042","Aster","F",41,27,68
"3043","Asteria","F",8,5,13
"3044","Astin","M",10,8,18
"3045","Aston","M",178,160,338
"3046","Astor","M",5,7,12
"3047","Astoria","F",16,19,35
"3048","Astra","F",11,19,30
"3049","Astraea","F",17,21,38
"3050","Astraeus","M",5,5,10
"3051","Astrid","F",311,363,674
"3052","Astryd","F",8,6,14
"3053","Astyn","F",6,7,13
"3054","Asuna","F",11,24,35
"3055","Asya","F",30,32,62
"3056","Asyah","F",5,9,14
"3057","Ata","M",14,10,24
"3058","Atalaya","F",8,10,18
"3059","Atalee","F",5,6,11
"3060","Atalia","F",27,39,66
"3061","Atalie","F",16,20,36
"3062","Atara","F",38,43,81
"3063","Atarah","F",30,33,63
"3064","Athalia","F",35,35,70
"3065","Athaliah","F",6,16,22
"3066","Athan","M",89,89,178
"3067","Athanasia","F",8,7,15
"3068","Athanasios","M",18,23,41
"3069","Athanasius","M",16,15,31
"3070","Atharv","M",91,121,212
"3071","Atharva","M",46,42,88
"3072","Athea","F",13,15,28
"3073","Athen","M",29,43,72
"3074","Athena","F",2046,2162,4208
"3075","Athenarose","F",6,6,12
"3076","Athenea","F",7,5,12
"3077","Athenna","F",9,8,17
"3078","Athens","M",8,7,15
"3079","Athina","F",12,24,36
"3080","Athira","F",8,16,24
"3081","Athyna","F",7,8,15
"3082","Athziri","F",14,25,39
"3083","Athziry","F",13,11,24
"3084","Atia","F",7,7,14
"3085","Atif","M",8,7,15
"3086","Atiya","F",8,9,17
"3087","Atiyah","F",5,5,10
"3088","Atlanta","F",8,6,14
"3089","Atlantis","F",10,8,18
"3090","Atlas","F",30,27,57
"3091","Atlas","M",599,787,1386
"3092","Atlee","F",27,27,54
"3093","Atlee","M",31,18,49
"3094","Atleigh","F",8,11,19
"3095","Atley","F",50,40,90
"3096","Atley","M",33,18,51
"3097","Atom","M",49,57,106
"3098","Atreya","M",6,7,13
"3099","Atreyu","M",133,147,280
"3100","Attalie","F",8,5,13
"3101","Attica","F",5,6,11
"3102","Atticus","M",974,914,1888
"3103","Attikus","M",14,16,30
"3104","Attila","M",7,9,16
"3105","Attilio","M",6,5,11
"3106","Atzel","M",5,13,18
"3107","Atziri","F",26,33,59
"3108","Atziry","F",17,17,34
"3109","Aubery","F",10,9,19
"3110","Aubin","M",9,5,14
"3111","Aubre","F",34,36,70
"3112","Aubrea","F",12,9,21
"3113","Aubreana","F",16,7,23
"3114","Aubreanna","F",27,19,46
"3115","Aubree","F",3622,3390,7012
"3116","Aubreeanna","F",6,7,13
"3117","Aubrei","F",54,48,102
"3118","Aubreigh","F",126,112,238
"3119","Aubrey","F",7376,6507,13883
"3120","Aubrey","M",147,130,277
"3121","Aubreyana","F",12,13,25
"3122","Aubreyanna","F",26,13,39
"3123","Aubreyella","F",11,11,22
"3124","Aubreyrose","F",8,5,13
"3125","Aubri","F",265,274,539
"3126","Aubria","F",6,7,13
"3127","Aubriana","F",219,159,378
"3128","Aubrianna","F",269,244,513
"3129","Aubrianne","F",8,6,14
"3130","Aubriauna","F",5,5,10
"3131","Aubrie","F",677,645,1322
"3132","Aubriee","F",30,27,57
"3133","Aubriel","F",26,31,57
"3134","Aubriella","F",278,305,583
"3135","Aubrielle","F",362,378,740
"3136","Aubrii","F",23,30,53
"3137","Aubrina","F",12,6,18
"3138","Aubrionna","F",10,7,17
"3139","Aubry","F",89,85,174
"3140","Aubry","M",9,7,16
"3141","Aubryana","F",14,20,34
"3142","Aubryanna","F",19,14,33
"3143","Aubryella","F",5,6,11
"3144","Aubryn","F",22,20,42
"3145","Aubrynn","F",12,6,18
"3146","Auburn","F",52,34,86
"3147","Auburn","M",5,6,11
"3148","Audelia","F",7,5,12
"3149","Auden","F",63,41,104
"3150","Auden","M",90,104,194
"3151","Audi","F",19,13,32
"3152","Audi","M",10,5,15
"3153","Audianna","F",7,9,16
"3154","Audie","F",21,24,45
"3155","Audie","M",30,28,58
"3156","Audiel","M",7,5,12
"3157","Audin","M",5,5,10
"3158","Audra","F",192,174,366
"3159","Audreanna","F",6,5,11
"3160","Audree","F",173,158,331
"3161","Audrena","F",5,7,12
"3162","Audrey","F",5600,5330,10930
"3163","Audrey","M",14,7,21
"3164","Audreyana","F",5,13,18
"3165","Audreyanna","F",15,11,26
"3166","Audri","F",51,53,104
"3167","Audria","F",13,12,25
"3168","Audriana","F",247,255,502
"3169","Audrianna","F",215,188,403
"3170","Audric","M",27,30,57
"3171","Audrick","M",10,14,24
"3172","Audrie","F",93,92,185
"3173","Audriella","F",16,14,30
"3174","Audrielle","F",23,25,48
"3175","Audrina","F",410,383,793
"3176","Audrinna","F",15,9,24
"3177","Audry","F",22,13,35
"3178","Audryana","F",7,7,14
"3179","Audryanna","F",7,5,12
"3180","Audryna","F",9,7,16
"3181","Audyn","F",12,11,23
"3182","Auggie","M",6,13,19
"3183","Augie","M",7,11,18
"3184","August","F",244,222,466
"3185","August","M",2080,2076,4156
"3186","Augusta","F",48,25,73
"3187","Auguste","M",20,18,38
"3188","Augusten","M",16,10,26
"3189","Augustin","M",76,55,131
"3190","Augustina","F",14,17,31
"3191","Augustine","F",26,27,53
"3192","Augustine","M",276,334,610
"3193","Augustino","M",7,9,16
"3194","Augusto","M",29,26,55
"3195","Augustus","M",645,667,1312
"3196","Aukai","M",5,7,12
"3197","Aulani","F",57,60,117
"3198","Aulden","M",8,8,16
"3199","Aum","M",7,13,20
"3200","Auna","F",26,16,42
"3201","Aunalee","F",7,5,12
"3202","Aundraya","F",8,5,13
"3203","Aundre","M",15,17,32
"3204","Aundrea","F",45,44,89
"3205","Aundreya","F",5,6,11
"3206","Aunesti","F",13,11,24
"3207","Aunesty","F",16,14,30
"3208","Aung","M",6,8,14
"3209","Aunika","F",11,11,22
"3210","Aunisty","F",12,12,24
"3211","Aunna","F",30,12,42
"3212","Aura","F",94,99,193
"3213","Aurbree","F",8,5,13
"3214","Aurea","F",30,19,49
"3215","Auree","F",7,6,13
"3216","Aurelia","F",351,431,782
"3217","Aureliano","M",5,13,18
"3218","Aurelie","F",19,20,39
"3219","Aurelio","M",96,114,210
"3220","Aurelius","M",40,48,88
"3221","Auren","M",5,8,13
"3222","Auri","F",36,56,92
"3223","Auri","M",5,5,10
"3224","Auria","F",66,75,141
"3225","Auriah","F",12,10,22
"3226","Auriana","F",28,23,51
"3227","Aurianna","F",32,24,56
"3228","Aurie","F",24,37,61
"3229","Auriel","F",25,27,52
"3230","Auriella","F",35,37,72
"3231","Aurielle","F",46,53,99
"3232","Auron","M",47,47,94
"3233","Aurora","F",3632,3963,7595
"3234","Aurorah","F",12,18,30
"3235","Aury","F",6,9,15
"3236","Ausar","M",11,13,24
"3237","Auset","F",19,22,41
"3238","Austen","F",61,91,152
"3239","Austen","M",120,94,214
"3240","Austin","F",153,116,269
"3241","Austin","M",5791,5334,11125
"3242","Auston","M",38,38,76
"3243","Austyn","F",243,227,470
"3244","Austyn","M",103,105,208
"3245","Austynn","F",28,23,51
"3246","Autry","F",13,5,18
"3247","Autry","M",7,7,14
"3248","Autum","F",32,29,61
"3249","Autumn","F",4108,3990,8098
"3250","Autumnrose","F",11,11,22
"3251","Autym","F",6,6,12
"3252","Autymn","F",16,9,25
"3253","Ava","F",16340,16237,32577
"3254","Ava","M",19,10,29
"3255","Avaa","F",7,7,14
"3256","Avabella","F",5,5,10
"3257","Avabelle","F",7,9,16
"3258","Avacyn","F",22,41,63
"3259","Avaeh","F",5,7,12
"3260","Avagail","F",9,12,21
"3261","Avagrace","F",46,35,81
"3262","Avah","F",434,403,837
"3263","Avahlynn","F",5,8,13
"3264","Avaiah","F",11,16,27
"3265","Avaiyah","F",10,11,21
"3266","Avalee","F",88,109,197
"3267","Avaleen","F",14,21,35
"3268","Avalei","F",5,8,13
"3269","Avaleigh","F",76,62,138
"3270","Avalena","F",5,8,13
"3271","Avalene","F",23,28,51
"3272","Avaley","F",11,9,20
"3273","Avalie","F",8,6,14
"3274","Avalin","F",5,7,12
"3275","Avalina","F",33,35,68
"3276","Avaline","F",23,47,70
"3277","Avalon","F",151,153,304
"3278","Avalyn","F",273,260,533
"3279","Avalynn","F",311,318,629
"3280","Avalynne","F",20,15,35
"3281","Avalyse","F",6,6,12
"3282","Avamae","F",14,8,22
"3283","Avamarie","F",89,91,180
"3284","Avan","M",57,40,97
"3285","Avana","F",22,14,36
"3286","Avaneesh","M",17,10,27
"3287","Avanelle","F",10,10,20
"3288","Avangelina","F",6,7,13
"3289","Avangeline","F",19,29,48
"3290","Avani","F",134,140,274
"3291","Avanna","F",14,16,30
"3292","Avannah","F",7,6,13
"3293","Avanni","F",9,7,16
"3294","Avant","M",15,25,40
"3295","Avante","M",5,11,16
"3296","Avanthika","F",9,15,24
"3297","Avantika","F",19,20,39
"3298","Avarae","F",16,11,27
"3299","Avaree","F",36,28,64
"3300","Avarey","F",9,8,17
"3301","Avari","F",50,30,80
"3302","Avari","M",8,8,16
"3303","Avarie","F",129,114,243
"3304","Avarose","F",42,38,80
"3305","Avary","F",87,78,165
"3306","Avaya","F",87,85,172
"3307","Avayah","F",63,69,132
"3308","Avayla","F",6,7,13
"3309","Ave","F",12,29,41
"3310","Avea","F",12,17,29
"3311","Aveah","F",42,50,92
"3312","Aveen","F",6,5,11
"3313","Aveena","F",7,14,21
"3314","Aveer","M",21,40,61
"3315","Avel","M",9,10,19
"3316","Avelardo","M",8,7,15
"3317","Aveleen","F",11,10,21
"3318","Avelina","F",48,64,112
"3319","Aveline","F",100,179,279
"3320","Avelino","M",9,9,18
"3321","Avelyn","F",81,90,171
"3322","Avelynn","F",26,36,62
"3323","Aven","F",85,86,171
"3324","Aven","M",134,144,278
"3325","Avena","F",7,7,14
"3326","Avenir","M",22,26,48
"3327","Avenly","F",13,11,24
"3328","Aveon","M",16,9,25
"3329","Averee","F",57,62,119
"3330","Avereigh","F",8,5,13
"3331","Averett","M",9,5,14
"3332","Averey","F",37,23,60
"3333","Averey","M",8,9,17
"3334","Averi","F",398,356,754
"3335","Averi","M",22,17,39
"3336","Averiana","F",10,14,24
"3337","Averianna","F",8,14,22
"3338","Averie","F",839,782,1621
"3339","Averie","M",11,8,19
"3340","Averii","F",5,10,15
"3341","Averlee","F",11,18,29
"3342","Averleigh","F",11,11,22
"3343","Averley","F",11,11,22
"3344","Averly","F",33,42,75
"3345","Avery","F",9330,8733,18063
"3346","Avery","M",2208,2099,4307
"3347","Averyana","F",13,14,27
"3348","Averyanna","F",13,12,25
"3349","Averylynn","F",6,5,11
"3350","Averyonna","F",5,5,10
"3351","Averyrose","F",13,6,19
"3352","Avett","M",50,60,110
"3353","Avey","F",14,10,24
"3354","Aveya","F",20,21,41
"3355","Aveyah","F",15,29,44
"3356","Avi","F",37,33,70
"3357","Avi","M",223,219,442
"3358","Avia","F",103,113,216
"3359","Aviah","F",40,24,64
"3360","Avian","F",8,9,17
"3361","Avian","M",73,88,161
"3362","Aviana","F",430,839,1269
"3363","Avianah","F",22,27,49
"3364","Avianna","F",374,703,1077
"3365","Aviannah","F",19,22,41
"3366","Aviary","F",5,5,10
"3367","Avie","F",40,46,86
"3368","Aviel","M",42,47,89
"3369","Aviela","F",13,17,30
"3370","Aviella","F",20,20,40
"3371","Avielle","F",33,34,67
"3372","Avien","M",14,12,26
"3373","Aviendha","F",11,15,26
"3374","Avier","M",5,7,12
"3375","Avigail","F",98,112,210
"3376","Avigayil","F",29,26,55
"3377","Avigdor","M",15,18,33
"3378","Avik","M",19,28,47
"3379","Avika","F",38,50,88
"3380","Avila","F",38,37,75
"3381","Avilene","F",7,11,18
"3382","Avilyn","F",9,10,19
"3383","Avilynn","F",10,6,16
"3384","Avin","F",5,5,10
"3385","Avin","M",40,56,96
"3386","Avina","F",17,12,29
"3387","Avinash","M",29,24,53
"3388","Avion","F",9,6,15
"3389","Avion","M",128,125,253
"3390","Aviona","F",25,24,49
"3391","Avionna","F",39,71,110
"3392","Avir","M",9,20,29
"3393","Avira","F",12,13,25
"3394","Aviraj","M",15,16,31
"3395","Aviree","F",6,5,11
"3396","Avis","F",14,8,22
"3397","Avis","M",6,9,15
"3398","Avish","M",9,7,16
"3399","Avisha","F",12,9,21
"3400","Avishai","M",14,8,22
"3401","Avitaj","M",5,13,18
"3402","Avital","F",22,17,39
"3403","Aviv","F",14,11,25
"3404","Aviv","M",19,30,49
"3405","Aviva","F",117,105,222
"3406","Aviya","F",24,26,50
"3407","Aviyah","F",18,26,44
"3408","Aviyana","F",9,14,23
"3409","Aviyanna","F",7,15,22
"3410","Aviyon","M",7,10,17
"3411","Avleen","F",40,34,74
"3412","Avlyn","F",5,6,11
"3413","Avlynn","F",9,10,19
"3414","Avneesh","M",5,6,11
"3415","Avneet","F",28,14,42
"3416","Avner","M",26,15,41
"3417","Avni","F",78,59,137
"3418","Avnoor","F",16,21,37
"3419","Avon","M",9,14,23
"3420","Avondre","M",6,8,14
"3421","Avonlea","F",90,82,172
"3422","Avonna","F",13,19,32
"3423","Avontae","M",9,5,14
"3424","Avorie","F",7,6,13
"3425","Avory","F",20,24,44
"3426","Avory","M",21,14,35
"3427","Avraham","M",137,136,273
"3428","Avraj","M",16,11,27
"3429","Avram","M",28,24,52
"3430","Avree","F",27,26,53
"3431","Avreet","F",5,7,12
"3432","Avrey","F",12,12,24
"3433","Avri","F",55,35,90
"3434","Avrian","M",9,5,14
"3435","Avriana","F",14,9,23
"3436","Avrianna","F",17,12,29
"3437","Avrie","F",48,40,88
"3438","Avriel","F",6,7,13
"3439","Avriella","F",7,6,13
"3440","Avrielle","F",12,16,28
"3441","Avril","F",129,124,253
"3442","Avrohom","M",90,102,192
"3443","Avrum","M",17,24,41
"3444","Avry","F",30,21,51
"3445","Avry","M",11,19,30
"3446","Avy","F",17,13,30
"3447","Avya","F",8,10,18
"3448","Avyaan","M",55,58,113
"3449","Avyan","M",51,76,127
"3450","Avyana","F",25,35,60
"3451","Avyanna","F",74,75,149
"3452","Avyay","M",14,10,24
"3453","Avyn","F",22,28,50
"3454","Avyn","M",12,20,32
"3455","Avynn","F",5,9,14
"3456","Avyon","M",5,7,12
"3457","Avyukt","M",35,25,60
"3458","Avyukth","M",38,35,73
"3459","Awa","F",26,29,55
"3460","Awab","M",18,20,38
"3461","Awad","M",5,5,10
"3462","Awesome","M",11,8,19
"3463","Aws","M",19,16,35
"3464","Axavier","M",13,6,19
"3465","Axcel","M",18,13,31
"3466","Axel","F",12,10,22
"3467","Axel","M",3236,3441,6677
"3468","Axell","M",26,26,52
"3469","Axelle","F",10,9,19
"3470","Axeton","M",6,11,17
"3471","Axiel","M",14,12,26
"3472","Axil","M",11,12,23
"3473","Axl","M",312,304,616
"3474","Axle","M",124,132,256
"3475","Axten","M",13,11,24
"3476","Axtin","M",8,8,16
"3477","Axton","M",359,338,697
"3478","Axtyn","M",21,17,38
"3479","Axxel","M",13,8,21
"3480","Axyl","M",37,45,82
"3481","Axzel","M",6,7,13
"3482","Aya","F",308,322,630
"3483","Ayaan","F",9,8,17
"3484","Ayaan","M",416,424,840
"3485","Ayaana","F",13,17,30
"3486","Ayaansh","M",32,74,106
"3487","Ayaat","F",18,19,37
"3488","Ayad","M",7,15,22
"3489","Ayah","F",148,167,315
"3490","Ayak","F",6,5,11
"3491","Ayaka","F",12,11,23
"3492","Ayala","F",38,44,82
"3493","Ayame","F",14,8,22
"3494","Ayan","F",20,35,55
"3495","Ayan","M",204,176,380
"3496","Ayana","F",256,273,529
"3497","Ayanah","F",14,15,29
"3498","Ayane","F",15,17,32
"3499","Ayani","F",17,15,32
"3500","Ayanna","F",244,242,486
"3501","Ayannah","F",15,18,33
"3502","Ayanni","F",6,9,15
"3503","Ayansh","M",64,89,153
"3504","Ayari","F",12,12,24
"3505","Ayasha","F",5,10,15
"3506","Ayat","F",55,68,123
"3507","Ayaz","M",13,9,22
"3508","Aybel","M",11,7,18
"3509","Ayce","M",23,39,62
"3510","Aycen","M",25,22,47
"3511","Ayda","F",54,65,119
"3512","Aydah","F",6,11,17
"3513","Aydan","M",214,201,415
"3514","Aydden","M",12,10,22
"3515","Aydeen","M",7,10,17
"3516","Ayden","F",73,57,130
"3517","Ayden","M",4873,4472,9345
"3518","Aydenn","M",60,34,94
"3519","Aydian","M",7,6,13
"3520","Aydien","M",15,7,22
"3521","Aydin","M",287,277,564
"3522","Aydon","M",47,25,72
"3523","Aydrian","M",28,20,48
"3524","Aydrien","M",13,13,26
"3525","Aydyn","M",14,16,30
"3526","Ayeden","M",12,6,18
"3527","Ayelen","F",63,41,104
"3528","Ayelet","F",41,33,74
"3529","Ayen","F",6,6,12
"3530","Ayesha","F",151,177,328
"3531","Ayeza","F",10,19,29
"3532","Ayham","M",23,18,41
"3533","Ayiana","F",28,22,50
"3534","Ayianna","F",16,13,29
"3535","Ayiden","M",11,5,16
"3536","Ayinde","M",6,6,12
"3537","Ayisha","F",16,9,25
"3538","Ayla","F",1199,1226,2425
"3539","Aylah","F",85,96,181
"3540","Aylan","M",65,96,161
"3541","Aylana","F",13,10,23
"3542","Aylani","F",43,38,81
"3543","Aylanie","F",7,12,19
"3544","Aylee","F",33,23,56
"3545","Ayleen","F",342,361,703
"3546","Aylen","F",49,56,105
"3547","Aylen","M",5,9,14
"3548","Aylene","F",17,17,34
"3549","Ayliana","F",7,10,17
"3550","Aylie","F",6,6,12
"3551","Aylin","F",893,761,1654
"3552","Aylin","M",6,7,13
"3553","Ayline","F",17,12,29
"3554","Aylinn","F",25,15,40
"3555","Aylla","F",6,10,16
"3556","Ayman","M",77,75,152
"3557","Aymar","F",7,8,15
"3558","Aymee","F",12,5,17
"3559","Aymen","M",25,19,44
"3560","Aynslee","F",13,10,23
"3561","Aynsleigh","F",6,6,12
"3562","Aynsley","F",11,5,16
"3563","Ayo","M",6,7,13
"3564","Ayodeji","M",8,9,17
"3565","Ayomide","F",28,19,47
"3566","Ayomide","M",33,28,61
"3567","Ayomikun","M",8,11,19
"3568","Ayomiposi","F",7,5,12
"3569","Ayonna","F",23,20,43
"3570","Ayotunde","M",6,9,15
"3571","Ayoub","M",39,38,77
"3572","Ayra","F",59,80,139
"3573","Ayrabella","F",24,13,37
"3574","Ayren","M",7,8,15
"3575","Ayriana","F",17,10,27
"3576","Ayrianna","F",11,7,18
"3577","Ayrin","F",5,8,13
"3578","Ayris","F",5,14,19
"3579","Ayron","M",9,5,14
"3580","Ayrton","M",46,40,86
"3581","Aysa","F",7,7,14
"3582","Ayse","F",24,20,44
"3583","Aysel","F",16,16,32
"3584","Aysen","M",13,15,28
"3585","Aysha","F",51,59,110
"3586","Aysia","F",50,40,90
"3587","Ayslin","F",8,9,17
"3588","Ayson","M",32,42,74
"3589","Aytana","F",14,13,27
"3590","Aythan","M",8,7,15
"3591","Ayub","M",74,83,157
"3592","Ayumi","F",23,24,47
"3593","Ayush","M",76,68,144
"3594","Ayushi","F",13,9,22
"3595","Ayuub","M",9,14,23
"3596","Ayva","F",259,221,480
"3597","Ayvah","F",144,140,284
"3598","Ayven","M",33,38,71
"3599","Ayvin","M",8,10,18
"3600","Ayvion","M",8,13,21
"3601","Ayvree","F",7,6,13
"3602","Ayza","F",18,14,32
"3603","Ayzah","F",8,5,13
"3604","Ayzlee","F",9,7,16
"3605","Aza","F",18,16,34
"3606","Azaan","M",48,69,117
"3607","Azad","M",16,13,29
"3608","Azael","M",122,112,234
"3609","Azaelia","F",6,5,11
"3610","Azai","M",12,39,51
"3611","Azaiah","F",11,11,22
"3612","Azaiah","M",97,80,177
"3613","Azalaya","F",5,5,10
"3614","Azalea","F",520,520,1040
"3615","Azaleah","F",32,36,68
"3616","Azalee","F",19,19,38
"3617","Azaleigh","F",5,8,13
"3618","Azalia","F",67,56,123
"3619","Azaliah","F",41,24,65
"3620","Azaliyah","F",9,9,18
"3621","Azalya","F",11,8,19
"3622","Azalyn","F",9,11,20
"3623","Azalynn","F",15,12,27
"3624","Azam","M",10,6,16
"3625","Azan","M",9,21,30
"3626","Azani","F",5,5,10
"3627","Azar","M",5,7,12
"3628","Azara","F",15,27,42
"3629","Azarah","F",13,16,29
"3630","Azarel","M",6,6,12
"3631","Azari","F",59,61,120
"3632","Azari","M",21,33,54
"3633","Azaria","F",288,270,558
"3634","Azaria","M",14,14,28
"3635","Azariah","F",326,361,687
"3636","Azariah","M",359,295,654
"3637","Azarian","M",8,8,16
"3638","Azarias","M",27,27,54
"3639","Azarie","F",8,9,17
"3640","Azariel","M",6,5,11
"3641","Azarion","M",14,15,29
"3642","Azarius","M",16,15,31
"3643","Azariya","F",13,10,23
"3644","Azariyah","F",42,36,78
"3645","Azariyah","M",5,8,13
"3646","Azaryah","F",13,12,25
"3647","Azaryah","M",6,14,20
"3648","Azavier","M",8,8,16
"3649","Azaya","F",14,7,21
"3650","Azayla","F",31,23,54
"3651","Azaylah","F",10,9,19
"3652","Azaylea","F",11,10,21
"3653","Azaylee","F",9,7,16
"3654","Azaylia","F",18,12,30
"3655","Azazel","M",23,29,52
"3656","Azealia","F",9,10,19
"3657","Azeem","M",17,18,35
"3658","Azel","F",7,11,18
"3659","Azel","M",18,10,28
"3660","Azelea","F",5,13,18
"3661","Azelia","F",25,19,44
"3662","Azelie","F",18,16,34
"3663","Azella","F",5,6,11
"3664","Azelle","F",11,6,17
"3665","Azelyn","F",9,5,14
"3666","Azeneth","F",59,66,125
"3667","Azeriah","F",5,5,10
"3668","Azhar","F",10,9,19
"3669","Azhar","M",10,8,18
"3670","Azia","F",16,16,32
"3671","Aziah","F",27,26,53
"3672","Aziah","M",42,37,79
"3673","Aziel","M",65,93,158
"3674","Azim","M",12,17,29
"3675","Azion","M",20,16,36
"3676","Azir","M",12,22,34
"3677","Azirah","F",5,9,14
"3678","Aziya","F",19,22,41
"3679","Aziyah","F",68,74,142
"3680","Aziz","M",55,63,118
"3681","Aziza","F",45,52,97
"3682","Azizah","F",8,8,16
"3683","Azlaan","M",14,17,31
"3684","Azlan","M",35,36,71
"3685","Azlin","F",6,9,15
"3686","Azlyn","F",64,39,103
"3687","Azlynn","F",74,62,136
"3688","Azmariah","F",5,8,13
"3689","Azmina","F",11,7,18
"3690","Azora","F",7,10,17
"3691","Azori","F",7,8,15
"3692","Azra","F",52,50,102
"3693","Azrael","F",13,16,29
"3694","Azrael","M",63,113,176
"3695","Azrah","F",7,6,13
"3696","Azreal","M",11,7,18
"3697","Azriel","F",20,25,45
"3698","Azriel","M",103,125,228
"3699","Azriella","F",8,6,14
"3700","Azrielle","F",15,21,36
"3701","Azucena","F",48,42,90
"3702","Azul","F",162,113,275
"3703","Azul","M",8,14,22
"3704","Azula","F",14,10,24
"3705","Azura","F",29,40,69
"3706","Azure","F",35,26,61
"3707","Azure","M",16,15,31
"3708","Azuri","F",38,49,87
"3709","Azyah","F",7,5,12
"3710","Azyiah","F",7,15,22
"3711","Azyria","F",6,7,13
"3712","Azyriah","F",8,6,14
"3713","Azzam","M",15,21,36
"3714","Baani","F",9,11,20
"3715","Babacar","M",12,10,22
"3716","Baby","F",18,9,27
"3717","Baby","M",10,5,15
"3718","Babyboy","M",14,7,21
"3719","Babygirl","F",15,7,22
"3720","Baden","M",7,14,21
"3721","Bader","M",13,14,27
"3722","Badr","M",18,12,30
"3723","Baelynn","F",7,10,17
"3724","Baer","M",17,16,33
"3725","Bahar","F",27,26,53
"3726","Bahja","F",6,5,11
"3727","Baila","F",124,113,237
"3728","Bailea","F",5,7,12
"3729","Bailee","F",560,518,1078
"3730","Bailei","F",7,7,14
"3731","Baileigh","F",88,91,179
"3732","Bailen","M",7,6,13
"3733","Bailey","F",2833,2689,5522
"3734","Bailey","M",109,109,218
"3735","Bailie","F",12,13,25
"3736","Bailor","F",5,5,10
"3737","Baily","F",17,8,25
"3738","Bailyn","F",12,12,24
"3739","Bailynn","F",11,15,26
"3740","Bain","M",17,18,35
"3741","Baine","M",15,19,34
"3742","Baird","M",9,5,14
"3743","Bairon","M",11,8,19
"3744","Bakari","M",25,25,50
"3745","Baker","F",10,19,29
"3746","Baker","M",86,156,242
"3747","Baldemar","M",10,13,23
"3748","Baldwin","M",6,6,12
"3749","Baleigh","F",42,50,92
"3750","Balen","M",14,8,22
"3751","Balian","M",28,13,41
"3752","Balin","M",12,7,19
"3753","Baltazar","M",24,33,57
"3754","Balthazar","M",13,10,23
"3755","Bana","F",12,14,26
"3756","Bandar","M",7,6,13
"3757","Bane","M",92,72,164
"3758","Baneen","F",8,7,15
"3759","Bani","F",15,13,28
"3760","Banjamin","M",5,6,11
"3761","Banks","M",106,126,232
"3762","Bankston","M",7,7,14
"3763","Banner","M",39,44,83
"3764","Bannon","M",13,16,29
"3765","Banx","M",9,12,21
"3766","Banyan","M",26,22,48
"3767","Bao","M",22,18,40
"3768","Baraa","M",7,9,16
"3769","Barack","M",8,19,27
"3770","Barak","M",7,8,15
"3771","Baraka","M",14,16,30
"3772","Baran","F",8,5,13
"3773","Baran","M",14,10,24
"3774","Barbara","F",321,326,647
"3775","Barbie","F",34,27,61
"3776","Barett","M",9,9,18
"3777","Baris","M",6,6,12
"3778","Barkon","M",7,6,13
"3779","Barnabas","M",15,13,28
"3780","Barnes","M",8,5,13
"3781","Barney","M",6,7,13
"3782","Baron","M",133,134,267
"3783","Barret","M",31,28,59
"3784","Barrett","F",25,16,41
"3785","Barrett","M",1140,1379,2519
"3786","Barrick","M",6,9,15
"3787","Barrington","M",13,16,29
"3788","Barron","M",74,94,168
"3789","Barry","M",141,169,310
"3790","Bart","M",6,5,11
"3791","Bartholomew","M",19,17,36
"3792","Bartolo","M",6,6,12
"3793","Barton","M",5,17,22
"3794","Baruch","M",47,43,90
"3795","Basel","M",11,9,20
"3796","Basem","M",5,5,10
"3797","Bashar","M",12,6,18
"3798","Bashir","M",25,31,56
"3799","Basil","F",16,22,38
"3800","Basil","M",52,60,112
"3801","Basilio","M",12,7,19
"3802","Basir","M",5,7,12
"3803","Basma","F",23,27,50
"3804","Bassam","M",28,19,47
"3805","Bassel","M",10,9,19
"3806","Bastian","M",143,186,329
"3807","Bastien","M",12,17,29
"3808","Bastion","M",15,18,33
"3809","Basya","F",25,35,60
"3810","Bates","M",8,8,16
"3811","Batool","F",14,24,38
"3812","Batoul","F",23,22,45
"3813","Batsheva","F",84,78,162
"3814","Battal","M",11,11,22
"3815","Batu","M",11,6,17
"3816","Batya","F",25,22,47
"3817","Bauer","M",34,43,77
"3818","Bawi","F",9,6,15
"3819","Bawi","M",32,20,52
"3820","Baxley","F",6,9,15
"3821","Baxter","M",68,59,127
"3822","Baxton","M",5,8,13
"3823","Bay","F",58,33,91
"3824","Bay","M",11,8,19
"3825","Baya","F",12,19,31
"3826","Bayan","F",36,42,78
"3827","Bayani","M",7,7,14
"3828","Bayden","M",9,7,16
"3829","Bayla","F",51,54,105
"3830","Baylea","F",12,8,20
"3831","Baylee","F",788,626,1414
"3832","Baylei","F",27,17,44
"3833","Bayleigh","F",244,206,450
"3834","Baylen","F",10,5,15
"3835","Baylen","M",43,49,92
"3836","Bayler","F",16,11,27
"3837","Bayler","M",16,21,37
"3838","Bayley","F",41,56,97
"3839","Bayli","F",18,11,29
"3840","Baylie","F",70,70,140
"3841","Baylin","F",12,8,20
"3842","Baylin","M",13,16,29
"3843","Baylon","M",16,12,28
"3844","Baylor","F",215,209,424
"3845","Baylor","M",280,339,619
"3846","Baylyn","F",8,10,18
"3847","Baylynn","F",12,14,26
"3848","Bayne","M",52,46,98
"3849","Bayron","M",56,63,119
"3850","Bea","F",25,46,71
"3851","Bear","M",134,186,320
"3852","Bearett","M",12,20,32
"3853","Beatrice","F",540,553,1093
"3854","Beatrix","F",213,209,422
"3855","Beatriz","F",105,138,243
"3856","Beau","F",44,41,85
"3857","Beau","M",1969,2113,4082
"3858","Beauden","M",14,16,30
"3859","Beaumont","M",9,10,19
"3860","Beauregard","M",28,42,70
"3861","Beautiful","F",50,55,105
"3862","Beautifull","F",11,9,20
"3863","Beauty","F",12,13,25
"3864","Beaux","F",20,19,39
"3865","Beaux","M",98,119,217
"3866","Bebe","F",10,7,17
"3867","Becca","F",69,62,131
"3868","Beck","M",148,168,316
"3869","Becka","F",6,6,12
"3870","Beckam","M",71,67,138
"3871","Beckem","M",12,18,30
"3872","Becker","M",26,25,51
"3873","Becket","M",24,41,65
"3874","Beckett","F",99,93,192
"3875","Beckett","M",1817,1827,3644
"3876","Beckham","F",16,11,27
"3877","Beckham","M",922,1114,2036
"3878","Beckhem","M",8,9,17
"3879","Beckley","F",10,8,18
"3880","Beckum","M",5,5,10
"3881","Becky","F",58,43,101
"3882","Behr","M",14,16,30
"3883","Behrett","M",6,6,12
"3884","Bekah","F",6,8,14
"3885","Bela","F",16,25,41
"3886","Bela","M",7,6,13
"3887","Belal","M",17,21,38
"3888","Belen","F",296,373,669
"3889","Belia","F",5,9,14
"3890","Belicia","F",7,5,12
"3891","Belinda","F",192,182,374
"3892","Belize","F",5,7,12
"3893","Bella","F",3778,3641,7419
"3894","Bellaann","F",5,6,11
"3895","Belladonna","F",17,22,39
"3896","Bellagrace","F",10,11,21
"3897","Bellah","F",30,17,47
"3898","Bellamarie","F",21,16,37
"3899","Bellami","F",11,15,26
"3900","Bellamie","F",15,17,32
"3901","Bellamy","F",184,231,415
"3902","Bellamy","M",24,56,80
"3903","Bellanie","F",9,8,17
"3904","Bellany","F",14,13,27
"3905","Bellarose","F",60,68,128
"3906","Bellatrix","F",5,24,29
"3907","Belle","F",249,291,540
"3908","Bemnet","F",6,12,18
"3909","Ben","M",330,347,677
"3910","Benaiah","M",121,123,244
"3911","Bence","M",8,6,14
"3912","Benedict","M",152,151,303
"3913","Benelli","F",13,12,25
"3914","Benett","M",11,5,16
"3915","Beni","F",5,6,11
"3916","Beni","M",9,5,14
"3917","Beniah","M",14,12,26
"3918","Benicio","M",132,208,340
"3919","Benita","F",22,14,36
"3920","Benito","M",87,79,166
"3921","Benjamen","M",13,25,38
"3922","Benjamin","F",18,12,30
"3923","Benjamin","M",13670,14569,28239
"3924","Benjamyn","M",12,16,28
"3925","Benjerman","M",5,6,11
"3926","Benji","M",55,49,104
"3927","Benjiman","M",22,18,40
"3928","Bennet","M",54,64,118
"3929","Bennett","F",104,87,191
"3930","Bennett","M",2702,2919,5621
"3931","Bennie","F",6,12,18
"3932","Bennie","M",52,44,96
"3933","Benno","M",12,6,18
"3934","Benny","M",118,121,239
"3935","Benoit","M",7,8,15
"3936","Bensen","M",31,31,62
"3937","Benson","M",629,721,1350
"3938","Bensyn","M",13,29,42
"3939","Bentlee","F",53,59,112
"3940","Bentlee","M",316,277,593
"3941","Bentleigh","F",38,25,63
"3942","Bentleigh","M",8,6,14
"3943","Bentley","F",184,149,333
"3944","Bentley","M",4304,4026,8330
"3945","Bentli","F",6,14,20
"3946","Bentli","M",8,6,14
"3947","Bentlie","F",7,8,15
"3948","Bentlie","M",7,6,13
"3949","Bently","M",140,117,257
"3950","Benton","M",253,275,528
"3951","Bentzion","M",29,14,43
"3952","Benuel","M",28,15,43
"3953","Benyamin","M",32,39,71
"3954","Benz","M",13,8,21
"3955","Benzion","M",33,25,58
"3956","Beorn","M",9,7,16
"3957","Beowulf","M",6,8,14
"3958","Berel","M",6,12,18
"3959","Beren","F",9,7,16
"3960","Beren","M",14,11,25
"3961","Berenice","F",58,89,147
"3962","Beretta","F",13,21,34
"3963","Bergen","F",21,12,33
"3964","Bergen","M",11,8,19
"3965","Beric","M",8,6,14
"3966","Berish","M",14,10,24
"3967","Berit","F",11,16,27
"3968","Berk","M",5,5,10
"3969","Berkeley","F",108,116,224
"3970","Berkeley","M",17,16,33
"3971","Berklee","F",73,105,178
"3972","Berklee","M",5,6,11
"3973","Berkleigh","F",34,42,76
"3974","Berkley","F",242,227,469
"3975","Berkley","M",46,46,92
"3976","Berklie","F",17,12,29
"3977","Berl","M",21,21,42
"3978","Berlin","F",75,75,150
"3979","Berlin","M",11,5,16
"3980","Berlyn","F",30,27,57
"3981","Berlynn","F",25,26,51
"3982","Bernabe","M",13,10,23
"3983","Bernadette","F",154,145,299
"3984","Bernard","M",150,163,313
"3985","Bernardino","M",11,5,16
"3986","Bernardo","M",131,136,267
"3987","Bernice","F",56,53,109
"3988","Bernie","M",11,21,32
"3989","Berny","M",5,6,11
"3990","Berry","M",11,10,21
"3991","Bert","M",12,14,26
"3992","Berta","F",5,5,10
"3993","Bertha","F",30,34,64
"3994","Bertram","M",13,6,19
"3995","Bertrand","M",5,11,16
"3996","Beryl","F",9,9,18
"3997","Besan","F",9,6,15
"3998","Bess","F",6,6,12
"3999","Bessie","F",11,8,19
"4000","Betania","F",14,19,33
"4001","Beth","F",44,39,83
"4002","Bethania","F",14,16,30
"4003","Bethanie","F",33,32,65
"4004","Bethanny","F",12,6,18
"4005","Bethany","F",763,687,1450
"4006","Bethel","F",70,79,149
"4007","Bethlehem","F",24,11,35
"4008","Bethsaida","F",8,8,16
"4009","Betsabe","F",30,32,62
"4010","Betsaida","F",32,31,63
"4011","Betselot","F",5,12,17
"4012","Betsy","F",125,106,231
"4013","Bette","F",9,14,23
"4014","Bettie","F",9,7,16
"4015","Bettina","F",6,13,19
"4016","Betty","F",191,176,367
"4017","Betul","F",10,10,20
"4018","Betzabe","F",8,5,13
"4019","Betzabeth","F",17,6,23
"4020","Betzaida","F",27,17,44
"4021","Betzalel","M",14,10,24
"4022","Betzy","F",14,16,30
"4023","Beulah","F",14,15,29
"4024","Bevan","M",8,5,13
"4025","Beverley","F",5,7,12
"4026","Beverly","F",153,165,318
"4027","Bexlee","F",19,45,64
"4028","Bexleigh","F",12,30,42
"4029","Bexley","F",202,275,477
"4030","Bexley","M",8,13,21
"4031","Bexli","F",5,7,12
"4032","Bexton","M",6,10,16
"4033","Beya","F",14,9,23
"4034","Beyla","F",15,6,21
"4035","Beyonce","F",10,6,16
"4036","Beza","F",7,7,14
"4037","Bezaleel","M",6,5,11
"4038","Bhargav","M",10,9,19
"4039","Bhavik","M",8,9,17
"4040","Bhavika","F",7,9,16
"4041","Bhavin","M",6,8,14
"4042","Bhavya","F",12,17,29
"4043","Bhuvan","M",5,8,13
"4044","Biagio","M",9,6,15
"4045","Biak","F",9,7,16
"4046","Bianca","F",857,849,1706
"4047","Bianey","F",9,9,18
"4048","Bianka","F",41,51,92
"4049","Bibi","F",13,17,30
"4050","Bibiana","F",27,22,49
"4051","Bijan","M",6,10,16
"4052","Bijou","F",10,11,21
"4053","Bilal","M",151,167,318
"4054","Bilen","F",5,8,13
"4055","Bill","M",33,38,71
"4056","Billi","F",8,7,15
"4057","Billie","F",97,96,193
"4058","Billy","M",281,258,539
"4059","Bina","F",20,15,35
"4060","Bindi","F",8,25,33
"4061","Bingham","M",12,13,25
"4062","Binta","F",15,15,30
"4063","Bintou","F",24,27,51
"4064","Bintu","F",6,5,11
"4065","Binyamin","M",40,50,90
"4066","Binyomin","M",48,34,82
"4067","Birch","M",6,11,17
"4068","Birdie","F",64,80,144
"4069","Biruk","M",12,12,24
"4070","Bishop","M",207,187,394
"4071","Bisma","F",5,5,10
"4072","Bitania","F",7,8,15
"4073","Bithiah","F",7,5,12
"4074","Bjorn","M",99,150,249
"4075","Blade","M",44,30,74
"4076","Bladen","M",45,35,80
"4077","Bladimir","M",23,28,51
"4078","Blaiden","M",9,12,21
"4079","Blaike","F",12,18,30
"4080","Blaike","M",6,6,12
"4081","Blaiklee","F",7,8,15
"4082","Blain","M",22,21,43
"4083","Blaine","F",14,19,33
"4084","Blaine","M",399,355,754
"4085","Blair","F",483,594,1077
"4086","Blair","M",70,83,153
"4087","Blaire","F",215,287,502
"4088","Blaise","F",24,24,48
"4089","Blaise","M",283,236,519
"4090","Blaize","F",5,8,13
"4091","Blaize","M",78,71,149
"4092","Blake","F",751,1091,1842
"4093","Blake","M",4220,3269,7489
"4094","Blakelee","F",68,74,142
"4095","Blakeleigh","F",48,58,106
"4096","Blakeley","F",73,60,133
"4097","Blakeli","F",7,13,20
"4098","Blakely","F",918,1173,2091
"4099","Blakely","M",20,20,40
"4100","Blakelyn","F",66,77,143
"4101","Blakelynn","F",36,53,89
"4102","Blaklee","F",9,10,19
"4103","Blakleigh","F",10,10,20
"4104","Blakley","F",23,33,56
"4105","Blanca","F",116,121,237
"4106","Blane","M",39,43,82
"4107","Blas","M",21,23,44
"4108","Blase","M",9,7,16
"4109","Blayde","M",10,8,18
"4110","Blayden","M",51,32,83
"4111","Blayke","F",56,114,170
"4112","Blayke","M",17,20,37
"4113","Blayklee","F",14,11,25
"4114","Blayne","F",17,16,33
"4115","Blayne","M",78,65,143
"4116","Blayre","F",7,5,12
"4117","Blayton","M",5,8,13
"4118","Blayze","F",8,5,13
"4119","Blayze","M",57,60,117
"4120","Blaze","F",16,13,29
"4121","Blaze","M",351,259,610
"4122","Blen","F",27,20,47
"4123","Bless","F",14,16,30
"4124","Bless","M",28,17,45
"4125","Blessed","F",15,13,28
"4126","Blessed","M",7,11,18
"4127","Blessen","F",5,11,16
"4128","Blessin","F",23,21,44
"4129","Blessing","F",184,190,374
"4130","Blessing","M",27,23,50
"4131","Blessings","F",12,12,24
"4132","Blessyn","F",34,28,62
"4133","Bleu","F",6,5,11
"4134","Bleu","M",11,7,18
"4135","Blima","F",36,54,90
"4136","Blimi","F",5,6,11
"4137","Blimie","F",7,5,12
"4138","Blimy","F",30,29,59
"4139","Bliss","F",46,40,86
"4140","Bliss","M",7,5,12
"4141","Blossom","F",41,40,81
"4142","Blu","F",10,12,22
"4143","Blu","M",14,15,29
"4144","Blue","F",20,16,36
"4145","Blue","M",32,23,55
"4146","Bluma","F",18,17,35
"4147","Blyss","F",7,9,16
"4148","Blythe","F",152,168,320
"4149","Blythe","M",6,6,12
"4150","Bo","F",17,27,44
"4151","Bo","M",434,450,884
"4152","Boaz","M",132,157,289
"4153","Bob","M",14,13,27
"4154","Bobbi","F",67,68,135
"4155","Bobbie","F",43,33,76
"4156","Bobby","M",327,313,640
"4157","Bocephus","M",6,6,12
"4158","Bode","M",263,203,466
"4159","Bodee","M",36,31,67
"4160","Boden","M",210,179,389
"4161","Bodey","M",36,22,58
"4162","Bodhi","F",16,37,53
"4163","Bodhi","M",583,909,1492
"4164","Bodhin","M",5,6,11
"4165","Bodi","M",38,48,86
"4166","Bodie","M",213,275,488
"4167","Bodin","M",11,18,29
"4168","Bodyn","M",6,6,12
"4169","Boe","M",39,39,78
"4170","Boen","M",7,10,17
"4171","Bogdan","M",28,23,51
"4172","Bohannon","M",6,16,22
"4173","Bohdan","M",14,27,41
"4174","Bohden","M",9,8,17
"4175","Bohdi","M",20,41,61
"4176","Bolton","M",12,12,24
"4177","Bond","M",5,12,17
"4178","Bonham","M",6,8,14
"4179","Bonita","F",15,19,34
"4180","Bonnie","F",321,309,630
"4181","Booker","M",54,58,112
"4182","Boomer","M",5,12,17
"4183","Boone","M",222,293,515
"4184","Bora","F",12,15,27
"4185","Bora","M",12,17,29
"4186","Boris","M",48,47,95
"4187","Boruch","M",37,28,65
"4188","Bosco","M",25,24,49
"4189","Boss","M",9,14,23
"4190","Bosten","M",5,5,10
"4191","Boston","F",37,49,86
"4192","Boston","M",447,414,861
"4193","Bostyn","F",40,61,101
"4194","Bostyn","M",16,15,31
"4195","Bostynn","F",9,5,14
"4196","Boubacar","M",18,27,45
"4197","Bow","M",17,12,29
"4198","Bowan","M",6,5,11
"4199","Bowden","M",17,32,49
"4200","Bowdy","M",6,8,14
"4201","Bowe","M",12,11,23
"4202","Bowen","F",15,15,30
"4203","Bowen","M",555,636,1191
"4204","Bowie","F",43,75,118
"4205","Bowie","M",53,130,183
"4206","Bowman","M",41,43,84
"4207","Bowyn","M",13,15,28
"4208","Boy","M",26,19,45
"4209","Boyan","M",12,9,21
"4210","Boyce","M",10,13,23
"4211","Boyd","M",81,98,179
"4212","Brace","M",6,5,11
"4213","Bracha","F",91,69,160
"4214","Bracken","M",8,15,23
"4215","Brad","M",88,50,138
"4216","Bradan","M",13,12,25
"4217","Braddock","M",23,31,54
"4218","Braden","M",753,593,1346
"4219","Bradford","M",63,68,131
"4220","Bradie","F",6,10,16
"4221","Bradlee","F",42,30,72
"4222","Bradlee","M",74,55,129
"4223","Bradleigh","F",31,36,67
"4224","Bradley","F",51,58,109
"4225","Bradley","M",2395,2040,4435
"4226","Bradlie","F",7,6,13
"4227","Bradly","M",34,26,60
"4228","Bradon","M",17,12,29
"4229","Brady","F",36,41,77
"4230","Brady","M",2026,1745,3771
"4231","Bradyn","M",122,81,203
"4232","Brae","F",9,8,17
"4233","Braedan","M",21,22,43
"4234","Braeden","M",293,203,496
"4235","Braedon","M",68,37,105
"4236","Braedyn","F",9,12,21
"4237","Braedyn","M",83,75,158
"4238","Braelee","F",28,18,46
"4239","Braeleigh","F",29,37,66
"4240","Braelen","M",11,9,20
"4241","Braeley","F",11,7,18
"4242","Braelin","F",7,6,13
"4243","Braelin","M",15,13,28
"4244","Braelon","M",20,8,28
"4245","Braelyn","F",680,640,1320
"4246","Braelyn","M",78,61,139
"4247","Braelynn","F",682,803,1485
"4248","Braelynn","M",7,14,21
"4249","Braelynne","F",15,16,31
"4250","Braeson","M",8,11,19
"4251","Brahm","M",17,21,38
"4252","Braiden","M",240,233,473
"4253","Braidon","M",11,10,21
"4254","Braidyn","M",37,29,66
"4255","Brailee","F",54,35,89
"4256","Braileigh","F",11,9,20
"4257","Brailen","M",14,14,28
"4258","Brailey","F",51,46,97
"4259","Brailyn","F",53,53,106
"4260","Brailyn","M",19,25,44
"4261","Brailynn","F",60,66,126
"4262","Brais","M",7,6,13
"4263","Braison","M",10,13,23
"4264","Bralee","F",6,5,11
"4265","Braleigh","F",37,29,66
"4266","Bralen","M",11,14,25
"4267","Braley","F",11,7,18
"4268","Bralyn","F",11,18,29
"4269","Bralyn","M",28,17,45
"4270","Bralynn","F",38,43,81
"4271","Bralynn","M",10,9,19
"4272","Bram","M",48,71,119
"4273","Bran","M",12,13,25
"4274","Branch","M",38,74,112
"4275","Brand","M",6,5,11
"4276","Brandan","M",21,19,40
"4277","Brandee","F",11,10,21
"4278","Branden","M",185,150,335
"4279","Brandi","F",108,81,189
"4280","Brandie","F",15,11,26
"4281","Brandin","M",16,16,32
"4282","Brando","M",41,36,77
"4283","Brandon","M",5100,4076,9176
"4284","Brandt","M",114,85,199
"4285","Brandtley","M",8,8,16
"4286","Brandtly","M",7,5,12
"4287","Brandy","F",66,80,146
"4288","Brandy","M",11,12,23
"4289","Brandyn","M",44,29,73
"4290","Braniya","F",5,5,10
"4291","Braniyah","F",7,10,17
"4292","Branna","F",7,6,13
"4293","Brannon","M",33,32,65
"4294","Bransen","M",37,46,83
"4295","Branson","M",359,360,719
"4296","Branston","M",7,12,19
"4297","Bransyn","M",28,26,54
"4298","Brant","M",81,80,161
"4299","Brantlee","F",16,16,32
"4300","Brantlee","M",302,215,517
"4301","Brantleigh","F",20,11,31
"4302","Brantley","F",55,31,86
"4303","Brantley","M",3290,2592,5882
"4304","Brantly","M",62,29,91
"4305","Branton","M",30,14,44
"4306","Brantson","M",10,7,17
"4307","Brasen","M",9,9,18
"4308","Brasi","M",7,5,12
"4309","Brason","M",9,5,14
"4310","Braulio","M",99,92,191
"4311","Braun","M",6,7,13
"4312","Brave","M",21,29,50
"4313","Braven","M",51,51,102
"4314","Bravery","F",10,6,16
"4315","Bravery","M",8,18,26
"4316","Brax","M",23,30,53
"4317","Braxden","M",17,9,26
"4318","Braxley","F",7,7,14
"4319","Braxley","M",10,6,16
"4320","Braxon","M",37,27,64
"4321","Braxson","M",14,12,26
"4322","Braxston","M",21,18,39
"4323","Braxten","M",103,96,199
"4324","Braxtin","M",26,27,53
"4325","Braxton","F",28,31,59
"4326","Braxton","M",3290,3279,6569
"4327","Braxtyn","F",20,30,50
"4328","Braxtyn","M",119,111,230
"4329","Braxxton","M",12,14,26
"4330","Bray","F",6,9,15
"4331","Bray","M",26,21,47
"4332","Braya","F",34,25,59
"4333","Brayah","F",15,10,25
"4334","Brayan","M",461,411,872
"4335","Braycen","M",15,27,42
"4336","Braydan","M",40,38,78
"4337","Brayden","F",15,20,35
"4338","Brayden","M",6241,5679,11920
"4339","Braydin","M",42,38,80
"4340","Braydn","M",11,9,20
"4341","Braydon","M",489,378,867
"4342","Braydyn","M",25,22,47
"4343","Brayla","F",27,39,66
"4344","Braylah","F",6,6,12
"4345","Braylan","M",66,50,116
"4346","Braylea","F",11,9,20
"4347","Braylee","F",549,478,1027
"4348","Braylee","M",9,7,16
"4349","Braylei","F",11,8,19
"4350","Brayleigh","F",174,165,339
"4351","Braylen","F",43,38,81
"4352","Braylen","M",751,696,1447
"4353","Brayley","F",20,18,38
"4354","Brayli","F",18,9,27
"4355","Braylie","F",44,50,94
"4356","Braylin","F",82,90,172
"4357","Braylin","M",195,185,380
"4358","Braylinn","F",13,11,24
"4359","Braylon","F",15,8,23
"4360","Braylon","M",811,734,1545
"4361","Braylyn","F",30,40,70
"4362","Braylyn","M",28,25,53
"4363","Braylynn","F",107,111,218
"4364","Braylynn","M",17,12,29
"4365","Brayon","M",11,9,20
"4366","Braysen","M",36,39,75
"4367","Brayson","M",188,214,402
"4368","Brayten","M",6,8,14
"4369","Brayton","M",80,66,146
"4370","Brayven","M",5,5,10
"4371","Brazen","M",8,8,16
"4372","Brazil","F",13,22,35
"4373","Brazos","M",16,22,38
"4374","Brea","F",114,99,213
"4375","Breah","F",35,21,56
"4376","Breaker","M",9,11,20
"4377","Brealyn","F",5,10,15
"4378","Brealynn","F",27,19,46
"4379","Breana","F",40,34,74
"4380","Breann","F",26,26,52
"4381","Breanna","F",427,358,785
"4382","Breanne","F",54,44,98
"4383","Breasia","F",45,25,70
"4384","Breccan","M",39,35,74
"4385","Breck","F",5,7,12
"4386","Breck","M",75,85,160
"4387","Breckan","M",11,6,17
"4388","Brecken","F",25,31,56
"4389","Brecken","M",334,330,664
"4390","Breckin","F",9,5,14
"4391","Breckin","M",69,53,122
"4392","Brecklyn","F",52,50,102
"4393","Brecklynn","F",15,23,38
"4394","Breckon","M",15,14,29
"4395","Breckyn","F",56,45,101
"4396","Breckyn","M",28,17,45
"4397","Bree","F",220,192,412
"4398","Breea","F",8,7,15
"4399","Breeana","F",11,11,22
"4400","Breeanna","F",12,8,20
"4401","Breelan","F",7,7,14
"4402","Breeley","F",5,6,11
"4403","Breella","F",8,7,15
"4404","Breelle","F",16,9,25
"4405","Breelyn","F",83,66,149
"4406","Breelynn","F",44,44,88
"4407","Breena","F",15,12,27
"4408","Brees","M",10,9,19
"4409","Breeze","F",24,24,48
"4410","Breeze","M",6,8,14
"4411","Breezy","F",15,14,29
"4412","Breighlyn","F",8,11,19
"4413","Breighton","M",7,5,12
"4414","Breindel","F",6,7,13
"4415","Breindy","F",13,18,31
"4416","Brek","M",16,11,27
"4417","Breken","M",10,6,16
"4418","Brekken","M",29,35,64
"4419","Breklyn","F",10,12,22
"4420","Brekyn","F",13,8,21
"4421","Brekyn","M",7,5,12
"4422","Breland","M",6,8,14
"4423","Brelee","F",6,6,12
"4424","Breleigh","F",18,22,40
"4425","Brelyn","F",18,17,35
"4426","Brelynn","F",53,74,127
"4427","Bren","F",7,7,14
"4428","Bren","M",11,11,22
"4429","Brena","F",18,15,33
"4430","Brenan","M",12,7,19
"4431","Brenda","F",349,338,687
"4432","Brendalynn","F",5,7,12
"4433","Brendan","M",821,683,1504
"4434","Brenden","M",241,203,444
"4435","Brendin","M",8,5,13
"4436","Brendon","M",171,124,295
"4437","Brendy","F",9,8,17
"4438","Brendyn","M",36,32,68
"4439","Brenham","M",6,6,12
"4440","Brenlee","F",38,34,72
"4441","Brenleigh","F",33,28,61
"4442","Brenley","F",52,48,100
"4443","Brenlie","F",6,6,12
"4444","Brenlyn","F",5,7,12
"4445","Brenlynn","F",13,10,23
"4446","Brenna","F",354,302,656
"4447","Brennan","F",39,35,74
"4448","Brennan","M",686,545,1231
"4449","Brennen","M",141,124,265
"4450","Brenner","M",35,42,77
"4451","Brennon","M",64,49,113
"4452","Brennyn","F",5,6,11
"4453","Brenson","M",9,16,25
"4454","Brent","M",250,209,459
"4455","Brenten","M",15,10,25
"4456","Brentlee","F",9,8,17
"4457","Brentlee","M",87,75,162
"4458","Brentley","F",12,16,28
"4459","Brentley","M",409,322,731
"4460","Brently","M",92,76,168
"4461","Brenton","M",170,167,337
"4462","Brentyn","M",9,8,17
"4463","Brenya","F",8,7,15
"4464","Breon","M",39,29,68
"4465","Breonna","F",27,25,52
"4466","Breslin","F",20,9,29
"4467","Breslin","M",12,9,21
"4468","Breslyn","F",17,19,36
"4469","Bret","M",32,33,65
"4470","Breton","M",9,6,15
"4471","Brett","F",5,22,27
"4472","Brett","M",321,332,653
"4473","Brettley","M",9,5,14
"4474","Bretton","M",11,10,21
"4475","Brevan","M",7,5,12
"4476","Brevin","M",26,19,45
"4477","Brevyn","M",17,9,26
"4478","Brewer","M",31,31,62
"4479","Brex","M",6,7,13
"4480","Brexlee","F",5,19,24
"4481","Brexley","F",14,25,39
"4482","Brexlyn","F",6,6,12
"4483","Brexten","M",7,7,14
"4484","Brextin","M",5,5,10
"4485","Brexton","M",42,74,116
"4486","Breya","F",27,19,46
"4487","Breyah","F",7,6,13
"4488","Breyana","F",10,6,16
"4489","Breyanna","F",8,8,16
"4490","Breydan","M",10,16,26
"4491","Breyden","M",42,28,70
"4492","Breydon","M",14,17,31
"4493","Breyer","M",8,13,21
"4494","Breylen","M",8,10,18
"4495","Breylin","M",9,8,17
"4496","Breylon","M",11,11,22
"4497","Breylynn","F",5,5,10
"4498","Breyon","M",13,17,30
"4499","Breyonna","F",7,5,12
"4500","Breyson","M",16,18,34
"4501","Brezlyn","F",6,5,11
"4502","Bri","F",13,9,22
"4503","Bria","F",442,364,806
"4504","Briah","F",26,25,51
"4505","Brian","M",2208,1965,4173
"4506","Briana","F",763,719,1482
"4507","Brianda","F",19,26,45
"4508","Briann","F",15,8,23
"4509","Brianna","F",3464,3076,6540
"4510","Briannah","F",21,19,40
"4511","Brianne","F",77,63,140
"4512","Brianni","F",5,7,12
"4513","Brianny","F",26,40,66
"4514","Briany","F",11,22,33
"4515","Briar","F",333,353,686
"4516","Briar","M",203,201,404
"4517","Briarrose","F",14,18,32
"4518","Briasia","F",24,27,51
"4519","Brice","F",12,7,19
"4520","Brice","M",245,193,438
"4521","Bricen","M",41,39,80
"4522","Briceson","M",12,11,23
"4523","Briceyda","F",6,9,15
"4524","Brick","M",14,13,27
"4525","Bricyn","M",10,9,19
"4526","Bridger","M",198,259,457
"4527","Bridget","F",581,506,1087
"4528","Bridgett","F",42,24,66
"4529","Bridgette","F",145,129,274
"4530","Bridgit","F",14,8,22
"4531","Bridgitte","F",9,5,14
"4532","Brie","F",64,75,139
"4533","Brieana","F",8,8,16
"4534","Brieann","F",5,5,10
"4535","Brieanna","F",17,19,36
"4536","Briel","F",37,18,55
"4537","Briele","F",8,8,16
"4538","Briell","F",13,5,18
"4539","Briella","F",907,904,1811
"4540","Briellah","F",9,5,14
"4541","Brielle","F",2530,2651,5181
"4542","Brielyn","F",15,20,35
"4543","Brielynn","F",19,19,38
"4544","Brien","M",9,7,16
"4545","Brienna","F",24,31,55
"4546","Brienne","F",31,29,60
"4547","Brier","F",16,13,29
"4548","Brier","M",22,30,52
"4549","Brigette","F",31,14,45
"4550","Brigg","M",10,11,21
"4551","Briggs","M",323,397,720
"4552","Briggston","M",9,8,17
"4553","Brigham","M",101,119,220
"4554","Brighid","F",9,10,19
"4555","Bright","M",10,7,17
"4556","Brighten","M",12,10,22
"4557","Brightly","F",8,5,13
"4558","Brighton","F",103,100,203
"4559","Brighton","M",148,121,269
"4560","Brightyn","F",12,7,19
"4561","Brigid","F",80,78,158
"4562","Brigit","F",10,10,20
"4563","Brigitta","F",7,9,16
"4564","Brigitte","F",130,96,226
"4565","Brihana","F",11,18,29
"4566","Brihanna","F",45,23,68
"4567","Brij","M",6,6,12
"4568","Brilee","F",67,59,126
"4569","Brileigh","F",65,39,104
"4570","Briley","F",297,267,564
"4571","Briley","M",30,18,48
"4572","Brilyn","F",11,20,31
"4573","Brilynn","F",64,62,126
"4574","Brin","F",7,7,14
"4575","Brina","F",12,14,26
"4576","Brinda","F",9,5,14
"4577","Brindle","F",9,6,15
"4578","Brindley","F",9,7,16
"4579","Brinklee","F",5,8,13
"4580","Brinkley","F",72,47,119
"4581","Brinlee","F",176,175,351
"4582","Brinleigh","F",59,64,123
"4583","Brinley","F",784,979,1763
"4584","Brinley","M",8,7,15
"4585","Brinly","F",7,7,14
"4586","Brinlyn","F",8,7,15
"4587","Brinlynn","F",16,8,24
"4588","Brinn","F",22,18,40
"4589","Brinna","F",13,6,19
"4590","Brinnley","F",23,29,52
"4591","Brinslee","F",6,5,11
"4592","Brinsley","F",13,16,29
"4593","Brinton","M",8,13,21
"4594","Brion","M",21,14,35
"4595","Briona","F",7,11,18
"4596","Brionna","F",31,32,63
"4597","Briony","F",9,6,15
"4598","Brisa","F",192,176,368
"4599","Briseida","F",75,64,139
"4600","Briseis","F",68,61,129
"4601","Briseyda","F",70,59,129
"4602","Brison","M",54,45,99
"4603","Brissa","F",92,89,181
"4604","Brissia","F",6,8,14
"4605","Bristal","F",25,18,43
"4606","Bristol","F",705,585,1290
"4607","Bristol","M",12,15,27
"4608","Briston","M",15,11,26
"4609","Bristyl","F",12,6,18
"4610","Bristyn","F",6,10,16
"4611","Brita","F",5,9,14
"4612","Britain","F",33,25,58
"4613","Britain","M",31,31,62
"4614","Britani","F",15,5,20
"4615","Britanny","F",21,18,39
"4616","Britany","F",61,46,107
"4617","Brithany","F",56,41,97
"4618","British","F",21,15,36
"4619","Britley","F",7,7,14
"4620","Britney","F",190,158,348
"4621","Briton","M",9,10,19
"4622","Britt","F",9,7,16
"4623","Britt","M",11,19,30
"4624","Britta","F",58,41,99
"4625","Brittain","F",12,5,17
"4626","Brittain","M",7,6,13
"4627","Brittan","F",16,16,32
"4628","Brittan","M",7,6,13
"4629","Brittani","F",18,11,29
"4630","Brittanie","F",9,5,14
"4631","Brittany","F",687,570,1257
"4632","Britten","M",7,11,18
"4633","Brittish","F",6,15,21
"4634","Brittlyn","F",5,5,10
"4635","Brittney","F",110,98,208
"4636","Britton","F",78,61,139
"4637","Britton","M",106,104,210
"4638","Brittyn","F",22,24,46
"4639","Brityn","F",7,9,16
"4640","Brix","M",20,24,44
"4641","Brixley","F",9,11,20
"4642","Brixon","M",11,9,20
"4643","Brixton","F",24,19,43
"4644","Brixton","M",209,247,456
"4645","Brixtyn","F",7,8,15
"4646","Briya","F",8,12,20
"4647","Briyah","F",16,9,25
"4648","Briyana","F",8,5,13
"4649","Briyanna","F",14,7,21
"4650","Briyelle","F",8,9,17
"4651","Briyith","F",6,5,11
"4652","Briza","F",29,16,45
"4653","Brizeida","F",6,7,13
"4654","Broc","M",29,14,43
"4655","Brocha","F",19,20,39
"4656","Brock","M",678,684,1362
"4657","Brockton","M",15,17,32
"4658","Brodee","M",26,22,48
"4659","Broden","M",59,44,103
"4660","Broderick","M",158,154,312
"4661","Brodey","M",19,22,41
"4662","Brodi","M",26,28,54
"4663","Brodie","F",12,18,30
"4664","Brodie","M",323,303,626
"4665","Brodin","M",5,5,10
"4666","Brodix","M",6,5,11
"4667","Brodrick","M",27,13,40
"4668","Brody","F",17,10,27
"4669","Brody","M",3734,3035,6769
"4670","Brodyn","M",16,13,29
"4671","Brogan","F",16,24,40
"4672","Brogan","M",155,135,290
"4673","Brok","M",6,5,11
"4674","Brolin","M",5,5,10
"4675","Broly","M",20,20,40
"4676","Brom","M",7,6,13
"4677","Bronc","M",13,5,18
"4678","Bronson","M",382,341,723
"4679","Bronsyn","M",7,10,17
"4680","Bronte","F",8,10,18
"4681","Bronwen","F",7,9,16
"4682","Bronwyn","F",44,52,96
"4683","Bronx","M",111,124,235
"4684","Bronxton","M",5,8,13
"4685","Brook","F",71,83,154
"4686","Brook","M",13,12,25
"4687","Brooke","F",2146,1856,4002
"4688","Brookelyn","F",77,64,141
"4689","Brookelynn","F",116,96,212
"4690","Brookelynne","F",5,10,15
"4691","Brooklee","F",11,9,20
"4692","Brooklen","F",6,6,12
"4693","Brooklin","F",59,50,109
"4694","Brooklinn","F",7,10,17
"4695","Brooklyn","F",6291,5922,12213
"4696","Brooklyn","M",66,68,134
"4697","Brooklyne","F",15,15,30
"4698","Brooklynn","F",1882,1649,3531
"4699","Brooklynne","F",86,62,148
"4700","Brooks","F",32,30,62
"4701","Brooks","M",1652,1663,3315
"4702","Broox","M",5,11,16
"4703","Browning","M",7,6,13
"4704","Brox","M",5,6,11
"4705","Broxton","M",24,13,37
"4706","Bruce","M",762,697,1459
"4707","Brucha","F",12,20,32
"4708","Bruchy","F",24,19,43
"4709","Bruin","M",17,25,42
"4710","Bruk","M",5,11,16
"4711","Bruna","F",18,13,31
"4712","Bruno","M",348,382,730
"4713","Brya","F",7,9,16
"4714","Bryah","F",12,9,21
"4715","Bryan","M",2485,2110,4595
"4716","Bryana","F",63,50,113
"4717","Bryanna","F",359,244,603
"4718","Bryant","M",425,465,890
"4719","Bryar","F",50,49,99
"4720","Bryar","M",83,76,159
"4721","Bryce","F",80,70,150
"4722","Bryce","M",3119,2827,5946
"4723","Brycelyn","F",8,7,15
"4724","Brycelynn","F",9,9,18
"4725","Brycen","M",668,635,1303
"4726","Bryceon","M",5,8,13
"4727","Bryceson","M",34,14,48
"4728","Bryceton","M",13,8,21
"4729","Brycin","M",18,18,36
"4730","Brydan","M",5,7,12
"4731","Bryden","M",97,84,181
"4732","Brydon","M",18,15,33
"4733","Bryella","F",9,7,16
"4734","Bryelle","F",27,36,63
"4735","Bryen","M",5,9,14
"4736","Bryer","F",22,19,41
"4737","Bryer","M",120,88,208
"4738","Bryker","M",9,7,16
"4739","Brylan","M",65,60,125
"4740","Brylea","F",9,8,17
"4741","Brylee","F",675,599,1274
"4742","Brylee","M",20,6,26
"4743","Brylei","F",18,17,35
"4744","Bryleigh","F",319,314,633
"4745","Brylen","F",5,6,11
"4746","Brylen","M",28,41,69
"4747","Bryler","M",18,15,33
"4748","Bryley","F",20,17,37
"4749","Bryli","F",9,10,19
"4750","Brylie","F",120,78,198
"4751","Brylin","F",23,15,38
"4752","Brylin","M",12,20,32
"4753","Brylinn","F",9,8,17
"4754","Brylon","M",33,33,66
"4755","Brylyn","F",5,5,10
"4756","Brylynn","F",33,31,64
"4757","Bryn","F",216,178,394
"4758","Bryn","M",15,16,31
"4759","Bryna","F",15,20,35
"4760","Bryndal","F",6,10,16
"4761","Brynden","M",5,8,13
"4762","Bryndle","F",31,44,75
"4763","Brynja","F",7,6,13
"4764","Brynlea","F",17,17,34
"4765","Brynlee","F",1317,1428,2745
"4766","Brynlei","F",7,11,18
"4767","Brynleigh","F",217,206,423
"4768","Brynley","F",204,190,394
"4769","Brynli","F",22,21,43
"4770","Brynlie","F",62,65,127
"4771","Brynlynn","F",17,16,33
"4772","Brynn","F",1224,1231,2455
"4773","Brynn","M",5,7,12
"4774","Brynna","F",71,67,138
"4775","Brynne","F",44,38,82
"4776","Brynnlee","F",92,123,215
"4777","Brynnleigh","F",35,45,80
"4778","Brynnley","F",77,61,138
"4779","Brynnlie","F",7,9,16
"4780","Brynnly","F",7,8,15
"4781","Bryon","M",44,29,73
"4782","Bryonna","F",9,9,18
"4783","Bryony","F",6,6,12
"4784","Bryor","M",12,12,24
"4785","Brysan","M",11,10,21
"4786","Brysen","M",200,248,448
"4787","Brysin","M",17,18,35
"4788","Bryson","F",9,7,16
"4789","Bryson","M",3094,4333,7427
"4790","Bryssa","F",5,10,15
"4791","Brystal","F",59,34,93
"4792","Brysten","M",11,8,19
"4793","Brystol","F",96,90,186
"4794","Bryston","M",34,46,80
"4795","Brysun","M",5,7,12
"4796","Brysyn","M",5,7,12
"4797","Bryten","M",10,10,20
"4798","Bryton","M",78,69,147
"4799","Buchanan","M",8,5,13
"4800","Buck","M",27,37,64
"4801","Buckley","M",12,18,30
"4802","Bud","M",8,10,18
"4803","Buddy","M",27,28,55
"4804","Bukhari","M",5,5,10
"4805","Burak","M",10,5,15
"4806","Burech","M",6,8,14
"4807","Burhan","M",16,10,26
"4808","Burhanuddin","M",29,34,63
"4809","Burke","M",58,58,116
"4810","Burklee","F",6,5,11
"4811","Burkleigh","F",8,5,13
"4812","Burkley","F",9,8,17
"4813","Burkley","M",9,7,16
"4814","Burton","M",36,25,61
"4815","Bushra","F",29,36,65
"4816","Buster","M",17,13,30
"4817","Byrdie","F",9,6,15
"4818","Byron","M",456,380,836
"4819","Caasi","F",9,7,16
"4820","Cabe","M",11,9,20
"4821","Cabela","F",5,8,13
"4822","Cabella","F",15,16,31
"4823","Cabot","M",8,7,15
"4824","Cache","M",38,25,63
"4825","Cadan","M",13,11,24
"4826","Cadance","F",16,15,31
"4827","Cade","F",7,6,13
"4828","Cade","M",886,777,1663
"4829","Cadee","F",8,9,17
"4830","Caden","F",21,17,38
"4831","Caden","M",2129,1984,4113
"4832","Cadence","F",962,864,1826
"4833","Cadence","M",79,75,154
"4834","Cadie","F",11,13,24
"4835","Cadin","M",13,10,23
"4836","Cady","F",25,28,53
"4837","Cadyn","F",7,5,12
"4838","Cadyn","M",41,32,73
"4839","Cadynce","F",10,12,22
"4840","Caedan","M",9,7,16
"4841","Caeden","M",77,60,137
"4842","Caedence","F",5,6,11
"4843","Caedmon","M",33,30,63
"4844","Caedyn","M",16,15,31
"4845","Cael","M",145,92,237
"4846","Caela","F",13,6,19
"4847","Caelan","F",6,8,14
"4848","Caelan","M",53,52,105
"4849","Caeleb","M",14,8,22
"4850","Caelen","M",17,13,30
"4851","Caeli","F",36,39,75
"4852","Caelin","F",11,9,20
"4853","Caelin","M",7,5,12
"4854","Caellum","M",11,18,29
"4855","Caelum","M",28,24,52
"4856","Caelyn","F",96,67,163
"4857","Caelynn","F",23,18,41
"4858","Caesar","M",92,79,171
"4859","Caeson","M",17,11,28
"4860","Caffrey","M",9,5,14
"4861","Cage","M",29,38,67
"4862","Cahlil","M",15,7,22
"4863","Cai","F",25,33,58
"4864","Cai","M",82,80,162
"4865","Caia","F",65,73,138
"4866","Caiah","F",10,11,21
"4867","Caidan","M",15,12,27
"4868","Caide","M",9,7,16
"4869","Caiden","F",16,22,38
"4870","Caiden","M",1286,1126,2412
"4871","Caidence","F",61,55,116
"4872","Caidence","M",7,9,16
"4873","Caidon","M",8,7,15
"4874","Caidyn","F",13,12,25
"4875","Caidyn","M",38,32,70
"4876","Caige","M",10,10,20
"4877","Caila","F",13,31,44
"4878","Cailah","F",8,6,14
"4879","Caileb","M",12,8,20
"4880","Cailee","F",56,62,118
"4881","Caileigh","F",47,40,87
"4882","Cailen","F",6,6,12
"4883","Cailen","M",5,5,10
"4884","Cailey","F",68,85,153
"4885","Cailie","F",7,7,14
"4886","Cailin","F",50,24,74
"4887","Caillou","M",10,7,17
"4888","Cailyn","F",175,114,289
"4889","Cailynn","F",58,51,109
"4890","Caiman","M",9,5,14
"4891","Cain","M",325,321,646
"4892","Cainan","M",38,46,84
"4893","Caine","M",60,53,113
"4894","Cainen","M",13,24,37
"4895","Caio","M",23,11,34
"4896","Caira","F",17,8,25
"4897","Cairo","F",7,16,23
"4898","Cairo","M",221,266,487
"4899","Caisen","M",14,30,44
"4900","Caisley","F",15,12,27
"4901","Caison","M",37,38,75
"4902","Caitlin","F",475,217,692
"4903","Caitlyn","F",493,244,737
"4904","Caitlynn","F",70,44,114
"4905","Caitriona","F",11,5,16
"4906","Caius","M",138,150,288
"4907","Caiya","F",12,19,31
"4908","Caiyah","F",10,8,18
"4909","Cal","M",144,156,300
"4910","Cala","F",8,5,13
"4911","Calah","F",5,7,12
"4912","Calahan","M",5,5,10
"4913","Calais","F",12,5,17
"4914","Calan","M",28,35,63
"4915","Calani","F",14,7,21
"4916","Calaya","F",12,11,23
"4917","Calayah","F",11,8,19
"4918","Calder","M",79,120,199
"4919","Caldwell","M",5,5,10
"4920","Cale","M",140,91,231
"4921","Calea","F",7,6,13
"4922","Caleah","F",39,31,70
"4923","Caleb","F",11,8,19
"4924","Caleb","M",8775,7914,16689
"4925","Calee","F",27,22,49
"4926","Caleena","F",7,5,12
"4927","Caleesi","F",11,8,19
"4928","Caleigh","F",193,143,336
"4929","Caleigha","F",13,12,25
"4930","Calel","M",16,9,25
"4931","Calem","M",13,12,25
"4932","Calen","M",61,65,126
"4933","Calena","F",8,7,15
"4934","Caley","F",23,23,46
"4935","Calhoun","M",12,8,20
"4936","Cali","F",1430,1194,2624
"4937","Cali","M",30,32,62
"4938","Calia","F",51,53,104
"4939","Caliah","F",22,23,45
"4940","Caliana","F",57,54,111
"4941","Caliann","F",13,8,21
"4942","Calianna","F",32,19,51
"4943","Calianne","F",8,7,15
"4944","Calib","M",7,6,13
"4945","Caliber","M",8,26,34
"4946","Calie","F",35,37,72
"4947","Caliegh","F",8,7,15
"4948","California","F",11,13,24
"4949","Calii","F",8,5,13
"4950","Calil","M",6,5,11
"4951","Calin","M",40,23,63
"4952","Calina","F",36,36,72
"4953","Calirae","F",5,6,11
"4954","Calirose","F",9,8,17
"4955","Calise","F",32,24,56
"4956","Calissa","F",31,14,45
"4957","Calista","F",171,179,350
"4958","Calix","M",30,26,56
"4959","Calixto","M",12,14,26
"4960","Caliya","F",11,8,19
"4961","Caliyah","F",96,103,199
"4962","Calla","F",140,162,302
"4963","Callaghan","M",6,10,16
"4964","Callahan","F",27,27,54
"4965","Callahan","M",83,113,196
"4966","Callan","F",29,33,62
"4967","Callan","M",365,332,697
"4968","Callaway","F",14,25,39
"4969","Callaway","M",16,31,47
"4970","Callee","F",27,22,49
"4971","Calleigh","F",80,71,151
"4972","Callen","F",15,15,30
"4973","Callen","M",553,543,1096
"4974","Calley","F",6,6,12
"4975","Calli","F",83,89,172
"4976","Callia","F",17,13,30
"4977","Calliah","F",6,8,14
"4978","Calliana","F",5,9,14
"4979","Callie","F",1677,1531,3208
"4980","Callieann","F",5,5,10
"4981","Callin","M",6,7,13
"4982","Calliope","F",220,289,509
"4983","Callista","F",57,65,122
"4984","Callon","M",9,6,15
"4985","Calloway","M",19,21,40
"4986","Callum","M",369,348,717
"4987","Cally","F",12,14,26
"4988","Callyn","F",19,20,39
"4989","Calogero","M",14,15,29
"4990","Calum","M",75,92,167
"4991","Calvary","F",5,6,11
"4992","Calvary","M",9,6,15
"4993","Calvin","M",2431,2781,5212
"4994","Calvyn","M",5,6,11
"4995","Calyn","F",10,21,31
"4996","Calynn","F",21,23,44
"4997","Calypso","F",15,18,33
"4998","Calyssa","F",12,5,17
"4999","Calyx","F",5,5,10
"5000","Calyx","M",6,5,11
"5001","Cam","F",5,5,10
"5002","Cam","M",94,101,195
"5003","Camar","M",5,5,10
"5004","Camara","F",14,10,24
"5005","Camari","F",42,44,86
"5006","Camari","M",69,54,123
"5007","Camarie","F",9,6,15
"5008","Camarion","M",21,20,41
"5009","Camaya","F",6,14,20
"5010","Camber","F",24,25,49
"5011","Cambre","F",5,10,15
"5012","Cambrea","F",6,7,13
"5013","Cambree","F",137,134,271
"5014","Cambreigh","F",6,8,14
"5015","Cambren","M",9,5,14
"5016","Cambrey","F",5,9,14
"5017","Cambri","F",36,59,95
"5018","Cambria","F",262,229,491
"5019","Cambridge","M",6,11,17
"5020","Cambrie","F",123,139,262
"5021","Cambry","F",44,25,69
"5022","Cambryn","F",9,10,19
"5023","Cambryn","M",6,8,14
"5024","Camdan","M",8,12,20
"5025","Camden","F",138,156,294
"5026","Camden","M",3757,3322,7079
"5027","Camdin","M",15,11,26
"5028","Camdon","M",57,41,98
"5029","Camdyn","F",125,128,253
"5030","Camdyn","M",268,278,546
"5031","Camdynn","F",11,5,16
"5032","Camdynn","M",6,10,16
"5033","Camelia","F",37,37,74
"5034","Camella","F",14,5,19
"5035","Camellia","F",67,78,145
"5036","Cameo","F",5,5,10
"5037","Cameran","F",20,36,56
"5038","Cameran","M",20,23,43
"5039","Cameren","M",31,23,54
"5040","Camerin","M",8,13,21
"5041","Cameron","F",586,583,1169
"5042","Cameron","M",6731,6807,13538
"5043","Cameryn","F",61,64,125
"5044","Cameryn","M",35,33,68
"5045","Cami","F",43,28,71
"5046","Camia","F",23,25,48
"5047","Camiah","F",18,23,41
"5048","Camie","F",9,5,14
"5049","Camielle","F",6,12,18
"5050","Camila","F",5271,6036,11307
"5051","Camilah","F",14,25,39
"5052","Camile","F",21,16,37
"5053","Camilia","F",15,11,26
"5054","Camilla","F",870,972,1842
"5055","Camille","F",1306,1300,2606
"5056","Camillia","F",20,15,35
"5057","Camillo","M",7,16,23
"5058","Camilo","M",217,205,422
"5059","Camiya","F",21,27,48
"5060","Camiyah","F",34,48,82
"5061","Cammi","F",9,7,16
"5062","Cammie","F",16,19,35
"5063","Camora","F",24,18,42
"5064","Camp","M",5,10,15
"5065","Campbell","F",224,224,448
"5066","Campbell","M",138,176,314
"5067","Camree","F",9,7,16
"5068","Camren","F",5,10,15
"5069","Camren","M",204,162,366
"5070","Camri","F",23,14,37
"5071","Camrie","F",17,11,28
"5072","Camrin","M",28,23,51
"5073","Camron","M",263,241,504
"5074","Camry","F",21,27,48
"5075","Camryn","F",823,815,1638
"5076","Camryn","M",188,186,374
"5077","Camrynn","F",25,20,45
"5078","Camya","F",9,27,36
"5079","Camyla","F",13,17,30
"5080","Camyra","F",6,5,11
"5081","Can","M",19,27,46
"5082","Cana","F",10,16,26
"5083","Canaan","M",283,382,665
"5084","Candace","F",90,100,190
"5085","Candelaria","F",17,14,31
"5086","Candelario","M",10,9,19
"5087","Candice","F",111,133,244
"5088","Candido","M",10,11,21
"5089","Candon","M",6,10,16
"5090","Candy","F",52,49,101
"5091","Candyce","F",6,5,11
"5092","Cane","M",11,16,27
"5093","Canelo","M",6,7,13
"5094","Caniya","F",13,10,23
"5095","Caniyah","F",13,8,21
"5096","Cannan","M",17,22,39
"5097","Cannen","M",18,8,26
"5098","Cannon","F",7,17,24
"5099","Cannon","M",470,530,1000
"5100","Canon","M",86,88,174
"5101","Canton","M",33,27,60
"5102","Canyon","F",17,8,25
"5103","Canyon","M",114,130,244
"5104","Caoimhe","F",11,11,22
"5105","Capri","F",171,135,306
"5106","Capriana","F",8,6,14
"5107","Caprice","F",34,17,51
"5108","Captain","M",25,31,56
"5109","Cara","F",385,350,735
"5110","Caragh","F",6,5,11
"5111","Carah","F",12,15,27
"5112","Caralee","F",7,7,14
"5113","Caralena","F",6,8,14
"5114","Caralina","F",11,6,17
"5115","Caraline","F",30,54,84
"5116","Caralyn","F",24,14,38
"5117","Caralynn","F",15,12,27
"5118","Carbon","M",7,5,12
"5119","Cardell","M",22,22,44
"5120","Carden","M",18,17,35
"5121","Carder","M",21,18,39
"5122","Cardin","M",12,7,19
"5123","Carely","F",8,5,13
"5124","Caren","F",6,13,19
"5125","Carey","F",8,6,14
"5126","Carey","M",23,24,47
"5127","Cari","F",26,21,47
"5128","Cariana","F",11,10,21
"5129","Carin","F",5,6,11
"5130","Carina","F",246,244,490
"5131","Carion","M",5,6,11
"5132","Caris","F",50,44,94
"5133","Carisa","F",12,5,17
"5134","Carissa","F",164,126,290
"5135","Cariyah","F",11,6,17
"5136","Carl","M",454,442,896
"5137","Carla","F",317,322,639
"5138","Carlea","F",8,5,13
"5139","Carleah","F",7,9,16
"5140","Carlee","F",366,313,679
"5141","Carleen","F",7,7,14
"5142","Carlei","F",6,14,20
"5143","Carleigh","F",236,203,439
"5144","Carlena","F",11,6,17
"5145","Carlene","F",17,18,35
"5146","Carley","F",234,168,402
"5147","Carli","F",146,157,303
"5148","Carlie","F",254,246,500
"5149","Carlin","F",35,23,58
"5150","Carlin","M",32,39,71
"5151","Carlina","F",15,18,33
"5152","Carlisle","F",14,15,29
"5153","Carlisle","M",35,39,74
"5154","Carlito","M",45,38,83
"5155","Carlitos","M",13,12,25
"5156","Carliyah","F",8,5,13
"5157","Carlo","M",143,181,324
"5158","Carlos","M",3414,3184,6598
"5159","Carlota","F",30,45,75
"5160","Carlotta","F",16,16,32
"5161","Carlson","M",17,19,36
"5162","Carlton","M",96,79,175
"5163","Carly","F",842,802,1644
"5164","Carlyle","M",18,23,41
"5165","Carlyn","F",31,27,58
"5166","Carlynn","F",20,23,43
"5167","Carma","F",31,15,46
"5168","Carman","F",6,7,13
"5169","Carmel","F",18,8,26
"5170","Carmela","F",112,116,228
"5171","Carmelina","F",12,18,30
"5172","Carmelita","F",11,11,22
"5173","Carmella","F",153,148,301
"5174","Carmello","M",66,67,133
"5175","Carmelo","M",351,353,704
"5176","Carmen","F",855,820,1675
"5177","Carmen","M",23,32,55
"5178","Carmilla","F",6,5,11
"5179","Carmin","F",15,9,24
"5180","Carmina","F",28,16,44
"5181","Carmine","M",150,129,279
"5182","Carmyn","F",47,51,98
"5183","Carnell","M",28,19,47
"5184","Carol","F",118,129,247
"5185","Carolann","F",16,11,27
"5186","Carole","F",10,11,21
"5187","Caroleena","F",9,5,14
"5188","Carolena","F",19,15,34
"5189","Carolina","F",732,769,1501
"5190","Caroline","F",4322,4410,8732
"5191","Carolyn","F",373,349,722
"5192","Carolyna","F",6,7,13
"5193","Carolyne","F",30,23,53
"5194","Carolynn","F",46,51,97
"5195","Caron","M",11,19,30
"5196","Carra","F",10,7,17
"5197","Carrah","F",6,6,12
"5198","Carrera","F",6,9,15
"5199","Carrick","M",27,32,59
"5200","Carrie","F",125,140,265
"5201","Carrigan","F",37,37,74
"5202","Carrington","F",69,59,128
"5203","Carrington","M",24,26,50
"5204","Carroll","M",9,10,19
"5205","Carrson","M",7,11,18
"5206","Carsen","F",34,25,59
"5207","Carsen","M",164,187,351
"5208","Carsin","M",9,5,14
"5209","Carson","F",178,184,362
"5210","Carson","M",4739,4892,9631
"5211","Carsten","M",83,66,149
"5212","Carston","M",27,17,44
"5213","Carsyn","F",167,212,379
"5214","Carsyn","M",108,119,227
"5215","Carsynn","F",14,12,26
"5216","Cartel","M",11,14,25
"5217","Carter","F",579,699,1278
"5218","Carter","M",10761,10134,20895
"5219","Cartez","M",5,5,10
"5220","Cartier","F",9,8,17
"5221","Cartier","M",75,89,164
"5222","Carvell","M",5,5,10
"5223","Carver","F",8,9,17
"5224","Carver","M",141,140,281
"5225","Cary","M",32,35,67
"5226","Caryn","F",8,12,20
"5227","Carys","F",82,61,143
"5228","Cas","M",8,6,14
"5229","Casandra","F",24,30,54
"5230","Case","M",525,518,1043
"5231","Caselyn","F",9,5,14
"5232","Caselynn","F",5,5,10
"5233","Casen","M",366,406,772
"5234","Caseton","M",7,6,13
"5235","Casey","F",342,325,667
"5236","Casey","M",515,509,1024
"5237","Cash","M",1362,1434,2796
"5238","Cashel","M",25,23,48
"5239","Cashius","M",19,19,38
"5240","Cashlyn","F",9,11,20
"5241","Cashlynn","F",8,11,19
"5242","Cashmere","F",19,9,28
"5243","Cashmere","M",36,29,65
"5244","Cashmir","M",9,8,17
"5245","Cashten","M",7,8,15
"5246","Cashton","M",131,135,266
"5247","Cashtyn","M",7,12,19
"5248","Cashus","M",8,7,15
"5249","Casia","F",7,7,14
"5250","Casidee","F",6,6,12
"5251","Casie","F",7,13,20
"5252","Casimir","M",34,29,63
"5253","Cason","M",656,647,1303
"5254","Caspar","M",7,19,26
"5255","Casper","M",87,82,169
"5256","Caspian","M",105,158,263
"5257","Cass","M",20,28,48
"5258","Cassadee","F",23,29,52
"5259","Cassady","F",8,11,19
"5260","Cassandra","F",612,540,1152
"5261","Cassi","F",18,12,30
"5262","Cassia","F",61,62,123
"5263","Cassian","M",19,19,38
"5264","Cassiana","F",5,5,10
"5265","Cassidee","F",25,20,45
"5266","Cassidi","F",7,10,17
"5267","Cassidie","F",10,9,19
"5268","Cassidy","F",1231,1113,2344
"5269","Cassidy","M",41,58,99
"5270","Cassie","F",192,210,402
"5271","Cassiel","F",6,7,13
"5272","Cassiel","M",25,39,64
"5273","Cassiopeia","F",8,7,15
"5274","Cassius","M",403,444,847
"5275","Casten","M",9,13,22
"5276","Castiel","F",5,7,12
"5277","Castiel","M",276,315,591
"5278","Castin","M",8,8,16
"5279","Castle","M",27,15,42
"5280","Caston","M",24,20,44
"5281","Castor","M",15,29,44
"5282","Casyn","M",28,28,56
"5283","Catalaya","F",52,51,103
"5284","Catalea","F",12,12,24
"5285","Cataleah","F",9,7,16
"5286","Cataleia","F",8,8,16
"5287","Catalena","F",14,10,24
"5288","Cataleya","F",723,606,1329
"5289","Cataleyah","F",22,16,38
"5290","Catalia","F",24,12,36
"5291","Catalina","F",999,1024,2023
"5292","Catalya","F",7,7,14
"5293","Catalyna","F",14,16,30
"5294","Catarina","F",62,60,122
"5295","Cate","F",59,37,96
"5296","Cateleya","F",11,8,19
"5297","Catelyn","F",48,27,75
"5298","Catelynn","F",23,18,41
"5299","Caterina","F",44,43,87
"5300","Cathaleya","F",6,5,11
"5301","Cathalina","F",15,10,25
"5302","Cathan","M",5,5,10
"5303","Catharine","F",12,12,24
"5304","Catherina","F",7,5,12
"5305","Catherine","F",1799,1660,3459
"5306","Cathleen","F",21,16,37
"5307","Cathryn","F",63,39,102
"5308","Cathy","F",64,53,117
"5309","Catie","F",15,12,27
"5310","Cato","M",23,17,40
"5311","Catori","F",12,7,19
"5312","Catrina","F",11,15,26
"5313","Catriona","F",17,15,32
"5314","Cattaleya","F",33,29,62
"5315","Cattleya","F",132,119,251
"5316","Caulder","M",8,15,23
"5317","Cavalli","M",5,7,12
"5318","Cavan","M",43,44,87
"5319","Caven","M",10,7,17
"5320","Cavin","M",23,23,46
"5321","Cayce","M",8,15,23
"5322","Caycee","F",8,7,15
"5323","Caydance","F",19,10,29
"5324","Cayde","M",22,46,68
"5325","Cayden","F",54,48,102
"5326","Cayden","M",1866,1543,3409
"5327","Caydence","F",201,162,363
"5328","Caydence","M",20,16,36
"5329","Caydin","M",11,14,25
"5330","Caydon","M",33,33,66
"5331","Cayenne","F",9,8,17
"5332","Cayla","F",120,99,219
"5333","Caylah","F",16,5,21
"5334","Cayleb","M",41,35,76
"5335","Caylee","F",331,300,631
"5336","Cayleigh","F",75,102,177
"5337","Caylen","F",18,22,40
"5338","Caylen","M",14,12,26
"5339","Cayley","F",22,13,35
"5340","Cayli","F",9,9,18
"5341","Caylie","F",39,29,68
"5342","Caylin","F",53,35,88
"5343","Caylor","M",5,6,11
"5344","Caylynn","F",19,13,32
"5345","Cayman","M",25,20,45
"5346","Caynan","M",6,8,14
"5347","Cayne","M",16,25,41
"5348","Cayse","M",7,8,15
"5349","Caysen","M",123,151,274
"5350","Caysin","M",11,7,18
"5351","Cayson","M",428,520,948
"5352","Ceanna","F",23,17,40
"5353","Ceara","F",6,7,13
"5354","Ceasar","M",31,32,63
"5355","Ceaser","M",10,5,15
"5356","Cebastian","M",11,11,22
"5357","Cece","F",11,14,25
"5358","Ceceilia","F",5,5,10
"5359","Cecelia","F",570,573,1143
"5360","Cecil","M",114,100,214
"5361","Cecile","F",27,25,52
"5362","Cecilia","F",1776,1814,3590
"5363","Cecilio","M",13,22,35
"5364","Cecillia","F",7,15,22
"5365","Cecily","F",214,194,408
"5366","Cecilya","F",5,7,12
"5367","Cecylia","F",8,7,15
"5368","Cedar","F",60,40,100
"5369","Cedar","M",110,132,242
"5370","Cedric","M",261,233,494
"5371","Cedrick","M",58,40,98
"5372","Cedrik","M",6,5,11
"5373","Ceejay","M",10,6,16
"5374","Ceili","F",5,5,10
"5375","Celaya","F",5,5,10
"5376","Celena","F",26,27,53
"5377","Celene","F",15,23,38
"5378","Celest","F",11,6,17
"5379","Celeste","F",638,625,1263
"5380","Celestia","F",11,24,35
"5381","Celestial","F",9,9,18
"5382","Celestina","F",26,22,48
"5383","Celestine","F",27,31,58
"5384","Celestino","M",15,16,31
"5385","Celia","F",325,339,664
"5386","Celina","F",174,220,394
"5387","Celine","F",339,492,831
"5388","Celio","M",6,5,11
"5389","Celso","M",21,25,46
"5390","Ceonna","F",7,5,12
"5391","Cephas","M",12,9,21
"5392","Cera","F",10,15,25
"5393","Cerena","F",14,6,20
"5394","Cereniti","F",10,7,17
"5395","Cerenity","F",72,68,140
"5396","Cerinity","F",11,5,16
"5397","Cerise","F",10,5,15
"5398","Ceriyah","F",6,7,13
"5399","Cesar","M",1302,1154,2456
"5400","Cesare","M",11,12,23
"5401","Cesia","F",51,37,88
"5402","Cesilia","F",8,5,13
"5403","Cezar","M",8,11,19
"5404","Chaarvi","F",5,6,11
"5405","Chace","M",225,169,394
"5406","Chad","M",312,288,600
"5407","Chadrick","M",12,11,23
"5408","Chadwick","M",39,18,57
"5409","Chael","M",35,30,65
"5410","Chaim","M",347,307,654
"5411","Chaise","F",6,8,14
"5412","Chaise","M",34,23,57
"5413","Chaitanya","M",5,6,11
"5414","Chaitra","F",16,17,33
"5415","Chamberlain","M",6,9,15
"5416","Champ","M",37,39,76
"5417","Champion","M",24,27,51
"5418","Chan","M",6,13,19
"5419","Chana","F",330,364,694
"5420","Chanan","M",8,11,19
"5421","Chance","F",29,32,61
"5422","Chance","M",1452,1329,2781
"5423","Chancellor","M",86,92,178
"5424","Chancelor","M",13,14,27
"5425","Chancey","M",7,8,15
"5426","Chandler","F",249,264,513
"5427","Chandler","M",730,650,1380
"5428","Chanel","F",413,449,862
"5429","Chanell","F",38,17,55
"5430","Chanelle","F",76,65,141
"5431","Chaney","F",18,14,32
"5432","Chani","F",6,12,18
"5433","Chanie","F",10,9,19
"5434","Chaniya","F",13,11,24
"5435","Chaniyah","F",8,8,16
"5436","Chanler","M",8,8,16
"5437","Chanley","F",6,11,17
"5438","Channah","F",11,6,17
"5439","Channel","F",11,7,18
"5440","Channelle","F",6,5,11
"5441","Channing","F",119,97,216
"5442","Channing","M",298,271,569
"5443","Channon","M",5,9,14
"5444","Chanse","M",24,18,42
"5445","Chanson","M",9,5,14
"5446","Chanston","M",6,8,14
"5447","Chantal","F",47,28,75
"5448","Chantel","F",24,41,65
"5449","Chantelle","F",36,33,69
"5450","Chantz","M",18,19,37
"5451","Chany","F",44,54,98
"5452","Chanz","M",9,8,17
"5453","Chanze","M",12,10,22
"5454","Chapel","F",14,18,32
"5455","Chaplin","M",6,5,11
"5456","Chapman","M",28,29,57
"5457","Chara","F",12,11,23
"5458","Charbel","M",36,49,85
"5459","Charis","F",85,70,155
"5460","Charish","F",10,7,17
"5461","Charisma","F",54,59,113
"5462","Charissa","F",26,25,51
"5463","Charity","F",206,196,402
"5464","Charla","F",17,12,29
"5465","Charlea","F",23,20,43
"5466","Charlee","F",1122,1094,2216
"5467","Charlee","M",18,21,39
"5468","Charlei","F",19,19,38
"5469","Charleigh","F",591,620,1211
"5470","Charlene","F",146,138,284
"5471","Charles","F",9,16,25
"5472","Charles","M",7165,7050,14215
"5473","Charleston","F",254,154,408
"5474","Charleston","M",88,64,152
"5475","Charlestyn","F",11,14,25
"5476","Charlet","F",5,5,10
"5477","Charlett","F",8,6,14
"5478","Charlette","F",50,80,130
"5479","Charley","F",603,555,1158
"5480","Charley","M",85,79,164
"5481","Charli","F",558,470,1028
"5482","Charlie","F",1557,1751,3308
"5483","Charlie","M",1666,1697,3363
"5484","Charlieann","F",8,10,18
"5485","Charliee","F",24,17,41
"5486","Charliegh","F",6,6,12
"5487","Charlierose","F",7,11,18
"5488","Charlii","F",9,16,25
"5489","Charline","F",13,8,21
"5490","Charlise","F",17,25,42
"5491","Charlize","F",275,224,499
"5492","Charlotte","F",11381,13030,24411
"5493","Charlotte","M",10,10,20
"5494","Charlton","M",19,14,33
"5495","Charly","F",81,86,167
"5496","Charly","M",26,21,47
"5497","Charlye","F",19,15,34
"5498","Charlyn","F",8,8,16
"5499","Charlynn","F",8,9,17
"5500","Charm","F",25,27,52
"5501","Charmaine","F",18,15,33
"5502","Charming","M",6,6,12
"5503","Charna","F",8,6,14
"5504","Charolette","F",26,40,66
"5505","Charvi","F",19,31,50
"5506","Charvik","M",8,9,17
"5507","Chas","M",7,10,17
"5508","Chase","F",63,67,130
"5509","Chase","M",5357,4826,10183
"5510","Chaselyn","F",7,5,12
"5511","Chasen","M",45,57,102
"5512","Chaseton","M",8,16,24
"5513","Chasidy","F",17,12,29
"5514","Chasin","M",19,19,38
"5515","Chasity","F",152,114,266
"5516","Chason","M",26,36,62
"5517","Chassidy","F",35,51,86
"5518","Chassity","F",17,15,32
"5519","Chasten","M",13,13,26
"5520","Chastin","M",7,14,21
"5521","Chastity","F",30,25,55
"5522","Chaston","M",14,15,29
"5523","Chasyn","M",8,5,13
"5524","Chatham","M",14,12,26
"5525","Chauncey","M",55,35,90
"5526","Chauncy","M",6,5,11
"5527","Chava","F",95,108,203
"5528","Chavez","M",9,11,20
"5529","Chavis","M",5,6,11
"5530","Chavy","F",33,24,57
"5531","Chaya","F",378,397,775
"5532","Chayce","F",12,15,27
"5533","Chayce","M",108,118,226
"5534","Chayden","M",15,11,26
"5535","Chayla","F",7,7,14
"5536","Chaynce","M",5,14,19
"5537","Chayse","F",18,18,36
"5538","Chayse","M",85,88,173
"5539","Chaysen","M",14,8,22
"5540","Chayson","M",14,16,30
"5541","Chayton","M",76,67,143
"5542","Chaz","M",119,112,231
"5543","Chazz","M",16,19,35
"5544","Che","M",20,15,35
"5545","Cheikh","M",13,21,34
"5546","Chelby","F",8,5,13
"5547","Chelsea","F",1054,928,1982
"5548","Chelsee","F",10,7,17
"5549","Chelsey","F",122,100,222
"5550","Chelsi","F",16,16,32
"5551","Chelsie","F",65,34,99
"5552","Chelsy","F",33,45,78
"5553","Chen","M",8,5,13
"5554","Chenelle","F",5,5,10
"5555","Chenoa","F",14,18,32
"5556","Cherie","F",19,12,31
"5557","Cherish","F",288,273,561
"5558","Cherith","F",6,5,11
"5559","Cherokee","F",29,44,73
"5560","Cherrish","F",8,12,20
"5561","Cherry","F",42,40,82
"5562","Cheryl","F",55,71,126
"5563","Cherysh","F",11,7,18
"5564","Cheskel","M",22,25,47
"5565","Chesky","M",15,26,41
"5566","Chesley","M",8,8,16
"5567","Chesney","F",68,87,155
"5568","Chesni","F",7,7,14
"5569","Chessa","F",14,8,22
"5570","Chester","M",98,76,174
"5571","Cheston","M",27,11,38
"5572","Chet","M",37,44,81
"5573","Chetan","M",9,10,19
"5574","Chett","M",8,11,19
"5575","Chevelle","F",134,164,298
"5576","Chevelle","M",12,15,27
"5577","Chevi","F",14,11,25
"5578","Chevie","F",7,7,14
"5579","Chevy","F",62,44,106
"5580","Chevy","M",211,201,412
"5581","Cheyann","F",25,15,40
"5582","Cheyanna","F",14,11,25
"5583","Cheyanne","F",162,160,322
"5584","Cheyenne","F",948,802,1750
"5585","Cheyenne","M",11,5,16
"5586","Chi","F",10,9,19
"5587","Chiamaka","F",25,26,51
"5588","Chiara","F",111,132,243
"5589","Chibueze","M",8,8,16
"5590","Chibuike","M",8,8,16
"5591","Chibuikem","M",12,10,22
"5592","Chidera","F",21,23,44
"5593","Chidera","M",5,11,16
"5594","Chidiebube","M",5,5,10
"5595","Chidinma","F",11,11,22
"5596","Chidubem","M",18,28,46
"5597","Chiedozie","M",5,7,12
"5598","Chief","M",17,17,34
"5599","Chigozie","M",5,8,13
"5600","Chikaima","F",11,8,19
"5601","Chikamso","M",9,9,18
"5602","Chima","M",5,8,13
"5603","Chimamanda","F",43,34,77
"5604","Chimaobi","M",6,7,13
"5605","China","F",33,33,66
"5606","Chinaza","F",6,8,14
"5607","Chinedu","M",16,7,23
"5608","Chinenye","F",9,5,14
"5609","Chinmay","M",8,8,16
"5610","Chinmayi","F",8,6,14
"5611","Chinyere","F",9,6,15
"5612","Chioma","F",18,19,37
"5613","Chip","M",14,16,30
"5614","Chipper","M",7,7,14
"5615","Chiron","M",6,7,13
"5616","Chisom","F",30,27,57
"5617","Chisom","M",7,5,12
"5618","Chistopher","M",5,6,11
"5619","Chizara","F",16,25,41
"5620","Chizaram","F",37,32,69
"5621","Chiziterem","F",6,10,16
"5622","Chloe","F",7907,7410,15317
"5623","Chloe","M",10,12,22
"5624","Chloee","F",58,63,121
"5625","Chloemarie","F",6,7,13
"5626","Chloey","F",41,41,82
"5627","Chloie","F",42,39,81
"5628","Chole","F",55,42,97
"5629","Chord","M",7,8,15
"5630","Chosen","F",9,6,15
"5631","Chosen","M",9,31,40
"5632","Chozen","M",5,10,15
"5633","Chris","F",8,6,14
"5634","Chris","M",565,510,1075
"5635","Chriselle","F",7,8,15
"5636","Chrisette","F",39,33,72
"5637","Chrishaun","M",8,5,13
"5638","Chrishawn","M",11,9,20
"5639","Chrisley","F",15,9,24
"5640","Chrislyn","F",18,26,44
"5641","Chrislynn","F",27,28,55
"5642","Chriss","M",6,9,15
"5643","Chrissa","F",9,8,17
"5644","Chrissy","F",37,34,71
"5645","Christ","M",37,35,72
"5646","Christa","F",60,70,130
"5647","Christabel","F",26,26,52
"5648","Christabella","F",14,19,33
"5649","Christabelle","F",6,6,12
"5650","Christain","M",23,19,42
"5651","Christal","F",25,25,50
"5652","Christalyn","F",9,7,16
"5653","Christan","M",29,27,56
"5654","Christapher","M",7,5,12
"5655","Christel","F",9,12,21
"5656","Christella","F",13,9,22
"5657","Christelle","F",30,26,56
"5658","Christen","F",34,40,74
"5659","Christen","M",26,27,53
"5660","Christi","F",17,9,26
"5661","Christiaan","M",8,8,16
"5662","Christian","F",124,101,225
"5663","Christian","M",8168,7584,15752
"5664","Christiana","F",191,191,382
"5665","Christiane","F",6,7,13
"5666","Christianna","F",76,58,134
"5667","Christiano","M",53,36,89
"5668","Christie","F",46,29,75
"5669","Christien","M",16,15,31
"5670","Christin","F",21,13,34
"5671","Christin","M",11,6,17
"5672","Christina","F",975,841,1816
"5673","Christine","F",355,388,743
"5674","Christion","M",12,10,22
"5675","Christionna","F",8,7,15
"5676","Christo","M",9,7,16
"5677","Christobal","M",12,5,17
"5678","Christofer","M",45,48,93
"5679","Christon","M",25,24,49
"5680","Christoper","M",9,5,14
"5681","Christoph","M",21,17,38
"5682","Christophe","M",5,10,15
"5683","Christopher","F",15,13,28
"5684","Christopher","M",9788,9020,18808
"5685","Christopherjame","M",6,5,11
"5686","Christos","M",44,47,91
"5687","Christy","F",83,60,143
"5688","Christyan","M",15,5,20
"5689","Christyana","F",8,7,15
"5690","Christyanna","F",6,7,13
"5691","Christyn","F",16,15,31
"5692","Chrysanthemum","F",5,11,16
"5693","Chrystal","F",15,23,38
"5694","Chrystian","M",14,11,25
"5695","Chrystopher","M",11,5,16
"5696","Chuck","M",16,12,28
"5697","Chukwuebuka","M",15,8,23
"5698","Chukwuemeka","M",22,18,40
"5699","Chyann","F",16,14,30
"5700","Chyanne","F",45,17,62
"5701","Chyenne","F",8,6,14
"5702","Chyla","F",13,13,26
"5703","Chyler","F",10,8,18
"5704","Chyna","F",121,99,220
"5705","Chynna","F",11,10,21
"5706","Cian","M",154,155,309
"5707","Ciana","F",56,46,102
"5708","Ciani","F",11,8,19
"5709","Cianna","F",60,69,129
"5710","Cianni","F",12,8,20
"5711","Ciara","F",370,316,686
"5712","Ciaran","M",73,65,138
"5713","Ciarra","F",15,6,21
"5714","Cicely","F",9,16,25
"5715","Cicilia","F",6,5,11
"5716","Cicily","F",8,5,13
"5717","Cid","M",9,8,17
"5718","Cidney","F",8,7,15
"5719","Ciel","F",21,19,40
"5720","Ciel","M",16,23,39
"5721","Ciela","F",15,9,24
"5722","Ciella","F",8,5,13
"5723","Cielle","F",5,5,10
"5724","Cielo","F",116,153,269
"5725","Ciena","F",10,10,20
"5726","Cienna","F",81,72,153
"5727","Ciera","F",32,39,71
"5728","Cierra","F",109,80,189
"5729","Ciin","F",14,8,22
"5730","Cillian","M",121,175,296
"5731","Cin","M",5,5,10
"5732","Cincere","M",29,23,52
"5733","Cinch","M",9,17,26
"5734","Cindy","F",249,256,505
"5735","Cing","F",51,53,104
"5736","Cinsere","M",5,6,11
"5737","Cinthia","F",27,35,62
"5738","Cinthya","F",16,8,24
"5739","Cipriana","F",6,5,11
"5740","Cipriano","M",10,7,17
"5741","Cira","F",5,12,17
"5742","Cire","F",10,5,15
"5743","Cire","M",8,10,18
"5744","Ciri","F",5,8,13
"5745","Cirilo","M",9,10,19
"5746","Ciro","M",24,21,45
"5747","Cisco","M",9,12,21
"5748","Citlali","F",93,114,207
"5749","Citlalli","F",62,45,107
"5750","Citlaly","F",65,51,116
"5751","Cj","M",33,19,52
"5752","Claiborne","F",5,5,10
"5753","Clair","F",48,31,79
"5754","Claira","F",137,129,266
"5755","Claire","F",4823,5190,10013
"5756","Clancy","F",8,12,20
"5757","Clancy","M",25,15,40
"5758","Clara","F",3058,3055,6113
"5759","Clarabella","F",8,6,14
"5760","Clarabelle","F",30,34,64
"5761","Clarajane","F",5,5,10
"5762","Clare","F",388,392,780
"5763","Clarence","M",180,155,335
"5764","Claribel","F",15,16,31
"5765","Clarice","F",42,43,85
"5766","Clarie","F",7,6,13
"5767","Clarisa","F",29,37,66
"5768","Clarissa","F",405,453,858
"5769","Clarisse","F",16,26,42
"5770","Clarita","F",5,7,12
"5771","Clarity","F",51,36,87
"5772","Clark","F",15,16,31
"5773","Clark","M",863,861,1724
"5774","Clarke","F",49,76,125
"5775","Clarke","M",36,61,97
"5776","Clary","F",9,11,20
"5777","Claude","M",51,55,106
"5778","Claudette","F",12,12,24
"5779","Claudia","F",378,371,749
"5780","Claudine","F",8,7,15
"5781","Claudio","M",55,33,88
"5782","Clay","M",342,332,674
"5783","Clayden","M",8,9,17
"5784","Clayson","M",6,7,13
"5785","Clayten","M",11,8,19
"5786","Clayton","M",1471,1364,2835
"5787","Clea","F",12,11,23
"5788","Clemence","F",6,9,15
"5789","Clement","M",44,52,96
"5790","Clemente","M",25,26,51
"5791","Clementina","F",11,11,22
"5792","Clementine","F",342,378,720
"5793","Cleo","F",118,142,260
"5794","Cleo","M",16,19,35
"5795","Cleon","M",11,9,20
"5796","Cleopatra","F",22,26,48
"5797","Cletus","M",8,6,14
"5798","Cleveland","M",25,23,48
"5799","Clever","M",7,6,13
"5800","Cliff","M",17,19,36
"5801","Clifford","M",146,137,283
"5802","Cliffton","M",6,6,12
"5803","Clifton","M",110,90,200
"5804","Clint","M",116,123,239
"5805","Clinton","M",200,187,387
"5806","Clio","F",37,30,67
"5807","Clive","M",82,85,167
"5808","Clodagh","F",5,5,10
"5809","Cloe","F",51,56,107
"5810","Cloey","F",23,29,52
"5811","Cloie","F",15,11,26
"5812","Cloris","F",6,5,11
"5813","Cloud","M",35,31,66
"5814","Clover","F",180,172,352
"5815","Clovis","M",6,8,14
"5816","Clyde","M",286,295,581
"5817","Coal","M",7,14,21
"5818","Coalton","M",5,5,10
"5819","Coast","M",8,5,13
"5820","Cobain","M",12,13,25
"5821","Cobe","M",25,21,46
"5822","Cobey","M",10,8,18
"5823","Cobi","F",8,10,18
"5824","Cobi","M",18,19,37
"5825","Cobie","F",30,14,44
"5826","Cobie","M",11,7,18
"5827","Cobin","M",5,10,15
"5828","Coby","M",124,119,243
"5829","Coco","F",83,60,143
"5830","Coda","M",29,38,67
"5831","Coden","M",6,5,11
"5832","Codey","M",14,20,34
"5833","Codi","F",43,26,69
"5834","Codi","M",22,19,41
"5835","Codie","F",16,24,40
"5836","Codie","M",11,11,22
"5837","Cody","F",24,16,40
"5838","Cody","M",1583,1391,2974
"5839","Coe","M",5,10,15
"5840","Coehn","M",5,6,11
"5841","Coen","M",242,290,532
"5842","Cohan","M",10,13,23
"5843","Cohen","F",12,17,29
"5844","Cohen","M",1017,1085,2102
"5845","Colbey","M",5,6,11
"5846","Colbi","F",14,18,32
"5847","Colbie","F",175,187,362
"5848","Colbie","M",14,7,21
"5849","Colburn","M",5,5,10
"5850","Colby","F",45,36,81
"5851","Colby","M",663,550,1213
"5852","Colden","M",47,56,103
"5853","Cole","F",15,18,33
"5854","Cole","M",3488,3580,7068
"5855","Coleen","F",9,5,14
"5856","Coleman","M",250,211,461
"5857","Coleson","M",87,80,167
"5858","Coleston","M",9,12,21
"5859","Coleton","M",71,51,122
"5860","Colette","F",593,672,1265
"5861","Coley","F",15,8,23
"5862","Coley","M",8,10,18
"5863","Colin","M",2421,2045,4466
"5864","Colleen","F",114,102,216
"5865","Collen","M",7,14,21
"5866","Collette","F",70,90,160
"5867","Collier","F",10,8,18
"5868","Collier","M",55,47,102
"5869","Collin","F",13,6,19
"5870","Collin","M",1376,1195,2571
"5871","Collins","F",404,451,855
"5872","Collins","M",52,45,97
"5873","Collyn","F",13,12,25
"5874","Collyn","M",25,15,40
"5875","Collyns","F",36,38,74
"5876","Colm","M",13,28,41
"5877","Colman","M",16,19,35
"5878","Colsen","M",35,23,58
"5879","Colson","M",170,185,355
"5880","Colston","M",83,63,146
"5881","Colsyn","M",8,6,14
"5882","Colt","M",1014,1023,2037
"5883","Coltan","M",29,21,50
"5884","Colten","M",516,441,957
"5885","Colter","M",142,131,273
"5886","Coltin","M",56,55,111
"5887","Colton","F",8,6,14
"5888","Colton","M",6292,5580,11872
"5889","Coltrane","M",14,18,32
"5890","Coltyn","M",77,72,149
"5891","Colvin","M",11,18,29
"5892","Colyn","M",20,7,27
"5893","Compton","M",5,6,11
"5894","Conall","M",38,41,79
"5895","Conan","M",58,67,125
"5896","Conlan","M",31,21,52
"5897","Conlee","M",9,11,20
"5898","Conleigh","F",7,10,17
"5899","Conley","F",18,26,44
"5900","Conley","M",75,76,151
"5901","Connar","M",17,16,33
"5902","Connell","M",22,13,35
"5903","Connelly","F",15,14,29
"5904","Conner","F",8,12,20
"5905","Conner","M",1403,1135,2538
"5906","Connie","F",82,73,155
"5907","Connolly","M",7,6,13
"5908","Connor","F",22,23,45
"5909","Connor","M",6748,6983,13731
"5910","Conor","M",624,1082,1706
"5911","Conrad","M",429,460,889
"5912","Conrado","M",16,9,25
"5913","Constance","F",144,150,294
"5914","Constantin","M",12,14,26
"5915","Constantine","M",91,105,196
"5916","Constantino","M",11,12,23
"5917","Constanza","F",43,44,87
"5918","Consuelo","F",19,15,34
"5919","Contessa","F",17,16,33
"5920","Conway","M",54,64,118
"5921","Cooper","F",110,122,232
"5922","Cooper","M",5257,4951,10208
"5923","Cope","M",13,10,23
"5924","Copelan","M",8,6,14
"5925","Copeland","F",21,25,46
"5926","Copeland","M",52,38,90
"5927","Copelyn","F",11,10,21
"5928","Copelynn","F",7,9,16
"5929","Copen","M",13,5,18
"5930","Copper","F",10,11,21
"5931","Copper","M",21,30,51
"5932","Cora","F",3397,3350,6747
"5933","Corabelle","F",16,14,30
"5934","Corah","F",31,21,52
"5935","Coral","F",201,199,400
"5936","Coralee","F",75,72,147
"5937","Coralei","F",10,7,17
"5938","Coraleigh","F",16,24,40
"5939","Coralie","F",104,167,271
"5940","Coraline","F",527,496,1023
"5941","Coralyn","F",49,50,99
"5942","Coralynn","F",56,66,122
"5943","Corazon","F",7,6,13
"5944","Corban","M",164,135,299
"5945","Corben","M",53,55,108
"5946","Corbett","M",20,15,35
"5947","Corbin","F",18,14,32
"5948","Corbin","M",1764,1594,3358
"5949","Corbyn","F",23,15,38
"5950","Corbyn","M",171,139,310
"5951","Cord","M",29,24,53
"5952","Cordae","M",23,13,36
"5953","Cordale","M",9,10,19
"5954","Cordarius","M",13,12,25
"5955","Corde","M",17,11,28
"5956","Cordelia","F",285,257,542
"5957","Cordell","M",129,113,242
"5958","Cordero","M",21,11,32
"5959","Coreon","M",5,5,10
"5960","Coretta","F",15,7,22
"5961","Corey","F",19,22,41
"5962","Corey","M",748,760,1508
"5963","Coreyon","M",6,7,13
"5964","Cori","F",115,118,233
"5965","Cori","M",15,11,26
"5966","Corian","M",6,11,17
"5967","Coriana","F",11,14,25
"5968","Corianna","F",11,12,23
"5969","Corie","F",25,24,49
"5970","Corie","M",10,7,17
"5971","Corin","F",10,14,24
"5972","Corin","M",23,27,50
"5973","Corina","F",78,86,164
"5974","Corine","F",9,7,16
"5975","Corinna","F",37,40,77
"5976","Corinne","F",385,354,739
"5977","Corinthia","F",5,5,10
"5978","Corinthian","M",15,25,40
"5979","Cormac","M",175,169,344
"5980","Cormick","M",9,13,22
"5981","Cornelia","F",28,36,64
"5982","Cornelious","M",10,7,17
"5983","Cornelius","M",153,151,304
"5984","Cornell","M",47,40,87
"5985","Corra","F",28,19,47
"5986","Corrado","M",6,7,13
"5987","Corran","M",12,7,19
"5988","Correy","M",6,7,13
"5989","Corri","F",8,7,15
"5990","Corrie","F",39,43,82
"5991","Corrie","M",8,5,13
"5992","Corrigan","M",8,7,15
"5993","Corrin","F",8,5,13
"5994","Corrina","F",49,32,81
"5995","Corrine","F",59,47,106
"5996","Corrinne","F",6,5,11
"5997","Corry","M",10,7,17
"5998","Corryn","F",16,15,31
"5999","Corson","M",6,5,11
"6000","Cort","M",39,26,65
"6001","Cortana","F",30,16,46
"6002","Cortez","M",191,162,353
"6003","Cortland","M",46,37,83
"6004","Cortlyn","F",7,12,19
"6005","Cortlynn","F",14,6,20
"6006","Cortney","F",15,12,27
"6007","Cortney","M",18,17,35
"6008","Corvin","M",36,27,63
"6009","Corvus","M",5,7,12
"6010","Corwin","M",43,41,84
"6011","Corwyn","M",5,6,11
"6012","Cory","F",11,14,25
"6013","Cory","M",339,317,656
"6014","Coryn","F",8,14,22
"6015","Corynn","F",16,14,30
"6016","Corynne","F",5,6,11
"6017","Cosette","F",139,117,256
"6018","Cosima","F",21,35,56
"6019","Cosimo","M",9,6,15
"6020","Cosme","M",8,11,19
"6021","Cosmo","M",30,21,51
"6022","Costa","M",15,7,22
"6023","Cotton","M",31,18,49
"6024","Coty","M",18,20,38
"6025","Coulson","M",48,39,87
"6026","Coulter","M",24,24,48
"6027","Coumba","F",14,5,19
"6028","Courage","M",12,15,27
"6029","Courtland","F",5,6,11
"6030","Courtland","M",42,37,79
"6031","Courtlyn","F",21,28,49
"6032","Courtlynn","F",25,14,39
"6033","Courtnee","F",9,6,15
"6034","Courtney","F",373,344,717
"6035","Courtney","M",111,108,219
"6036","Cove","F",5,7,12
"6037","Cove","M",53,42,95
"6038","Cowan","M",8,9,17
"6039","Cowen","M",10,6,16
"6040","Coy","M",137,141,278
"6041","Cozette","F",28,17,45
"6042","Craig","M",235,236,471
"6043","Crawford","M",62,56,118
"6044","Crayton","M",13,11,24
"6045","Cree","F",46,33,79
"6046","Cree","M",63,59,122
"6047","Creed","M",128,206,334
"6048","Creede","M",8,6,14
"6049","Creedence","F",17,12,29
"6050","Creedence","M",21,20,41
"6051","Creedyn","M",6,6,12
"6052","Creek","M",19,28,47
"6053","Creighton","M",50,47,97
"6054","Cressida","F",10,10,20
"6055","Creston","M",8,7,15
"6056","Crew","M",345,331,676
"6057","Crewe","M",11,7,18
"6058","Crews","M",6,9,15
"6059","Cricket","F",13,11,24
"6060","Crimson","F",62,69,131
"6061","Crimson","M",37,44,81
"6062","Cris","M",23,16,39
"6063","Crispin","M",28,15,43
"6064","Criss","M",13,9,22
"6065","Crist","M",5,8,13
"6066","Crista","F",18,9,27
"6067","Cristal","F",100,90,190
"6068","Cristel","F",28,55,83
"6069","Cristen","F",6,8,14
"6070","Cristhian","M",38,37,75
"6071","Cristian","F",6,6,12
"6072","Cristian","M",1347,1210,2557
"6073","Cristiana","F",21,19,40
"6074","Cristiano","M",266,263,529
"6075","Cristina","F",233,239,472
"6076","Cristine","F",8,7,15
"6077","Cristo","M",27,25,52
"6078","Cristobal","M",164,144,308
"6079","Cristofer","M",89,90,179
"6080","Cristopher","M",215,187,402
"6081","Cristy","F",21,19,40
"6082","Crixus","M",21,19,40
"6083","Crockett","M",14,11,25
"6084","Croix","M",68,65,133
"6085","Crosby","F",19,27,46
"6086","Crosby","M",484,427,911
"6087","Crosley","F",9,6,15
"6088","Crosley","M",13,19,32
"6089","Cross","M",37,28,65
"6090","Crowley","M",7,9,16
"6091","Croy","M",11,8,19
"6092","Cru","M",65,78,143
"6093","Crue","M",69,58,127
"6094","Cruise","M",15,12,27
"6095","Cruz","F",27,22,49
"6096","Cruz","M",1064,1011,2075
"6097","Cruze","M",66,39,105
"6098","Cruzito","M",15,19,34
"6099","Crystal","F",559,539,1098
"6100","Crystel","F",9,12,21
"6101","Crystianna","F",8,12,20
"6102","Cuauhtemoc","M",16,15,31
"6103","Cuinn","M",11,6,17
"6104","Cullan","M",6,11,17
"6105","Cullen","M",492,528,1020
"6106","Cullin","M",13,6,19
"6107","Cung","M",9,9,18
"6108","Curran","M",18,11,29
"6109","Curren","M",35,31,66
"6110","Curry","M",5,13,18
"6111","Curt","M",8,9,17
"6112","Curtis","M",540,501,1041
"6113","Cutler","M",38,36,74
"6114","Cutter","M",68,34,102
"6115","Cuyler","M",15,24,39
"6116","Cy","M",61,60,121
"6117","Cyan","F",22,26,48
"6118","Cyan","M",24,20,44
"6119","Cyanna","F",13,11,24
"6120","Cyanne","F",9,6,15
"6121","Cyara","F",7,5,12
"6122","Cybil","F",12,10,22
"6123","Cydnee","F",9,13,22
"6124","Cydney","F",40,48,88
"6125","Cyla","F",6,11,17
"6126","Cylah","F",5,6,11
"6127","Cylan","M",10,12,22
"6128","Cylar","M",6,5,11
"6129","Cylas","M",77,51,128
"6130","Cyle","M",6,9,15
"6131","Cylee","F",11,20,31
"6132","Cyleigh","F",17,14,31
"6133","Cyler","M",31,22,53
"6134","Cylie","F",24,16,40
"6135","Cylis","M",32,17,49
"6136","Cylus","M",52,54,106
"6137","Cymone","F",6,10,16
"6138","Cynai","F",5,6,11
"6139","Cyncere","F",18,9,27
"6140","Cyncere","M",29,28,57
"6141","Cynia","F",5,5,10
"6142","Cyniah","F",10,12,22
"6143","Cyniyah","F",5,5,10
"6144","Cynthia","F",577,550,1127
"6145","Cypher","M",5,6,11
"6146","Cypress","F",40,43,83
"6147","Cypress","M",43,64,107
"6148","Cyprian","M",11,14,25
"6149","Cyprus","M",11,10,21
"6150","Cyra","F",21,36,57
"6151","Cyree","M",9,9,18
"6152","Cyrene","F",11,5,16
"6153","Cyriah","F",9,9,18
"6154","Cyrie","M",10,10,20
"6155","Cyril","M",42,42,84
"6156","Cyrine","F",8,8,16
"6157","Cyris","M",13,8,21
"6158","Cyrus","M",631,722,1353
"6159","Czar","M",12,11,23
"6160","Czarina","F",5,13,18
"6161","Daania","F",5,6,11
"6162","Daanya","F",6,9,15
"6163","Dabney","F",10,6,16
"6164","Dacari","M",20,12,32
"6165","Dace","M",12,13,25
"6166","Dacen","M",6,7,13
"6167","Dacey","F",9,13,22
"6168","Dacian","M",9,11,20
"6169","Dade","M",13,22,35
"6170","Dadrian","M",8,9,17
"6171","Daedric","M",10,6,16
"6172","Daegan","M",29,34,63
"6173","Daeja","F",10,11,21
"6174","Dael","M",14,26,40
"6175","Daelan","M",19,22,41
"6176","Daelen","M",14,13,27
"6177","Daelin","M",8,11,19
"6178","Daelon","M",8,12,20
"6179","Daelyn","F",65,62,127
"6180","Daelyn","M",38,37,75
"6181","Daelynn","F",35,36,71
"6182","Daemon","M",50,38,88
"6183","Daemyn","M",8,6,14
"6184","Daena","F",5,7,12
"6185","Daenerys","F",82,101,183
"6186","Daequan","M",13,6,19
"6187","Daeshawn","M",17,13,30
"6188","Daeson","M",5,5,10
"6189","Daeton","M",6,7,13
"6190","Daeveon","M",6,5,11
"6191","Daevion","M",15,16,31
"6192","Daevon","M",14,12,26
"6193","Dafne","F",93,93,186
"6194","Dagan","M",13,17,30
"6195","Dagim","M",10,5,15
"6196","Dagmawi","M",8,14,22
"6197","Dagny","F",46,37,83
"6198","Dago","M",7,8,15
"6199","Dagoberto","M",12,14,26
"6200","Dah","F",7,5,12
"6201","Dah","M",7,6,13
"6202","Dahiana","F",12,15,27
"6203","Dahlia","F",774,839,1613
"6204","Dahlila","F",16,16,32
"6205","Dahlya","F",6,7,13
"6206","Daiana","F",56,46,102
"6207","Daianna","F",7,8,15
"6208","Daichi","M",5,10,15
"6209","Daiden","M",11,8,19
"6210","Daija","F",25,16,41
"6211","Daijah","F",31,28,59
"6212","Daijon","M",18,14,32
"6213","Daiki","M",6,6,12
"6214","Daila","F",31,38,69
"6215","Dailah","F",7,11,18
"6216","Dailani","F",5,5,10
"6217","Dailany","F",9,8,17
"6218","Dailee","F",7,10,17
"6219","Dailen","M",12,12,24
"6220","Dailey","F",5,13,18
"6221","Dailin","F",5,5,10
"6222","Daily","F",14,6,20
"6223","Dailyn","F",42,64,106
"6224","Dailyn","M",15,16,31
"6225","Dailynn","F",21,16,37
"6226","Daimen","M",5,6,11
"6227","Daimon","M",17,10,27
"6228","Dain","M",17,12,29
"6229","Daina","F",10,10,20
"6230","Daine","M",5,5,10
"6231","Daionna","F",6,5,11
"6232","Daira","F",17,30,47
"6233","Daire","M",9,13,22
"6234","Daisey","F",18,17,35
"6235","Daisha","F",32,33,65
"6236","Daishawn","M",10,15,25
"6237","Daisie","F",11,19,30
"6238","Daison","M",9,6,15
"6239","Daisy","F",1763,1717,3480
"6240","Daisymae","F",10,9,19
"6241","Daivik","M",7,9,16
"6242","Daivion","M",10,7,17
"6243","Daivon","M",7,6,13
"6244","Daiwik","M",8,7,15
"6245","Daiya","F",8,10,18
"6246","Daizee","F",11,7,18
"6247","Daizy","F",27,22,49
"6248","Daja","F",12,16,28
"6249","Dajah","F",21,7,28
"6250","Dajohn","M",6,5,11
"6251","Dajon","M",19,23,42
"6252","Dajour","M",7,8,15
"6253","Dajuan","M",33,26,59
"6254","Dakai","M",6,7,13
"6255","Dakarai","M",45,35,80
"6256","Dakari","F",8,8,16
"6257","Dakari","M",114,116,230
"6258","Dakarri","M",8,10,18
"6259","Dakayla","F",11,14,25
"6260","Daken","M",9,6,15
"6261","Dakhari","M",10,20,30
"6262","Daking","M",14,11,25
"6263","Dakiyah","F",5,8,13
"6264","Dakoda","F",22,32,54
"6265","Dakoda","M",62,52,114
"6266","Dakota","F",1330,1405,2735
"6267","Dakota","M",937,861,1798
"6268","Dakotah","F",73,58,131
"6269","Dakotah","M",38,44,82
"6270","Daksh","M",31,43,74
"6271","Daksha","F",12,11,23
"6272","Dal","M",7,7,14
"6273","Dalaila","F",8,5,13
"6274","Dalal","F",10,11,21
"6275","Dalan","M",10,6,16
"6276","Dalaney","F",15,15,30
"6277","Dalani","F",14,13,27
"6278","Dalanie","F",5,9,14
"6279","Dalari","F",8,13,21
"6280","Dalarie","F",10,10,20
"6281","Dalary","F",301,322,623
"6282","Dalaya","F",12,6,18
"6283","Dalayah","F",20,11,31
"6284","Dalayla","F",9,13,22
"6285","Dalayna","F",8,13,21
"6286","Dalaysia","F",9,15,24
"6287","Dalayza","F",27,17,44
"6288","Dale","M",177,171,348
"6289","Daleah","F",12,15,27
"6290","Daleigh","F",5,7,12
"6291","Daleisa","F",16,11,27
"6292","Daleiza","F",13,18,31
"6293","Dalen","M",31,33,64
"6294","Dalena","F",15,11,26
"6295","Dalery","F",6,9,15
"6296","Dalessandro","M",5,7,12
"6297","Daleth","F",5,7,12
"6298","Dalexa","F",22,25,47
"6299","Daley","F",10,7,17
"6300","Daley","M",6,12,18
"6301","Daleysa","F",103,67,170
"6302","Daleyssa","F",21,16,37
"6303","Daleyza","F",1395,1346,2741
"6304","Dalia","F",258,242,500
"6305","Daliah","F",39,48,87
"6306","Daliana","F",15,12,27
"6307","Dalida","F",10,7,17
"6308","Dalila","F",132,137,269
"6309","Dalilah","F",214,232,446
"6310","Dalina","F",17,11,28
"6311","Dalis","F",25,21,46
"6312","Dalissa","F",14,9,23
"6313","Daliya","F",13,5,18
"6314","Daliyah","F",69,69,138
"6315","Dallan","M",12,14,26
"6316","Dallana","F",10,11,21
"6317","Dallas","F",551,479,1030
"6318","Dallas","M",1412,1218,2630
"6319","Dallen","M",20,14,34
"6320","Dallie","F",14,14,28
"6321","Dallin","M",66,62,128
"6322","Dallis","F",45,31,76
"6323","Dallis","M",18,11,29
"6324","Dallon","M",6,9,15
"6325","Dally","F",18,12,30
"6326","Dallys","F",8,14,22
"6327","Dalon","M",14,11,25
"6328","Dalten","M",5,6,11
"6329","Dalton","M",1046,1038,2084
"6330","Dalvin","M",23,22,45
"6331","Dalya","F",19,11,30
"6332","Dalyah","F",6,11,17
"6333","Dalyla","F",39,26,65
"6334","Dalylah","F",31,30,61
"6335","Dalyn","F",5,7,12
"6336","Dalyn","M",21,18,39
"6337","Dalynn","F",5,12,17
"6338","Daman","M",12,10,22
"6339","Damani","F",25,17,42
"6340","Damani","M",75,69,144
"6341","Damar","M",19,16,35
"6342","Damara","F",9,9,18
"6343","Damarco","M",18,12,30
"6344","Damarcus","M",50,44,94
"6345","Damari","F",24,17,41
"6346","Damari","M",244,300,544
"6347","Damaria","F",13,14,27
"6348","Damarian","M",13,7,20
"6349","Damario","M",33,23,56
"6350","Damarion","M",169,129,298
"6351","Damarious","M",9,7,16
"6352","Damaris","F",162,152,314
"6353","Damaris","M",8,6,14
"6354","Damarius","M",36,26,62
"6355","Damariz","F",6,6,12
"6356","Damarri","M",10,15,25
"6357","Damarrion","M",11,8,19
"6358","Damauri","M",18,13,31
"6359","Damaya","F",17,25,42
"6360","Dameer","M",13,9,22
"6361","Dameir","M",8,9,17
"6362","Damen","M",37,29,66
"6363","Dameon","M",31,26,57
"6364","Dametrius","M",10,8,18
"6365","Damia","F",39,40,79
"6366","Damiah","F",17,13,30
"6367","Damian","M",3476,3328,6804
"6368","Damiana","F",13,22,35
"6369","Damiano","M",16,9,25
"6370","Damien","M",1415,1292,2707
"6371","Damier","M",20,14,34
"6372","Damilola","F",8,6,14
"6373","Damin","M",9,6,15
"6374","Damion","M",150,164,314
"6375","Damir","M",103,117,220
"6376","Damira","F",9,6,15
"6377","Damiya","F",40,25,65
"6378","Damiyah","F",67,79,146
"6379","Damon","M",713,695,1408
"6380","Damond","M",16,16,32
"6381","Damone","M",8,18,26
"6382","Damoney","M",5,7,12
"6383","Damoni","F",25,23,48
"6384","Damoni","M",106,79,185
"6385","Damonie","F",6,8,14
"6386","Damonie","M",19,17,36
"6387","Damont","M",5,6,11
"6388","Damontae","M",18,12,30
"6389","Damonte","M",25,28,53
"6390","Damori","M",5,5,10
"6391","Damya","F",46,45,91
"6392","Damyah","F",15,11,26
"6393","Damyan","M",10,5,15
"6394","Damyia","F",9,5,14
"6395","Damyiah","F",10,7,17
"6396","Damyra","F",8,6,14
"6397","Dan","M",90,100,190
"6398","Dana","F",326,320,646
"6399","Dana","M",37,31,68
"6400","Danae","F",86,57,143
"6401","Danah","F",24,26,50
"6402","Danahi","F",6,6,12
"6403","Danai","F",11,11,22
"6404","Danaly","F",14,7,21
"6405","Danaria","F",6,6,12
"6406","Danasia","F",12,13,25
"6407","Danay","F",14,20,34
"6408","Danaya","F",14,13,27
"6409","Dandre","M",84,91,175
"6410","Dane","F",5,6,11
"6411","Dane","M",423,351,774
"6412","Daneen","F",5,6,11
"6413","Danella","F",10,11,21
"6414","Danelle","F",9,16,25
"6415","Danelly","F",8,37,45
"6416","Danely","F",15,15,30
"6417","Danette","F",12,8,20
"6418","Dangelo","M",208,242,450
"6419","Danger","M",8,9,17
"6420","Dani","F",259,239,498
"6421","Dani","M",31,28,59
"6422","Dania","F",198,188,386
"6423","Daniah","F",18,22,40
"6424","Danial","M",28,30,58
"6425","Danica","F",401,320,721
"6426","Danicka","F",5,5,10
"6427","Danie","F",10,5,15
"6428","Daniel","F",18,22,40
"6429","Daniel","M",13464,12839,26303
"6430","Daniela","F",1641,1663,3304
"6431","Daniele","M",13,10,23
"6432","Daniella","F",1015,984,1999
"6433","Danielle","F",1083,984,2067
"6434","Danielys","F",13,6,19
"6435","Daniil","M",23,31,54
"6436","Danika","F",265,224,489
"6437","Danil","M",11,9,20
"6438","Danila","F",11,8,19
"6439","Danilo","M",196,196,392
"6440","Danilyn","F",6,11,17
"6441","Danilynn","F",22,16,38
"6442","Danique","F",6,5,11
"6443","Danira","F",8,5,13
"6444","Danis","M",7,6,13
"6445","Danish","M",5,7,12
"6446","Danisha","F",10,11,21
"6447","Danita","F",7,5,12
"6448","Danity","F",12,5,17
"6449","Danitza","F",22,27,49
"6450","Daniya","F",62,46,108
"6451","Daniyah","F",68,57,125
"6452","Daniyal","M",36,37,73
"6453","Daniyla","F",9,10,19
"6454","Danna","F",601,605,1206
"6455","Dannah","F",14,12,26
"6456","Danner","M",17,9,26
"6457","Danni","F",84,79,163
"6458","Dannia","F",17,13,30
"6459","Dannica","F",9,10,19
"6460","Dannie","F",25,22,47
"6461","Dannie","M",14,17,31
"6462","Danniel","M",18,19,37
"6463","Danniela","F",6,8,14
"6464","Danniella","F",5,7,12
"6465","Dannika","F",11,10,21
"6466","Dannon","M",5,5,10
"6467","Danny","F",9,12,21
"6468","Danny","M",714,636,1350
"6469","Dantae","M",10,10,20
"6470","Dante","M",1072,1004,2076
"6471","Danthony","M",41,26,67
"6472","Dantrell","M",9,11,20
"6473","Dany","M",31,26,57
"6474","Danya","F",59,63,122
"6475","Danyah","F",9,9,18
"6476","Danyal","M",13,12,25
"6477","Danyel","M",20,10,30
"6478","Danyell","F",7,5,12
"6479","Danyella","F",11,12,23
"6480","Danyelle","F",24,22,46
"6481","Danyiah","F",8,7,15
"6482","Danyka","F",9,6,15
"6483","Danyla","F",33,37,70
"6484","Danylah","F",21,18,39
"6485","Danylo","M",6,5,11
"6486","Danzig","M",6,6,12
"6487","Daoud","M",10,6,16
"6488","Daphne","F",864,809,1673
"6489","Daphnee","F",11,15,26
"6490","Daphney","F",24,19,43
"6491","Daphnie","F",20,17,37
"6492","Daquan","M",55,66,121
"6493","Dara","F",64,71,135
"6494","Dara","M",9,11,20
"6495","Darah","F",11,9,20
"6496","Daraly","F",7,8,15
"6497","Darby","F",110,120,230
"6498","Darby","M",27,17,44
"6499","Darcey","F",12,14,26
"6500","Darci","F",28,26,54
"6501","Darcie","F",25,13,38
"6502","Darcy","F",167,186,353
"6503","Darcy","M",12,7,19
"6504","Dareen","F",18,17,35
"6505","Darek","M",27,11,38
"6506","Darel","M",9,10,19
"6507","Darell","M",29,29,58
"6508","Darely","F",17,15,32
"6509","Daren","M",39,37,76
"6510","Dareon","M",6,9,15
"6511","Darey","M",26,23,49
"6512","Dari","F",6,10,16
"6513","Daria","F",125,97,222
"6514","Dariah","F",29,20,49
"6515","Darian","F",24,14,38
"6516","Darian","M",296,263,559
"6517","Dariana","F",160,171,331
"6518","Darianna","F",52,51,103
"6519","Darianny","F",12,10,22
"6520","Dariel","F",8,8,16
"6521","Dariel","M",260,319,579
"6522","Dariela","F",23,24,47
"6523","Darielis","F",10,6,16
"6524","Dariella","F",10,13,23
"6525","Darielle","F",17,22,39
"6526","Dariely","F",7,7,14
"6527","Darielys","F",11,14,25
"6528","Darien","M",188,181,369
"6529","Darilyn","F",5,5,10
"6530","Darin","M",70,70,140
"6531","Darina","F",30,26,56
"6532","Dario","M",234,222,456
"6533","Darion","M",70,86,156
"6534","Darionna","F",10,6,16
"6535","Darious","M",17,16,33
"6536","Daris","M",20,23,43
"6537","Darius","M",577,578,1155
"6538","Dariya","F",19,23,42
"6539","Dariyah","F",43,39,82
"6540","Darkiel","M",7,14,21
"6541","Darla","F",127,182,309
"6542","Darleen","F",15,19,34
"6543","Darlene","F",159,143,302
"6544","Darlin","F",12,18,30
"6545","Darling","F",21,26,47
"6546","Darlyn","F",23,35,58
"6547","Darlynn","F",9,6,15
"6548","Darnell","M",150,150,300
"6549","Daron","M",59,60,119
"6550","Darrel","M",29,21,50
"6551","Darrell","M",224,233,457
"6552","Darren","M",525,522,1047
"6553","Darrian","M",39,49,88
"6554","Darrick","M",32,32,64
"6555","Darrielle","F",8,8,16
"6556","Darrien","M",40,37,77
"6557","Darrin","M",57,59,116
"6558","Darrion","M",48,52,100
"6559","Darris","M",12,10,22
"6560","Darrius","M",78,71,149
"6561","Darron","M",30,35,65
"6562","Darryl","M",192,184,376
"6563","Darryn","M",22,21,43
"6564","Darsh","M",61,60,121
"6565","Darshan","M",19,13,32
"6566","Dartagnan","M",27,25,52
"6567","Dartanian","M",5,7,12
"6568","Darvin","M",19,28,47
"6569","Darwin","M",254,259,513
"6570","Darwyn","M",9,8,17
"6571","Darya","F",39,44,83
"6572","Daryah","F",8,7,15
"6573","Daryan","M",12,15,27
"6574","Daryana","F",11,6,17
"6575","Daryel","M",7,9,16
"6576","Daryl","M",160,141,301
"6577","Daryn","F",11,13,24
"6578","Daryn","M",22,27,49
"6579","Daryna","F",5,6,11
"6580","Dasan","M",5,10,15
"6581","Dasani","F",21,18,39
"6582","Dasani","M",9,8,17
"6583","Daschel","M",10,7,17
"6584","Dasean","M",12,24,36
"6585","Dash","F",14,13,27
"6586","Dash","M",310,303,613
"6587","Dasha","F",95,84,179
"6588","Dashaun","M",21,23,44
"6589","Dashawn","M",112,94,206
"6590","Dashel","M",41,34,75
"6591","Dashiel","M",17,34,51
"6592","Dashiell","M",174,145,319
"6593","Dashley","F",9,9,18
"6594","Dashon","M",11,18,29
"6595","Dashton","M",7,9,16
"6596","Dashun","M",5,6,11
"6597","Dasia","F",75,63,138
"6598","Dasiya","F",6,5,11
"6599","Dason","M",22,19,41
"6600","Dastan","M",17,16,33
"6601","Dathan","M",12,22,34
"6602","Daud","M",16,8,24
"6603","Daulton","M",12,18,30
"6604","Daunte","M",13,12,25
"6605","Dava","F",13,6,19
"6606","Davanee","F",11,9,20
"6607","Davante","M",16,17,33
"6608","Davari","M",7,11,18
"6609","Davarius","M",5,10,15
"6610","Davaughn","M",11,17,28
"6611","Davaya","F",7,6,13
"6612","Davayah","F",8,6,14
"6613","Dave","M",64,54,118
"6614","Daveah","F",11,15,26
"6615","Daveigh","F",8,7,15
"6616","Daveion","M",9,10,19
"6617","Daven","M",39,40,79
"6618","Daveon","M",36,39,75
"6619","Davey","F",8,14,22
"6620","Davey","M",22,20,42
"6621","Davi","F",15,21,36
"6622","Davi","M",91,97,188
"6623","Davia","F",16,14,30
"6624","Davian","M",255,202,457
"6625","Daviana","F",22,18,40
"6626","Davianna","F",18,28,46
"6627","David","F",18,14,32
"6628","David","M",11766,11028,22794
"6629","Davida","F",15,20,35
"6630","Davide","M",10,10,20
"6631","Davidson","M",32,30,62
"6632","Davie","F",17,17,34
"6633","Davie","M",6,6,12
"6634","Daviel","M",17,17,34
"6635","Davien","M",32,41,73
"6636","Davieon","M",8,6,14
"6637","Davier","M",10,8,18
"6638","Davin","M",216,183,399
"6639","Davina","F",215,273,488
"6640","Davinah","F",9,8,17
"6641","Davinci","M",20,16,36
"6642","Davine","F",9,9,18
"6643","Davinity","F",6,8,14
"6644","Davion","M",323,299,622
"6645","Daviona","F",9,5,14
"6646","Davionna","F",16,8,24
"6647","Davis","F",24,26,50
"6648","Davis","M",626,618,1244
"6649","Davison","M",10,9,19
"6650","Davit","M",18,17,35
"6651","Daviyon","M",5,5,10
"6652","Davon","M",162,120,282
"6653","Davone","M",7,5,12
"6654","Davonna","F",5,5,10
"6655","Davonta","M",21,12,33
"6656","Davontae","M",26,29,55
"6657","Davontay","M",12,8,20
"6658","Davonte","M",73,43,116
"6659","Davy","F",10,12,22
"6660","Davy","M",13,13,26
"6661","Davyn","M",18,15,33
"6662","Davyon","M",9,5,14
"6663","Dawan","M",6,6,12
"6664","Dawayne","M",10,9,19
"6665","Dawid","M",12,14,26
"6666","Dawit","M",17,20,37
"6667","Dawn","F",98,83,181
"6668","Dawood","M",22,16,38
"6669","Dawsen","M",18,19,37
"6670","Dawson","F",66,82,148
"6671","Dawson","M",1583,1778,3361
"6672","Dawsyn","F",50,64,114
"6673","Dawsyn","M",25,34,59
"6674","Dawt","F",11,18,29
"6675","Dawud","M",30,25,55
"6676","Dax","F",6,5,11
"6677","Dax","M",517,570,1087
"6678","Daxen","M",5,9,14
"6679","Daxon","M",93,101,194
"6680","Daxson","M",20,14,34
"6681","Daxten","M",20,33,53
"6682","Daxter","M",9,10,19
"6683","Daxtin","M",17,20,37
"6684","Daxton","M",848,917,1765
"6685","Daxtyn","M",32,31,63
"6686","Daxx","M",24,29,53
"6687","Daxxton","M",5,6,11
"6688","Daya","F",42,43,85
"6689","Dayah","F",6,10,16
"6690","Dayami","F",20,26,46
"6691","Dayan","F",7,7,14
"6692","Dayan","M",18,20,38
"6693","Dayana","F",521,496,1017
"6694","Dayanara","F",67,75,142
"6695","Dayani","F",54,32,86
"6696","Dayanna","F",165,149,314
"6697","Dayanne","F",13,8,21
"6698","Dayceon","M",6,9,15
"6699","Dayden","M",15,12,27
"6700","Dayelin","F",34,17,51
"6701","Dayja","F",7,6,13
"6702","Dayla","F",53,47,100
"6703","Daylah","F",7,6,13
"6704","Daylan","M",85,84,169
"6705","Daylani","F",14,10,24
"6706","Dayle","F",5,5,10
"6707","Daylee","F",18,13,31
"6708","Dayleen","F",12,12,24
"6709","Daylen","M",138,149,287
"6710","Daylin","F",59,54,113
"6711","Daylin","M",62,46,108
"6712","Daylon","M",53,53,106
"6713","Daylyn","F",12,6,18
"6714","Daylyn","M",8,9,17
"6715","Daylynn","F",21,5,26
"6716","Daymian","M",27,24,51
"6717","Daymien","M",15,14,29
"6718","Daymon","M",19,18,37
"6719","Daymond","M",6,11,17
"6720","Dayna","F",43,47,90
"6721","Dayne","M",39,41,80
"6722","Dayon","M",11,10,21
"6723","Dayonna","F",12,14,26
"6724","Dayquan","M",6,8,14
"6725","Dayra","F",41,51,92
"6726","Dayren","M",6,9,15
"6727","Dayro","M",6,6,12
"6728","Dayron","M",27,28,55
"6729","Daysen","M",10,7,17
"6730","Daysha","F",35,16,51
"6731","Dayshawn","M",14,11,25
"6732","Daysi","F",26,23,49
"6733","Daysia","F",11,13,24
"6734","Daysie","F",6,5,11
"6735","Dayson","M",67,38,105
"6736","Dayten","M",10,13,23
"6737","Dayton","F",17,22,39
"6738","Dayton","M",309,242,551
"6739","Daytona","F",12,13,25
"6740","Dayven","M",5,7,12
"6741","Dayveon","M",10,6,16
"6742","Dayvian","M",8,5,13
"6743","Dayvion","M",22,25,47
"6744","Dayvon","M",16,26,42
"6745","Dayzee","F",6,8,14
"6746","Dazaria","F",5,7,12
"6747","Daziah","F",7,6,13
"6748","Dazie","F",6,5,11
"6749","Daziyah","F",11,11,22
"6750","Dea","F",23,23,46
"6751","Deacon","M",667,645,1312
"6752","Deadrian","M",10,7,17
"6753","Deagan","M",50,53,103
"6754","Deaglan","M",50,34,84
"6755","Deaira","F",15,7,22
"6756","Deaire","M",10,10,20
"6757","Deaja","F",5,7,12
"6758","Deajah","F",6,6,12
"6759","Deaken","M",10,6,16
"6760","Deakin","M",12,13,25
"6761","Deakon","M",27,26,53
"6762","Dean","M",1937,1953,3890
"6763","Deana","F",23,32,55
"6764","Deandra","F",19,15,34
"6765","Deandrae","M",10,6,16
"6766","Deandre","M",439,375,814
"6767","Deandrea","F",14,5,19
"6768","Deandria","F",5,6,11
"6769","Deane","M",5,6,11
"6770","Deangela","F",10,6,16
"6771","Deangelo","M",211,172,383
"6772","Deanna","F",209,185,394
"6773","Deante","M",24,31,55
"6774","Deanthony","M",66,63,129
"6775","Deari","F",8,7,15
"6776","Dearia","F",10,10,20
"6777","Dearius","M",6,5,11
"6778","Deasia","F",103,95,198
"6779","Deason","M",5,5,10
"6780","Deaton","M",6,5,11
"6781","Deaundre","M",10,5,15
"6782","Deaven","M",8,5,13
"6783","Deavion","M",7,6,13
"6784","Debanhi","F",26,31,57
"6785","Debbie","F",28,26,54
"6786","Debby","F",5,8,13
"6787","Debora","F",79,93,172
"6788","Deborah","F",347,348,695
"6789","Debra","F",38,51,89
"6790","Decari","M",11,10,21
"6791","Decarlos","M",7,12,19
"6792","December","F",40,32,72
"6793","Dechlan","M",7,13,20
"6794","Deckard","M",9,28,37
"6795","Decker","M",182,197,379
"6796","Decklan","M",39,42,81
"6797","Decklen","M",9,6,15
"6798","Decklin","M",22,23,45
"6799","Decklyn","F",17,10,27
"6800","Decklyn","M",37,18,55
"6801","Declan","F",21,28,49
"6802","Declan","M",3580,3596,7176
"6803","Declen","M",11,8,19
"6804","Declin","M",11,6,17
"6805","Declyn","F",23,20,43
"6806","Declyn","M",31,40,71
"6807","Declynn","F",15,21,36
"6808","Dedric","M",10,14,24
"6809","Dedrick","M",47,39,86
"6810","Dee","M",6,5,11
"6811","Deeanna","F",6,5,11
"6812","Deegan","F",5,7,12
"6813","Deegan","M",172,162,334
"6814","Deeksha","F",18,11,29
"6815","Deem","F",11,11,22
"6816","Deema","F",31,35,66
"6817","Deen","M",40,39,79
"6818","Deena","F",50,41,91
"6819","Deepika","F",12,9,21
"6820","Deethya","F",9,12,21
"6821","Deetya","F",25,25,50
"6822","Deeya","F",7,5,12
"6823","Defne","F",28,48,76
"6824","Degan","M",18,13,31
"6825","Deidra","F",7,6,13
"6826","Deidre","F",6,5,11
"6827","Deilani","F",5,6,11
"6828","Deion","M",123,119,242
"6829","Deirdre","F",27,20,47
"6830","Deisy","F",46,31,77
"6831","Deja","F",125,102,227
"6832","Dejah","F",38,36,74
"6833","Dejanae","F",8,7,15
"6834","Dejaun","M",7,9,16
"6835","Dejohn","M",5,7,12
"6836","Dejon","M",27,26,53
"6837","Dejuan","M",59,50,109
"6838","Dekari","M",18,15,33
"6839","Dekayla","F",9,6,15
"6840","Dekker","M",33,34,67
"6841","Deklan","M",164,145,309
"6842","Deklen","M",32,16,48
"6843","Deklin","M",68,41,109
"6844","Deklyn","F",13,12,25
"6845","Deklyn","M",72,61,133
"6846","Deklynn","F",12,15,27
"6847","Dekota","F",13,18,31
"6848","Dekota","M",5,12,17
"6849","Del","M",7,12,19
"6850","Dela","F",5,5,10
"6851","Delaila","F",11,16,27
"6852","Delailah","F",5,7,12
"6853","Delaina","F",20,17,37
"6854","Delainey","F",59,56,115
"6855","Delan","M",6,7,13
"6856","Delana","F",22,22,44
"6857","Delance","M",6,5,11
"6858","Delancey","F",5,9,14
"6859","Delanee","F",13,15,28
"6860","Delaney","F",1325,1198,2523
"6861","Delaney","M",5,9,14
"6862","Delani","F",47,57,104
"6863","Delanie","F",165,150,315
"6864","Delano","M",49,43,92
"6865","Delante","M",8,8,16
"6866","Delany","F",53,57,110
"6867","Delara","F",7,10,17
"6868","Delayah","F",5,6,11
"6869","Delayla","F",18,17,35
"6870","Delaylah","F",7,5,12
"6871","Delayna","F",23,8,31
"6872","Delayne","F",7,12,19
"6873","Delaynee","F",8,14,22
"6874","Delayni","F",10,8,18
"6875","Delaynie","F",12,6,18
"6876","Delayza","F",30,14,44
"6877","Delbert","M",22,21,43
"6878","Deleah","F",9,10,19
"6879","Delena","F",8,5,13
"6880","Deleon","M",8,15,23
"6881","Deleyza","F",12,7,19
"6882","Delfina","F",21,27,48
"6883","Delfino","M",12,13,25
"6884","Delia","F",197,181,378
"6885","Deliah","F",26,22,48
"6886","Deliana","F",8,5,13
"6887","Delicia","F",18,10,28
"6888","Delila","F",66,53,119
"6889","Delilah","F",2721,2715,5436
"6890","Deliliah","F",7,7,14
"6891","Delina","F",37,37,74
"6892","Delisa","F",8,7,15
"6893","Deliyah","F",21,13,34
"6894","Della","F",215,247,462
"6895","Dellah","F",8,8,16
"6896","Delmar","M",15,27,42
"6897","Delmer","M",6,5,11
"6898","Delmy","F",12,9,21
"6899","Delon","M",14,23,37
"6900","Delonte","M",19,21,40
"6901","Delorean","M",10,10,20
"6902","Delores","F",20,25,45
"6903","Deloris","F",5,5,10
"6904","Delphia","F",6,9,15
"6905","Delphina","F",5,7,12
"6906","Delphine","F",60,45,105
"6907","Delroy","M",5,8,13
"6908","Delsin","M",9,11,20
"6909","Delson","M",8,6,14
"6910","Delta","F",39,39,78
"6911","Delton","M",16,21,37
"6912","Delvin","M",29,37,66
"6913","Delvon","M",13,11,24
"6914","Delwin","M",6,5,11
"6915","Delyla","F",35,19,54
"6916","Delylah","F",82,89,171
"6917","Demani","F",5,7,12
"6918","Demani","M",28,24,52
"6919","Demar","M",27,20,47
"6920","Demarco","M",84,73,157
"6921","Demarcus","M",181,164,345
"6922","Demari","F",14,13,27
"6923","Demari","M",124,122,246
"6924","Demaria","F",19,7,26
"6925","Demarian","M",7,11,18
"6926","Demarie","M",6,6,12
"6927","Demario","M",56,64,120
"6928","Demarion","M",123,89,212
"6929","Demarious","M",9,6,15
"6930","Demarius","M",43,40,83
"6931","Demarko","M",12,5,17
"6932","Demarkus","M",21,8,29
"6933","Demarri","M",7,5,12
"6934","Demarrion","M",8,10,18
"6935","Demaryius","M",13,15,28
"6936","Demauri","M",18,20,38
"6937","Demaya","F",8,11,19
"6938","Demere","M",5,10,15
"6939","Demerius","M",7,5,12
"6940","Demetra","F",9,13,22
"6941","Demetre","M",9,10,19
"6942","Demetri","M",84,75,159
"6943","Demetria","F",52,33,85
"6944","Demetric","M",17,11,28
"6945","Demetrice","M",15,5,20
"6946","Demetrick","M",5,5,10
"6947","Demetrio","M",32,33,65
"6948","Demetrios","M",32,21,53
"6949","Demetrious","M",18,13,31
"6950","Demetris","M",18,16,34
"6951","Demetrius","M",374,327,701
"6952","Demi","F",484,548,1032
"6953","Demia","F",10,14,24
"6954","Demiah","F",9,11,20
"6955","Demian","M",40,47,87
"6956","Demiana","F",12,6,18
"6957","Demichael","M",10,6,16
"6958","Demir","M",52,50,102
"6959","Demira","F",5,5,10
"6960","Demitri","M",49,44,93
"6961","Demitria","F",8,6,14
"6962","Demitrius","M",23,27,50
"6963","Demiya","F",24,17,41
"6964","Demiyah","F",28,38,66
"6965","Demond","M",46,50,96
"6966","Demondre","M",6,5,11
"6967","Demoni","F",9,16,25
"6968","Demoni","M",29,22,51
"6969","Demonie","M",8,6,14
"6970","Demonta","M",14,5,19
"6971","Demontae","M",12,13,25
"6972","Demonte","M",39,35,74
"6973","Demontre","M",7,9,16
"6974","Dempsey","F",37,23,60
"6975","Dempsey","M",72,71,143
"6976","Demri","F",11,7,18
"6977","Demya","F",24,16,40
"6978","Demyah","F",5,5,10
"6979","Demyiah","F",7,6,13
"6980","Dena","F",37,43,80
"6981","Denae","F",12,15,27
"6982","Denahi","M",8,5,13
"6983","Denali","F",63,62,125
"6984","Denali","M",28,24,52
"6985","Denaly","F",7,7,14
"6986","Denard","M",7,5,12
"6987","Denari","M",5,5,10
"6988","Denarius","M",7,7,14
"6989","Denasia","F",9,13,22
"6990","Denaya","F",5,5,10
"6991","Deng","M",16,15,31
"6992","Denia","F",14,15,29
"6993","Denice","F",9,9,18
"6994","Deniel","M",7,5,12
"6995","Denilson","M",9,12,21
"6996","Denim","F",49,62,111
"6997","Denim","M",98,117,215
"6998","Deniro","M",10,12,22
"6999","Denis","M",110,88,198
"7000","Denisa","F",6,6,12
"7001","Denise","F",270,205,475
"7002","Denisse","F",148,123,271
"7003","Deniya","F",18,10,28
"7004","Deniyah","F",19,24,43
"7005","Deniz","F",23,31,54
"7006","Deniz","M",39,56,95
"7007","Denna","F",7,7,14
"7008","Dennis","M",589,581,1170
"7009","Dennise","F",13,7,20
"7010","Denny","M",48,31,79
"7011","Dennys","M",12,6,18
"7012","Denson","M",5,6,11
"7013","Denton","M",52,42,94
"7014","Denver","F",197,180,377
"7015","Denver","M",242,268,510
"7016","Denyla","F",10,10,20
"7017","Denylah","F",5,5,10
"7018","Denym","F",21,18,39
"7019","Denym","M",11,15,26
"7020","Denzel","M",187,175,362
"7021","Denzell","M",14,11,25
"7022","Denzil","M",10,6,16
"7023","Deo","M",6,10,16
"7024","Deon","M",199,182,381
"7025","Deona","F",10,10,20
"7026","Deondra","F",8,5,13
"7027","Deondre","M",48,47,95
"7028","Deonna","F",58,31,89
"7029","Deonta","M",27,29,56
"7030","Deontae","M",69,63,132
"7031","Deontay","M",20,12,32
"7032","Deonte","M",82,75,157
"7033","Deontray","M",6,5,11
"7034","Deontre","M",12,16,28
"7035","Dequan","M",47,41,88
"7036","Dequarius","M",7,6,13
"7037","Dereck","M",129,125,254
"7038","Derek","M",1876,1702,3578
"7039","Derell","M",6,8,14
"7040","Dereon","F",5,9,14
"7041","Dereon","M",21,15,36
"7042","Derian","M",20,27,47
"7043","Deriana","F",5,6,11
"7044","Deric","M",40,28,68
"7045","Derica","F",7,7,14
"7046","Derick","M",189,167,356
"7047","Dericka","F",5,6,11
"7048","Deriel","M",8,5,13
"7049","Derik","M",30,27,57
"7050","Derin","F",12,8,20
"7051","Derin","M",21,21,42
"7052","Derion","M",16,17,33
"7053","Deriyah","F",14,13,27
"7054","Dermot","M",5,9,14
"7055","Deron","M",29,32,61
"7056","Derreck","M",9,5,14
"7057","Derrek","M",19,24,43
"7058","Derrell","M",21,25,46
"7059","Derrian","M",17,6,23
"7060","Derriana","F",5,7,12
"7061","Derric","M",11,8,19
"7062","Derrick","M",830,743,1573
"7063","Derricka","F",16,8,24
"7064","Derrik","M",10,13,23
"7065","Derrin","M",6,5,11
"7066","Derrion","M",35,23,58
"7067","Derriona","F",7,7,14
"7068","Derrius","M",10,5,15
"7069","Derry","M",7,6,13
"7070","Derwin","M",20,15,35
"7071","Deryck","M",5,7,12
"7072","Deryk","M",12,10,22
"7073","Deryn","F",5,8,13
"7074","Desarae","F",7,11,18
"7075","Desean","M",79,53,132
"7076","Deshaun","M",87,82,169
"7077","Deshawn","M",204,179,383
"7078","Deshon","M",20,23,43
"7079","Deshun","M",21,26,47
"7080","Desi","F",18,24,42
"7081","Desi","M",15,20,35
"7082","Desiah","F",5,5,10
"7083","Desiderio","M",5,10,15
"7084","Desirae","F",131,95,226
"7085","Desiray","F",16,14,30
"7086","Desire","F",70,105,175
"7087","Desiree","F",346,282,628
"7088","Deslynn","F",7,10,17
"7089","Desmon","M",15,12,27
"7090","Desmond","M",958,891,1849
"7091","Despina","F",9,10,19
"7092","Dessa","F",20,19,39
"7093","Dessie","F",11,8,19
"7094","Desta","F",5,5,10
"7095","Destan","M",8,10,18
"7096","Destani","F",7,9,16
"7097","Destanie","F",11,10,21
"7098","Destany","F",19,11,30
"7099","Desteny","F",12,17,29
"7100","Destin","F",20,15,35
"7101","Destin","M",143,131,274
"7102","Destine","F",11,11,22
"7103","Destinee","F",199,174,373
"7104","Destiney","F",66,32,98
"7105","Destini","F",89,78,167
"7106","Destinie","F",18,18,36
"7107","Destiny","F",1712,1573,3285
"7108","Deston","M",13,9,22
"7109","Destry","M",12,10,22
"7110","Destyn","F",12,9,21
"7111","Destyn","M",12,9,21
"7112","Destyni","F",20,14,34
"7113","Destynie","F",6,7,13
"7114","Detrick","M",14,7,21
"7115","Dev","M",106,121,227
"7116","Deva","F",7,9,16
"7117","Devaansh","M",8,16,24
"7118","Devaeh","F",5,8,13
"7119","Devan","F",18,29,47
"7120","Devan","M",121,130,251
"7121","Devani","F",15,12,27
"7122","Devanie","F",18,9,27
"7123","Devanny","F",14,15,29
"7124","Devansh","M",48,69,117
"7125","Devanshi","F",13,10,23
"7126","Devante","M",69,79,148
"7127","Devany","F",21,36,57
"7128","Devarsh","M",5,5,10
"7129","Devaughn","M",21,32,53
"7130","Deveah","F",8,6,14
"7131","Deven","M",108,96,204
"7132","Deveon","M",11,8,19
"7133","Devereaux","M",6,14,20
"7134","Devesh","M",11,22,33
"7135","Devi","F",18,15,33
"7136","Devika","F",11,17,28
"7137","Devin","F",110,104,214
"7138","Devin","M",1376,1164,2540
"7139","Devina","F",37,30,67
"7140","Devine","F",17,11,28
"7141","Devine","M",8,13,21
"7142","Devion","M",32,26,58
"7143","Devlin","M",58,45,103
"7144","Devlyn","F",15,9,24
"7145","Devlynn","F",5,6,11
"7146","Devoiry","F",5,7,12
"7147","Devon","F",77,61,138
"7148","Devon","M",512,481,993
"7149","Devone","M",9,11,20
"7150","Devonna","F",5,7,12
"7151","Devonne","M",10,6,16
"7152","Devonta","M",35,31,66
"7153","Devontae","M",54,48,102
"7154","Devontay","M",11,13,24
"7155","Devonte","M",127,129,256
"7156","Devora","F",63,44,107
"7157","Devorah","F",93,102,195
"7158","Devory","F",5,6,11
"7159","Devron","M",6,6,12
"7160","Devyn","F",262,223,485
"7161","Devyn","M",107,101,208
"7162","Devynn","F",32,22,54
"7163","Dewayne","M",102,83,185
"7164","Dewey","M",17,16,33
"7165","Dewitt","M",9,5,14
"7166","Dewon","M",6,6,12
"7167","Dex","M",26,43,69
"7168","Dexter","M",755,695,1450
"7169","Dextin","M",7,5,12
"7170","Dexton","M",35,33,68
"7171","Deya","F",5,12,17
"7172","Deyana","F",7,8,15
"7173","Deyanira","F",20,13,33
"7174","Deyanna","F",15,5,20
"7175","Deyjah","F",6,6,12
"7176","Deylan","M",8,7,15
"7177","Deylani","F",9,6,15
"7178","Deyon","M",11,10,21
"7179","Deyonna","F",15,9,24
"7180","Deyren","M",5,5,10
"7181","Deysi","F",30,24,54
"7182","Dez","M",44,30,74
"7183","Dezarae","F",14,14,28
"7184","Dezaray","F",5,5,10
"7185","Dezi","F",13,15,28
"7186","Dezi","M",11,12,23
"7187","Deziah","F",9,6,15
"7188","Dezion","M",7,6,13
"7189","Dezirae","F",50,36,86
"7190","Deziray","F",15,9,24
"7191","Dezire","F",22,39,61
"7192","Deziree","F",14,11,25
"7193","Deziyah","F",13,7,20
"7194","Dezlyn","F",7,12,19
"7195","Dezlynn","F",8,6,14
"7196","Dezmen","M",13,6,19
"7197","Dezmin","M",6,8,14
"7198","Dezmon","M",20,15,35
"7199","Dezmond","M",126,118,244
"7200","Deztiny","F",8,10,18
"7201","Dhairya","M",9,7,16
"7202","Dhalia","F",10,7,17
"7203","Dhani","F",9,5,14
"7204","Dhani","M",12,6,18
"7205","Dhanush","M",5,7,12
"7206","Dhanvi","F",14,13,27
"7207","Dhanvin","M",15,9,24
"7208","Dhanya","F",15,13,28
"7209","Dhara","F",6,9,15
"7210","Dharius","M",8,10,18
"7211","Dharma","F",13,10,23
"7212","Dheeraj","M",5,5,10
"7213","Dhilan","M",31,21,52
"7214","Dhiya","F",13,21,34
"7215","Dhrithi","F",11,6,17
"7216","Dhriti","F",41,28,69
"7217","Dhruv","M",157,159,316
"7218","Dhruva","M",21,29,50
"7219","Dhruvan","M",7,11,18
"7220","Dhruvi","F",9,18,27
"7221","Dhwani","F",9,14,23
"7222","Dhyan","M",32,26,58
"7223","Dhyey","M",7,6,13
"7224","Dia","F",62,49,111
"7225","Diago","M",17,21,38
"7226","Diala","F",10,13,23
"7227","Diallo","M",8,9,17
"7228","Diamante","F",10,5,15
"7229","Diamante","M",8,10,18
"7230","Diamond","F",262,226,488
"7231","Diamond","M",35,33,68
"7232","Diamonique","F",8,11,19
"7233","Diamonte","M",6,9,15
"7234","Dian","M",8,8,16
"7235","Diana","F",1084,1178,2262
"7236","Diandra","F",5,7,12
"7237","Diane","F",92,101,193
"7238","Diangelo","M",9,13,22
"7239","Dianna","F",115,90,205
"7240","Dianne","F",26,30,56
"7241","Diante","M",8,10,18
"7242","Diar","M",8,9,17
"7243","Diara","F",9,7,16
"7244","Dickson","M",9,7,16
"7245","Didier","M",46,43,89
"7246","Diego","F",9,7,16
"7247","Diego","M",3227,3186,6413
"7248","Diem","F",51,54,105
"7249","Diem","M",6,8,14
"7250","Dierks","M",29,22,51
"7251","Diesel","M",140,135,275
"7252","Dieter","M",9,8,17
"7253","Dietrich","M",28,56,84
"7254","Diezel","M",26,12,38
"7255","Digna","F",5,7,12
"7256","Dijon","M",12,14,26
"7257","Dilan","M",240,199,439
"7258","Dilara","F",16,20,36
"7259","Dilcia","F",6,6,12
"7260","Dillan","F",8,9,17
"7261","Dillan","M",118,102,220
"7262","Dillen","M",6,12,18
"7263","Dillinger","M",21,20,41
"7264","Dillion","M",21,32,53
"7265","Dillon","F",28,37,65
"7266","Dillon","M",680,660,1340
"7267","Dillyn","F",13,12,25
"7268","Dillyn","M",14,8,22
"7269","Dilyn","F",9,8,17
"7270","Dilynn","F",38,33,71
"7271","Dim","F",9,14,23
"7272","Dima","F",17,26,43
"7273","Dimas","M",24,25,49
"7274","Dimitra","F",9,6,15
"7275","Dimitri","M",237,219,456
"7276","Dimitrios","M",39,30,69
"7277","Dimitris","M",5,7,12
"7278","Dimitrius","M",10,12,22
"7279","Dimitry","M",16,17,33
"7280","Dina","F",158,159,317
"7281","Dinah","F",60,54,114
"7282","Dinero","M",12,19,31
"7283","Dino","M",43,36,79
"7284","Dinora","F",12,10,22
"7285","Dinorah","F",8,5,13
"7286","Diogo","M",8,7,15
"7287","Dion","F",9,13,22
"7288","Dion","M",139,141,280
"7289","Diona","F",6,9,15
"7290","Diondre","M",16,15,31
"7291","Dionel","M",5,6,11
"7292","Dionicio","M",15,16,31
"7293","Dionisio","M",8,12,20
"7294","Dionna","F",16,25,41
"7295","Dionne","F",20,15,35
"7296","Diontae","M",9,9,18
"7297","Dionte","M",27,28,55
"7298","Dior","F",160,157,317
"7299","Dior","M",34,36,70
"7300","Diora","F",18,10,28
"7301","Dipson","M",8,6,14
"7302","Dirk","M",25,24,49
"7303","Disha","F",26,17,43
"7304","Disney","F",9,7,16
"7305","Ditya","F",11,9,20
"7306","Diva","F",13,15,28
"7307","Divina","F",42,45,87
"7308","Divine","F",78,86,164
"7309","Divine","M",36,42,78
"7310","Divinity","F",38,44,82
"7311","Divit","M",8,20,28
"7312","Divya","F",58,46,104
"7313","Divyansh","M",9,9,18
"7314","Dixie","F",287,254,541
"7315","Dixon","M",70,75,145
"7316","Diya","F",257,242,499
"7317","Diyan","M",11,9,20
"7318","Diyora","F",8,15,23
"7319","Dj","M",13,21,34
"7320","Django","M",12,8,20
"7321","Djibril","M",6,16,22
"7322","Djuan","M",17,15,32
"7323","Dmani","M",10,8,18
"7324","Dmarco","M",6,7,13
"7325","Dmarcus","M",17,8,25
"7326","Dmari","M",36,39,75
"7327","Dmarion","M",24,21,45
"7328","Dmauri","M",5,16,21
"7329","Dmitri","M",75,63,138
"7330","Dmitriy","M",18,17,35
"7331","Dmitry","M",36,30,66
"7332","Dmiyah","F",13,9,22
"7333","Dmoni","M",10,12,22
"7334","Dmya","F",10,13,23
"7335","Dniyah","F",10,10,20
"7336","Dnyla","F",6,7,13
"7337","Doc","M",10,35,45
"7338","Dodge","M",31,24,55
"7339","Dodger","M",11,10,21
"7340","Doha","F",8,6,14
"7341","Dolan","M",13,27,40
"7342","Dolce","F",13,6,19
"7343","Dolly","F",30,41,71
"7344","Dolores","F",33,50,83
"7345","Dolton","M",6,6,12
"7346","Dom","M",5,9,14
"7347","Domani","M",39,28,67
"7348","Domanic","M",23,12,35
"7349","Domanick","M",11,10,21
"7350","Domenic","M",105,87,192
"7351","Domenica","F",21,22,43
"7352","Domenick","M",31,26,57
"7353","Domenico","M",60,54,114
"7354","Dominga","F",11,14,25
"7355","Domingo","M",57,55,112
"7356","Dominic","F",18,11,29
"7357","Dominic","M",5837,5394,11231
"7358","Dominica","F",14,9,23
"7359","Dominick","M",1104,1024,2128
"7360","Dominico","M",7,9,16
"7361","Dominik","M",403,337,740
"7362","Dominika","F",15,14,29
"7363","Dominiq","M",11,16,27
"7364","Dominique","F",136,154,290
"7365","Dominique","M",236,211,447
"7366","Domino","F",7,8,15
"7367","Dominque","M",12,5,17
"7368","Dominyck","M",6,5,11
"7369","Dominyk","M",6,7,13
"7370","Domnick","M",5,5,10
"7371","Domonic","M",36,31,67
"7372","Domonick","M",11,10,21
"7373","Domonique","M",18,14,32
"7374","Don","M",115,104,219
"7375","Donal","M",7,5,12
"7376","Donald","M",690,621,1311
"7377","Donaldo","M",7,7,14
"7378","Donatella","F",11,13,24
"7379","Donatello","M",32,28,60
"7380","Donathan","M",6,6,12
"7381","Donato","M",28,31,59
"7382","Donavan","M",94,74,168
"7383","Donaven","M",16,9,25
"7384","Donavin","M",36,42,78
"7385","Donavon","M",36,35,71
"7386","Donavyn","M",6,9,15
"7387","Dondre","M",19,13,32
"7388","Donell","M",18,9,27
"7389","Donia","F",6,14,20
"7390","Doniel","M",5,5,10
"7391","Donivan","M",14,13,27
"7392","Donn","M",5,6,11
"7393","Donna","F",159,117,276
"7394","Donnell","M",78,74,152
"7395","Donnie","M",118,111,229
"7396","Donnovan","M",12,14,26
"7397","Donny","M",39,36,75
"7398","Donovan","M",1297,1148,2445
"7399","Donoven","M",7,9,16
"7400","Donovin","M",20,20,40
"7401","Donta","M",21,37,58
"7402","Dontae","M",96,66,162
"7403","Dontavious","M",26,35,61
"7404","Dontavius","M",9,9,18
"7405","Dontay","M",29,27,56
"7406","Donte","M",154,129,283
"7407","Dontez","M",16,19,35
"7408","Dontrell","M",33,39,72
"7409","Donya","F",11,7,18
"7410","Donyae","M",5,5,10
"7411","Dora","F",101,108,209
"7412","Doran","M",7,14,21
"7413","Dorcas","F",30,26,56
"7414","Doreen","F",27,28,55
"7415","Dori","F",12,10,22
"7416","Doria","F",5,5,10
"7417","Dorian","F",23,23,46
"7418","Dorian","M",507,531,1038
"7419","Dorie","F",5,5,10
"7420","Dorien","M",15,14,29
"7421","Dorion","M",11,8,19
"7422","Doris","F",85,117,202
"7423","Dorlan","M",7,12,19
"7424","Dorothea","F",38,43,81
"7425","Dorothy","F",396,448,844
"7426","Dorrian","M",12,8,20
"7427","Dorthy","F",6,5,11
"7428","Dottie","F",39,36,75
"7429","Douglas","M",430,445,875
"7430","Douglass","M",8,7,15
"7431","Dov","M",117,135,252
"7432","Dovber","M",11,10,21
"7433","Dove","F",17,20,37
"7434","Dovid","M",124,103,227
"7435","Dovie","F",8,17,25
"7436","Doyle","M",12,10,22
"7437","Drace","M",5,5,10
"7438","Dracen","M",14,10,24
"7439","Draco","M",36,36,72
"7440","Draeden","M",8,5,13
"7441","Draedyn","M",9,6,15
"7442","Drago","M",9,5,14
"7443","Draiden","M",23,20,43
"7444","Draizy","F",7,11,18
"7445","Drake","M",774,690,1464
"7446","Draken","M",9,8,17
"7447","Draper","M",9,13,22
"7448","Draven","M",263,250,513
"7449","Dravin","M",7,16,23
"7450","Dravyn","M",16,7,23
"7451","Dray","M",10,8,18
"7452","Draya","F",75,79,154
"7453","Drayce","M",6,10,16
"7454","Draycen","M",5,8,13
"7455","Drayden","M",107,83,190
"7456","Drayke","M",8,10,18
"7457","Draylen","M",11,10,21
"7458","Draylon","M",6,6,12
"7459","Draymond","M",6,8,14
"7460","Draysen","M",10,7,17
"7461","Drayson","M",15,31,46
"7462","Drayton","M",41,48,89
"7463","Drayven","M",27,23,50
"7464","Dre","M",28,20,48
"7465","Drea","F",41,23,64
"7466","Dream","F",98,128,226
"7467","Dream","M",8,9,17
"7468","Dreama","F",14,13,27
"7469","Dreanna","F",6,5,11
"7470","Dreden","M",8,9,17
"7471","Dredyn","M",19,15,34
"7472","Drelyn","M",14,11,25
"7473","Dresden","M",57,56,113
"7474","Dreshaun","M",6,6,12
"7475","Dreshawn","M",16,20,36
"7476","Dreshon","M",7,5,12
"7477","Dreux","M",12,11,23
"7478","Drevion","M",13,8,21
"7479","Drevon","M",13,15,28
"7480","Drew","F",212,216,428
"7481","Drew","M",889,793,1682
"7482","Drexel","M",20,7,27
"7483","Drey","M",15,9,24
"7484","Dreya","F",22,28,50
"7485","Dreyah","F",8,11,19
"7486","Dreyden","M",23,31,54
"7487","Dreydon","M",6,5,11
"7488","Dreyson","M",19,16,35
"7489","Dreyton","M",5,5,10
"7490","Drezden","M",10,6,16
"7491","Drianna","F",7,6,13
"7492","Drishti","F",11,7,18
"7493","Drishya","F",7,9,16
"7494","Dru","F",22,25,47
"7495","Dru","M",23,33,56
"7496","Drue","F",13,8,21
"7497","Drue","M",12,16,28
"7498","Drusilla","F",6,6,12
"7499","Dryden","M",11,10,21
"7500","Dshaun","M",9,7,16
"7501","Dshawn","M",13,12,25
"7502","Dua","F",33,41,74
"7503","Duaa","F",19,28,47
"7504","Duane","M",113,115,228
"7505","Dublin","F",10,7,17
"7506","Dublin","M",26,16,42
"7507","Duchess","F",10,14,24
"7508","Dudley","M",7,12,19
"7509","Dugan","M",7,9,16
"7510","Dujuan","M",13,5,18
"7511","Duke","M",454,513,967
"7512","Dulce","F",430,379,809
"7513","Dulcemaria","F",24,29,53
"7514","Dulcie","F",8,7,15
"7515","Dulcinea","F",9,8,17
"7516","Duncan","M",293,285,578
"7517","Dunia","F",11,8,19
"7518","Dunya","F",17,17,34
"7519","Dupree","M",7,6,13
"7520","Duran","M",11,12,23
"7521","Durell","M",9,5,14
"7522","Durham","M",5,9,14
"7523","Duron","M",9,5,14
"7524","Durrell","M",19,17,36
"7525","Duru","F",9,5,14
"7526","Dusti","F",11,6,17
"7527","Dustin","M",576,550,1126
"7528","Dusty","F",16,14,30
"7529","Dusty","M",48,36,84
"7530","Dustyn","M",25,24,49
"7531","Dutch","M",42,41,83
"7532","Dutchess","F",13,13,26
"7533","Duvid","M",16,12,28
"7534","Duwayne","M",7,7,14
"7535","Duy","M",6,8,14
"7536","Dvonte","M",5,9,14
"7537","Dwain","M",12,5,17
"7538","Dwan","M",9,5,14
"7539","Dwayne","M",292,219,511
"7540","Dwight","M",103,97,200
"7541","Dyami","M",8,9,17
"7542","Dyamond","F",7,6,13
"7543","Dyan","M",5,5,10
"7544","Dyana","F",16,16,32
"7545","Dyani","F",26,32,58
"7546","Dyanna","F",15,19,34
"7547","Dyce","M",5,8,13
"7548","Dylan","F",814,837,1651
"7549","Dylan","M",10267,9657,19924
"7550","Dyland","M",90,61,151
"7551","Dylaney","F",5,5,10
"7552","Dylanie","F",11,6,17
"7553","Dylann","F",47,55,102
"7554","Dylann","M",30,24,54
"7555","Dylen","M",36,30,66
"7556","Dylilah","F",7,8,15
"7557","Dylin","M",13,8,21
"7558","Dyllan","F",21,17,38
"7559","Dyllan","M",47,57,104
"7560","Dyllon","M",9,11,20
"7561","Dylon","M",45,45,90
"7562","Dylynn","F",9,13,22
"7563","Dymond","F",13,10,23
"7564","Dyna","F",6,5,11
"7565","Dynasti","F",13,13,26
"7566","Dynasty","F",32,54,86
"7567","Dynver","F",14,19,33
"7568","Dyron","M",9,5,14
"7569","Dyson","M",73,63,136
"7570","Dziyah","F",7,5,12
"7571","Eaden","M",7,15,22
"7572","Eagan","M",9,14,23
"7573","Eames","M",12,11,23
"7574","Eamon","M",141,181,322
"7575","Eamonn","M",35,33,68
"7576","Ean","M",209,194,403
"7577","Earl","M",128,109,237
"7578","Early","M",13,6,19
"7579","Earnest","M",33,24,57
"7580","Eashan","M",10,9,19
"7581","Eason","M",175,237,412
"7582","Easten","M",35,31,66
"7583","Eastin","M",34,34,68
"7584","Easton","F",72,60,132
"7585","Easton","M",5220,5606,10826
"7586","Eastyn","F",51,54,105
"7587","Eastyn","M",65,80,145
"7588","Eastynn","F",6,5,11
"7589","Eathan","M",11,18,29
"7590","Eaton","M",5,7,12
"7591","Eban","M",9,8,17
"7592","Ebba","F",13,12,25
"7593","Eben","M",75,57,132
"7594","Ebenezer","M",49,41,90
"7595","Eber","M",20,18,38
"7596","Eberardo","M",7,5,12
"7597","Ebin","M",14,6,20
"7598","Eboni","F",7,9,16
"7599","Ebony","F",56,67,123
"7600","Ebrahim","M",23,35,58
"7601","Ebubechukwu","M",10,7,17
"7602","Ebunoluwa","F",8,10,18
"7603","Echo","F",113,100,213
"7604","Echo","M",13,15,28
"7605","Ed","M",8,8,16
"7606","Eda","F",22,19,41
"7607","Edahi","M",18,11,29
"7608","Edan","F",8,7,15
"7609","Edan","M",49,41,90
"7610","Edda","F",13,7,20
"7611","Edden","M",6,8,14
"7612","Edder","M",14,9,23
"7613","Eddie","M",381,398,779
"7614","Eddiel","M",6,5,11
"7615","Eddison","M",25,29,54
"7616","Eddrick","M",5,6,11
"7617","Eddy","M",118,139,257
"7618","Edee","F",6,6,12
"7619","Edel","M",10,7,17
"7620","Edelin","F",6,9,15
"7621","Edeline","F",13,11,24
"7622","Edelweiss","F",8,6,14
"7623","Edelyn","F",14,32,46
"7624","Edelynn","F",7,16,23
"7625","Edem","M",6,7,13
"7626","Eden","F",2060,2068,4128
"7627","Eden","M",572,562,1134
"7628","Eder","M",142,116,258
"7629","Ederson","M",9,5,14
"7630","Edessa","F",6,5,11
"7631","Edgar","M",1111,1009,2120
"7632","Edgard","M",9,13,22
"7633","Edgardo","M",39,41,80
"7634","Edi","M",8,9,17
"7635","Edie","F",115,145,260
"7636","Ediel","M",18,20,38
"7637","Edin","M",52,57,109
"7638","Edina","F",6,9,15
"7639","Edinson","M",20,8,28
"7640","Edison","F",10,11,21
"7641","Edison","M",420,480,900
"7642","Edisson","M",6,5,11
"7643","Edith","F",596,631,1227
"7644","Ediz","M",6,9,15
"7645","Edlyn","F",16,14,30
"7646","Edmond","M",76,69,145
"7647","Edmund","M",173,190,363
"7648","Edmundo","M",22,15,37
"7649","Edna","F",76,80,156
"7650","Edom","F",9,6,15
"7651","Edon","M",6,12,18
"7652","Edras","M",11,7,18
"7653","Edrian","M",9,18,27
"7654","Edric","M",39,42,81
"7655","Edrick","M",46,36,82
"7656","Edris","M",18,12,30
"7657","Edsel","M",9,9,18
"7658","Edson","M",50,56,106
"7659","Eduar","M",9,15,24
"7660","Eduard","M",34,39,73
"7661","Eduarda","F",5,6,11
"7662","Eduardo","M",1445,1321,2766
"7663","Eduin","M",6,7,13
"7664","Edvin","M",26,21,47
"7665","Edwar","M",8,10,18
"7666","Edward","M",2592,2491,5083
"7667","Edwardo","M",24,15,39
"7668","Edwin","M",1144,1096,2240
"7669","Edwina","F",9,8,17
"7670","Edwyn","M",13,18,31
"7671","Edy","M",25,13,38
"7672","Edyn","F",64,77,141
"7673","Edyn","M",5,6,11
"7674","Edynn","F",8,13,21
"7675","Edyth","F",7,7,14
"7676","Edythe","F",7,12,19
"7677","Eero","M",32,26,58
"7678","Eesa","M",36,70,106
"7679","Eesha","F",36,40,76
"7680","Eeshan","M",16,23,39
"7681","Eeva","F",18,15,33
"7682","Eevee","F",24,42,66
"7683","Eevie","F",6,8,14
"7684","Efe","M",6,13,19
"7685","Effie","F",54,68,122
"7686","Effy","F",11,6,17
"7687","Efraim","M",47,39,86
"7688","Efrain","M",188,170,358
"7689","Efrata","F",12,18,30
"7690","Efren","M",99,93,192
"7691","Egan","M",29,22,51
"7692","Ege","M",11,17,28
"7693","Egor","M",9,11,20
"7694","Egypt","F",200,254,454
"7695","Egypt","M",29,77,106
"7696","Eh","F",17,31,48
"7697","Eh","M",30,29,59
"7698","Ehab","M",5,14,19
"7699","Ehan","M",25,23,48
"7700","Ehren","M",7,9,16
"7701","Ehsan","M",17,18,35
"7702","Eian","M",66,52,118
"7703","Eibhlin","F",8,6,14
"7704","Eidan","M",35,43,78
"7705","Eiden","M",55,79,134
"7706","Eiji","M",5,6,11
"7707","Eila","F",85,95,180
"7708","Eilah","F",7,6,13
"7709","Eilam","M",9,10,19
"7710","Eilan","M",10,9,19
"7711","Eilee","F",16,14,30
"7712","Eileen","F",408,389,797
"7713","Eilene","F",8,5,13
"7714","Eiley","F",28,21,49
"7715","Eilidh","F",13,11,24
"7716","Eilis","F",6,14,20
"7717","Eiliyah","F",25,18,43
"7718","Eily","F",24,25,49
"7719","Eilyn","F",13,17,30
"7720","Eimaan","F",5,6,11
"7721","Eimi","F",7,7,14
"7722","Eimy","F",40,58,98
"7723","Ein","M",10,12,22
"7724","Einar","M",6,5,11
"7725","Eira","F",33,37,70
"7726","Eirene","F",10,13,23
"7727","Eirik","M",13,13,26
"7728","Eisa","F",8,13,21
"7729","Eisa","M",21,34,55
"7730","Eisen","M",10,8,18
"7731","Eisha","F",5,8,13
"7732","Eislee","F",10,11,21
"7733","Eisleigh","F",7,6,13
"7734","Eisley","F",194,181,375
"7735","Eissa","M",6,11,17
"7736","Eita","M",6,10,16
"7737","Eitan","M",93,100,193
"7738","Eithan","M",99,95,194
"7739","Eithen","M",10,10,20
"7740","Eito","M",10,7,17
"7741","Eivan","M",16,14,30
"7742","Eiven","M",7,6,13
"7743","Eivin","M",67,53,120
"7744","Eiza","F",90,119,209
"7745","Ej","M",11,11,22
"7746","Ejay","M",13,8,21
"7747","Ekam","F",11,15,26
"7748","Ekam","M",35,38,73
"7749","Ekaterina","F",40,33,73
"7750","Eker","M",6,5,11
"7751","Ekin","M",9,5,14
"7752","Eknoor","F",17,6,23
"7753","Ela","F",99,100,199
"7754","Eladio","M",13,11,24
"7755","Elaf","F",12,17,29
"7756","Elah","F",33,18,51
"7757","Elai","M",11,9,20
"7758","Elaina","F",1101,1184,2285
"7759","Elainah","F",16,15,31
"7760","Elaine","F",422,490,912
"7761","Elainna","F",14,15,29
"7762","Elaiza","F",7,8,15
"7763","Elam","M",143,107,250
"7764","Elan","F",18,17,35
"7765","Elan","M",114,123,237
"7766","Elana","F",147,148,295
"7767","Elanah","F",8,6,14
"7768","Eland","M",8,7,15
"7769","Elani","F",66,72,138
"7770","Elania","F",9,10,19
"7771","Elanie","F",35,43,78
"7772","Elanna","F",16,16,32
"7773","Elanni","F",7,5,12
"7774","Elanor","F",61,55,116
"7775","Elanore","F",6,6,12
"7776","Elany","F",13,16,29
"7777","Elara","F",32,55,87
"7778","Elaria","F",11,11,22
"7779","Elaya","F",9,14,23
"7780","Elayah","F",13,23,36
"7781","Elayjah","F",6,8,14
"7782","Elayna","F",201,219,420
"7783","Elaynah","F",7,11,18
"7784","Elayne","F",24,34,58
"7785","Elaysia","F",14,19,33
"7786","Elazar","M",21,21,42
"7787","Elba","F",9,8,17
"7788","Elbert","M",15,21,36
"7789","Elchonon","M",17,15,32
"7790","Elcie","F",6,5,11
"7791","Elda","F",19,10,29
"7792","Eldana","F",37,45,82
"7793","Eldar","M",11,13,24
"7794","Elden","M",38,44,82
"7795","Elder","M",32,40,72
"7796","Eldin","M",16,23,39
"7797","Eldon","M",54,63,117
"7798","Eldric","M",6,5,11
"7799","Eldrick","M",8,5,13
"7800","Eldridge","M",5,6,11
"7801","Elea","F",21,11,32
"7802","Eleah","F",12,14,26
"7803","Eleana","F",45,36,81
"7804","Eleanna","F",8,7,15
"7805","Eleanor","F",4424,5100,9524
"7806","Eleanora","F",156,218,374
"7807","Eleanore","F",90,87,177
"7808","Eleazar","M",128,131,259
"7809","Electra","F",17,11,28
"7810","Eleen","F",39,38,77
"7811","Eleena","F",24,26,50
"7812","Eleina","F",16,25,41
"7813","Elek","M",12,10,22
"7814","Elektra","F",29,21,50
"7815","Elen","F",7,7,14
"7816","Elena","F",2886,3168,6054
"7817","Elene","F",9,7,16
"7818","Eleni","F",134,162,296
"7819","Elenie","F",13,5,18
"7820","Elenna","F",14,12,26
"7821","Elenor","F",9,18,27
"7822","Elenora","F",14,34,48
"7823","Elenore","F",23,22,45
"7824","Eleny","F",16,23,39
"7825","Eleonor","F",12,15,27
"7826","Eleonora","F",33,43,76
"7827","Eleonore","F",18,17,35
"7828","Eleora","F",16,28,44
"7829","Eleri","F",7,5,12
"7830","Elex","M",7,8,15
"7831","Elexa","F",14,19,33
"7832","Elexia","F",7,15,22
"7833","Elexis","F",34,19,53
"7834","Eleyna","F",44,35,79
"7835","Elgin","M",25,21,46
"7836","Elhadj","M",5,6,11
"7837","Elham","F",9,8,17
"7838","Eli","F",27,33,60
"7839","Eli","M",7122,7046,14168
"7840","Elia","F",200,194,394
"7841","Elia","M",18,20,38
"7842","Eliab","M",35,46,81
"7843","Eliah","F",20,26,46
"7844","Eliah","M",46,50,96
"7845","Eliahna","F",5,6,11
"7846","Eliakim","M",13,14,27
"7847","Eliam","M",94,138,232
"7848","Elian","M",362,449,811
"7849","Eliana","F",2973,3185,6158
"7850","Elianah","F",41,39,80
"7851","Eliane","F",18,15,33
"7852","Eliani","F",17,27,44
"7853","Elianie","F",12,6,18
"7854","Elianis","F",12,10,22
"7855","Elianna","F",494,535,1029
"7856","Eliannah","F",11,14,25
"7857","Elianne","F",8,12,20
"7858","Elianni","F",5,6,11
"7859","Elianny","F",39,37,76
"7860","Eliany","F",29,23,52
"7861","Elianys","F",16,11,27
"7862","Elias","F",10,6,16
"7863","Elias","M",4088,4454,8542
"7864","Eliav","M",13,11,24
"7865","Eliaz","M",19,27,46
"7866","Eliazar","M",40,43,83
"7867","Eliceo","M",6,5,11
"7868","Elicia","F",35,31,66
"7869","Elida","F",35,39,74
"7870","Elidia","F",6,5,11
"7871","Elie","F",24,16,40
"7872","Elie","M",35,38,73
"7873","Eliel","M",121,126,247
"7874","Elienai","F",41,32,73
"7875","Elier","M",11,17,28
"7876","Eliette","F",28,38,66
"7877","Eliezer","M",198,203,401
"7878","Elif","F",53,69,122
"7879","Eligh","M",55,43,98
"7880","Eligio","M",8,14,22
"7881","Elih","M",9,9,18
"7882","Elihu","M",16,22,38
"7883","Elija","M",42,26,68
"7884","Elijaah","M",5,5,10
"7885","Elijah","F",27,27,54
"7886","Elijah","M",13593,13764,27357
"7887","Elijahjames","M",10,9,19
"7888","Elijha","M",8,11,19
"7889","Elijiah","M",27,25,52
"7890","Elika","F",18,15,33
"7891","Elilta","F",5,5,10
"7892","Elim","F",10,11,21
"7893","Elim","M",21,23,44
"7894","Elimelech","M",40,32,72
"7895","Elin","F",297,266,563
"7896","Elin","M",12,7,19
"7897","Elina","F",248,246,494
"7898","Eline","F",7,9,16
"7899","Elinor","F",165,170,335
"7900","Elinora","F",5,12,17
"7901","Elinore","F",15,10,25
"7902","Elio","M",63,53,116
"7903","Elion","M",8,8,16
"7904","Eliora","F",86,80,166
"7905","Eliot","F",26,28,54
"7906","Eliot","M",175,159,334
"7907","Eliott","M",75,69,144
"7908","Elis","F",9,13,22
"7909","Elis","M",15,14,29
"7910","Elisa","F",654,628,1282
"7911","Elisabella","F",10,7,17
"7912","Elisabet","F",23,17,40
"7913","Elisabeth","F",396,424,820
"7914","Elisabetta","F",13,12,25
"7915","Elisandra","F",10,7,17
"7916","Elisandro","M",6,8,14
"7917","Elise","F",1841,1905,3746
"7918","Elisea","F",7,7,14
"7919","Eliseo","M",236,263,499
"7920","Elisey","M",5,7,12
"7921","Elisha","F",120,122,242
"7922","Elisha","M",302,300,602
"7923","Elisheba","F",8,10,18
"7924","Elisheva","F",77,67,144
"7925","Elishua","M",6,5,11
"7926","Elisia","F",36,30,66
"7927","Elisiana","F",5,5,10
"7928","Elisio","M",6,6,12
"7929","Eliska","F",5,7,12
"7930","Elison","M",5,10,15
"7931","Elissa","F",167,166,333
"7932","Elisse","F",9,9,18
"7933","Eliu","M",8,7,15
"7934","Eliud","M",35,26,61
"7935","Elius","M",6,6,12
"7936","Elivia","F",32,22,54
"7937","Eliya","F",41,28,69
"7938","Eliya","M",9,6,15
"7939","Eliyah","F",72,56,128
"7940","Eliyah","M",32,27,59
"7941","Eliyahu","M",133,129,262
"7942","Eliyana","F",25,33,58
"7943","Eliyanah","F",23,39,62
"7944","Eliyanna","F",11,6,17
"7945","Eliyas","M",19,20,39
"7946","Eliz","F",8,11,19
"7947","Eliza","F",1828,1851,3679
"7948","Elizabella","F",62,42,104
"7949","Elizabelle","F",16,14,30
"7950","Elizabet","F",11,10,21
"7951","Elizabeth","F",9703,9493,19196
"7952","Elizabeth","M",5,12,17
"7953","Elizabethann","F",6,7,13
"7954","Elizabethrose","F",5,5,10
"7955","Elizah","F",35,36,71
"7956","Elizah","M",7,10,17
"7957","Elizandra","F",6,9,15
"7958","Elizandro","M",7,16,23
"7959","Elizar","M",6,6,12
"7960","Elizaveta","F",25,29,54
"7961","Elizbeth","F",10,5,15
"7962","Elize","F",24,40,64
"7963","Elizebeth","F",5,5,10
"7964","Elizeo","M",8,10,18
"7965","Eljay","M",7,5,12
"7966","Elka","F",21,20,41
"7967","Elke","F",9,9,18
"7968","Elkin","M",7,9,16
"7969","Elky","F",10,5,15
"7970","Ella","F",7882,7866,15748
"7971","Ellagrace","F",24,18,42
"7972","Ellah","F",60,42,102
"7973","Ellaina","F",27,30,57
"7974","Ellajane","F",9,11,20
"7975","Ellakate","F",6,9,15
"7976","Ellamae","F",41,53,94
"7977","Ellamarie","F",22,26,48
"7978","Ellamay","F",8,8,16
"7979","Ellana","F",22,13,35
"7980","Ellani","F",5,9,14
"7981","Ellanie","F",8,17,25
"7982","Ellanor","F",38,36,74
"7983","Ellanora","F",25,26,51
"7984","Ellanore","F",21,17,38
"7985","Ellany","F",6,6,12
"7986","Ellarae","F",11,21,32
"7987","Ellarie","F",11,19,30
"7988","Ellarose","F",37,61,98
"7989","Ellary","F",14,11,25
"7990","Ellasandra","F",6,11,17
"7991","Ellason","F",6,8,14
"7992","Ellasyn","F",26,33,59
"7993","Ellawyn","F",7,10,17
"7994","Ellayna","F",16,15,31
"7995","Elle","F",816,825,1641
"7996","Elleah","F",7,5,12
"7997","Elleana","F",15,19,34
"7998","Elleanna","F",23,14,37
"7999","Elleanor","F",30,39,69
"8000","Ellee","F",52,66,118
"8001","Elleigh","F",35,33,68
"8002","Ellen","F",402,446,848
"8003","Ellena","F",57,64,121
"8004","Ellenie","F",7,8,15
"8005","Ellenor","F",13,20,33
"8006","Ellenora","F",9,9,18
"8007","Ellenore","F",7,21,28
"8008","Ellerie","F",30,20,50
"8009","Ellery","F",255,193,448
"8010","Ellery","M",14,11,25
"8011","Elley","F",10,14,24
"8012","Elli","F",96,92,188
"8013","Elli","M",5,7,12
"8014","Ellia","F",87,96,183
"8015","Elliah","F",8,7,15
"8016","Elliahna","F",5,12,17
"8017","Elliana","F",1068,1257,2325
"8018","Ellianah","F",13,12,25
"8019","Ellianna","F",253,301,554
"8020","Elliannah","F",10,8,18
"8021","Ellianne","F",9,10,19
"8022","Ellias","M",12,18,30
"8023","Ellie","F",4855,5045,9900
"8024","Ellie","M",6,6,12
"8025","Ellieana","F",30,28,58
"8026","Ellieann","F",5,9,14
"8027","Ellieanna","F",34,34,68
"8028","Elliemae","F",33,22,55
"8029","Elliemay","F",8,10,18
"8030","Ellierose","F",5,10,15
"8031","Elliet","F",9,13,22
"8032","Elliett","F",13,7,20
"8033","Elliette","F",122,109,231
"8034","Ellijah","M",12,17,29
"8035","Ellina","F",7,18,25
"8036","Ellington","F",85,78,163
"8037","Ellington","M",26,45,71
"8038","Ellinor","F",27,31,58
"8039","Ellinore","F",9,9,18
"8040","Ellionna","F",10,10,20
"8041","Elliora","F",7,9,16
"8042","Elliot","F",448,473,921
"8043","Elliot","M",1906,2220,4126
"8044","Elliott","F",423,469,892
"8045","Elliott","M",1868,2085,3953
"8046","Elliotte","F",61,86,147
"8047","Ellis","F",281,334,615
"8048","Ellis","M",737,992,1729
"8049","Ellisa","F",5,14,19
"8050","Ellise","F",25,19,44
"8051","Ellisen","F",12,5,17
"8052","Ellison","F",285,297,582
"8053","Ellison","M",92,95,187
"8054","Ellisyn","F",53,57,110
"8055","Elliyah","F",12,11,23
"8056","Elliyanna","F",5,6,11
"8057","Ellody","F",5,9,14
"8058","Elloise","F",25,24,49
"8059","Ellora","F",52,46,98
"8060","Elloree","F",9,10,19
"8061","Ellorie","F",7,12,19
"8062","Ellory","F",26,38,64
"8063","Ellouise","F",21,11,32
"8064","Ellowyn","F",35,30,65
"8065","Ellsie","F",17,15,32
"8066","Elly","F",154,163,317
"8067","Ellyana","F",71,85,156
"8068","Ellyanah","F",6,5,11
"8069","Ellyanna","F",37,31,68
"8070","Ellyette","F",8,7,15
"8071","Ellyn","F",26,25,51
"8072","Ellyott","F",8,5,13
"8073","Ellys","F",6,5,11
"8074","Ellyse","F",23,20,43
"8075","Ellyson","F",24,27,51
"8076","Ellyssa","F",12,6,18
"8077","Elma","F",31,26,57
"8078","Elmer","M",149,163,312
"8079","Elmin","M",8,5,13
"8080","Elmina","F",8,10,18
"8081","Elmira","F",14,5,19
"8082","Elna","F",5,6,11
"8083","Elnatan","M",6,5,11
"8084","Elnathan","M",38,23,61
"8085","Elnora","F",19,19,38
"8086","Elodie","F",216,243,459
"8087","Elody","F",9,12,21
"8088","Elohim","M",13,5,18
"8089","Eloisa","F",58,69,127
"8090","Eloise","F",1261,1554,2815
"8091","Elon","F",6,7,13
"8092","Elon","M",91,137,228
"8093","Elona","F",16,20,36
"8094","Eloni","F",6,7,13
"8095","Elonna","F",14,7,21
"8096","Elora","F",283,372,655
"8097","Elorah","F",9,6,15
"8098","Elouise","F",116,108,224
"8099","Elowen","F",36,85,121
"8100","Elowyn","F",68,84,152
"8101","Eloy","M",49,43,92
"8102","Elric","M",25,19,44
"8103","Elroy","M",23,23,46
"8104","Elsa","F",656,476,1132
"8105","Elsbeth","F",8,9,17
"8106","Elsi","F",18,13,31
"8107","Elsie","F",846,974,1820
"8108","Elson","M",11,12,23
"8109","Elspeth","F",13,18,31
"8110","Elston","M",8,11,19
"8111","Elsy","F",43,32,75
"8112","Elton","M",62,57,119
"8113","Eluzer","M",14,12,26
"8114","Elva","F",44,53,97
"8115","Elvia","F",35,32,67
"8116","Elvie","F",7,16,23
"8117","Elvin","M",127,116,243
"8118","Elvina","F",6,9,15
"8119","Elvira","F",50,66,116
"8120","Elvis","M",180,187,367
"8121","Elwood","M",52,49,101
"8122","Elwyn","M",6,12,18
"8123","Ely","F",26,15,41
"8124","Ely","M",109,103,212
"8125","Elya","F",11,11,22
"8126","Elya","M",11,18,29
"8127","Elyan","M",11,15,26
"8128","Elyana","F",91,99,190
"8129","Elyanah","F",8,10,18
"8130","Elyanna","F",53,41,94
"8131","Elyas","M",57,75,132
"8132","Elyce","F",9,10,19
"8133","Elycia","F",8,7,15
"8134","Elye","M",9,6,15
"8135","Elyjah","M",73,65,138
"8136","Elyn","F",26,15,41
"8137","Elyna","F",9,10,19
"8138","Elynn","F",24,18,42
"8139","Elynor","F",6,8,14
"8140","Elyon","M",20,13,33
"8141","Elysa","F",19,27,46
"8142","Elyse","F",436,417,853
"8143","Elysia","F",100,81,181
"8144","Elyssa","F",104,113,217
"8145","Elysse","F",13,15,28
"8146","Elyssia","F",5,10,15
"8147","Elyza","F",67,64,131
"8148","Elyzabeth","F",23,11,34
"8149","Elyzah","F",6,7,13
"8150","Elza","F",15,15,30
"8151","Elzie","F",6,7,13
"8152","Ema","F",155,150,305
"8153","Emaan","F",76,61,137
"8154","Emad","M",18,19,37
"8155","Emalee","F",110,78,188
"8156","Emaleigh","F",31,48,79
"8157","Emalia","F",12,13,25
"8158","Emalie","F",18,25,43
"8159","Emalin","F",5,5,10
"8160","Emalina","F",14,7,21
"8161","Emaline","F",65,71,136
"8162","Emalyn","F",176,148,324
"8163","Emalynn","F",83,63,146
"8164","Eman","F",59,53,112
"8165","Eman","M",6,10,16
"8166","Emani","F",211,190,401
"8167","Emani","M",9,13,22
"8168","Emanie","F",5,6,11
"8169","Emanii","F",5,5,10
"8170","Emanual","M",7,5,12
"8171","Emanuel","F",5,6,11
"8172","Emanuel","M",976,908,1884
"8173","Emanuela","F",22,13,35
"8174","Emanuele","M",6,5,11
"8175","Emanuella","F",8,8,16
"8176","Emanuelle","F",6,5,11
"8177","Emanuelly","F",9,6,15
"8178","Emaree","F",15,10,25
"8179","Emari","F",43,45,88
"8180","Emari","M",43,42,85
"8181","Emarie","F",80,78,158
"8182","Emarion","M",13,12,25
"8183","Emarosa","F",8,12,20
"8184","Emary","F",13,11,24
"8185","Emaya","F",11,10,21
"8186","Ember","F",895,1009,1904
"8187","Ember","M",17,21,38
"8188","Emberlee","F",63,95,158
"8189","Emberleigh","F",29,44,73
"8190","Emberley","F",9,21,30
"8191","Emberli","F",6,12,18
"8192","Emberlie","F",5,8,13
"8193","Emberlin","F",11,7,18
"8194","Emberly","F",118,194,312
"8195","Emberlyn","F",106,111,217
"8196","Emberlynn","F",106,127,233
"8197","Embree","F",33,35,68
"8198","Embri","F",6,7,13
"8199","Embrie","F",19,13,32
"8200","Embry","F",52,56,108
"8201","Embry","M",15,16,31
"8202","Embyr","F",8,5,13
"8203","Emeka","M",11,10,21
"8204","Emeli","F",24,26,50
"8205","Emelia","F",504,527,1031
"8206","Emelie","F",39,59,98
"8207","Emelin","F",20,14,34
"8208","Emelina","F",32,31,63
"8209","Emeline","F",85,104,189
"8210","Emelly","F",8,9,17
"8211","Emely","F",731,649,1380
"8212","Emelyn","F",107,96,203
"8213","Emelynn","F",13,15,28
"8214","Emera","F",6,5,11
"8215","Emerald","F",194,219,413
"8216","Emerald","M",6,13,19
"8217","Emeree","F",18,17,35
"8218","Emeri","F",148,136,284
"8219","Emeric","M",27,23,50
"8220","Emerich","M",5,6,11
"8221","Emerick","M",32,38,70
"8222","Emerie","F",355,386,741
"8223","Emerii","F",6,5,11
"8224","Emerlee","F",9,8,17
"8225","Emerleigh","F",5,6,11
"8226","Emerly","F",6,17,23
"8227","Emerlyn","F",11,19,30
"8228","Emerlynn","F",7,5,12
"8229","Emersen","F",37,43,80
"8230","Emerson","F",1789,1947,3736
"8231","Emerson","M",1198,1216,2414
"8232","Emersyn","F",827,1068,1895
"8233","Emersyn","M",15,12,27
"8234","Emersynn","F",21,21,42
"8235","Emery","F",2415,2410,4825
"8236","Emery","M",323,337,660
"8237","Emet","M",23,20,43
"8238","Emeterio","M",7,6,13
"8239","Emett","M",25,15,40
"8240","Emi","F",167,173,340
"8241","Emiah","F",10,13,23
"8242","Emie","F",14,10,24
"8243","Emigdio","M",7,5,12
"8244","Emiko","F",42,34,76
"8245","Emil","M",127,124,251
"8246","Emila","F",9,7,16
"8247","Emile","M",55,59,114
"8248","Emilea","F",10,15,25
"8249","Emileah","F",7,9,16
"8250","Emilee","F",515,407,922
"8251","Emileigh","F",39,42,81
"8252","Emilene","F",5,6,11
"8253","Emileo","M",6,5,11
"8254","Emiley","F",29,19,48
"8255","Emili","F",32,18,50
"8256","Emilia","F",2215,3019,5234
"8257","Emilian","M",13,6,19
"8258","Emiliana","F",174,163,337
"8259","Emilianna","F",14,15,29
"8260","Emiliano","M",1666,1693,3359
"8261","Emilie","F",321,314,635
"8262","Emilija","F",11,13,24
"8263","Emiline","F",17,11,28
"8264","Emilio","M",1186,1334,2520
"8265","Emiliya","F",11,12,23
"8266","Emillia","F",20,20,40
"8267","Emilliano","M",15,16,31
"8268","Emillie","F",12,15,27
"8269","Emillio","M",11,10,21
"8270","Emilly","F",37,23,60
"8271","Emily","F",11766,10926,22692
"8272","Emily","M",17,7,24
"8273","Emilya","F",12,10,22
"8274","Emilyann","F",8,8,16
"8275","Emilygrace","F",5,6,11
"8276","Emilyn","F",70,73,143
"8277","Emilynn","F",41,50,91
"8278","Emilyrose","F",10,13,23
"8279","Emin","M",26,33,59
"8280","Emina","F",27,30,57
"8281","Emir","M",146,117,263
"8282","Emira","F",12,8,20
"8283","Emireth","F",18,12,30
"8284","Emit","M",8,8,16
"8285","Emitt","M",29,22,51
"8286","Emiya","F",11,20,31
"8287","Emiyah","F",29,43,72
"8288","Emma","F",20415,19414,39829
"8289","Emma","M",10,18,28
"8290","Emmaclaire","F",6,6,12
"8291","Emmagrace","F",42,34,76
"8292","Emmah","F",57,34,91
"8293","Emmajane","F",10,8,18
"8294","Emmajean","F",19,19,38
"8295","Emmajo","F",10,7,17
"8296","Emmakate","F",16,12,28
"8297","Emmalea","F",6,15,21
"8298","Emmaleah","F",7,8,15
"8299","Emmalee","F",277,255,532
"8300","Emmaleigh","F",96,89,185
"8301","Emmalena","F",9,6,15
"8302","Emmalene","F",21,10,31
"8303","Emmalia","F",24,16,40
"8304","Emmalie","F",22,21,43
"8305","Emmalin","F",64,46,110
"8306","Emmalina","F",30,41,71
"8307","Emmaline","F",303,309,612
"8308","Emmalise","F",8,19,27
"8309","Emmalou","F",14,10,24
"8310","Emmaly","F",18,14,32
"8311","Emmalyn","F",689,585,1274
"8312","Emmalyne","F",18,14,32
"8313","Emmalynn","F",406,330,736
"8314","Emmalynne","F",23,21,44
"8315","Emmamae","F",15,11,26
"8316","Emmamarie","F",16,16,32
"8317","Emmani","F",5,9,14
"8318","Emmanual","M",5,9,14
"8319","Emmanuel","F",6,7,13
"8320","Emmanuel","M",2732,2560,5292
"8321","Emmanuela","F",31,24,55
"8322","Emmanuella","F",66,66,132
"8323","Emmanuelle","F",54,52,106
"8324","Emmarae","F",9,22,31
"8325","Emmaree","F",7,9,16
"8326","Emmarie","F",118,146,264
"8327","Emmarose","F",75,46,121
"8328","Emmary","F",22,7,29
"8329","Emmaus","M",12,17,29
"8330","Emme","F",159,124,283
"8331","Emmelia","F",28,35,63
"8332","Emmelina","F",7,5,12
"8333","Emmeline","F",346,358,704
"8334","Emmely","F",16,15,31
"8335","Emmelyn","F",49,40,89
"8336","Emmerich","M",16,24,40
"8337","Emmerick","M",7,6,13
"8338","Emmerie","F",19,13,32
"8339","Emmersen","F",9,17,26
"8340","Emmerson","F",154,128,282
"8341","Emmerson","M",30,29,59
"8342","Emmersyn","F",71,86,157
"8343","Emmery","F",67,53,120
"8344","Emmeryn","F",5,6,11
"8345","Emmet","M",261,242,503
"8346","Emmett","F",13,16,29
"8347","Emmett","M",3032,3033,6065
"8348","Emmette","M",7,7,14
"8349","Emmi","F",81,112,193
"8350","Emmie","F",245,303,548
"8351","Emmilia","F",9,8,17
"8352","Emmilou","F",5,6,11
"8353","Emmily","F",22,14,36
"8354","Emmilyn","F",25,26,51
"8355","Emmilynn","F",8,6,14
"8356","Emmit","M",121,121,242
"8357","Emmitt","M",476,558,1034
"8358","Emmory","F",15,10,25
"8359","Emmry","F",9,10,19
"8360","Emmy","F",466,476,942
"8361","Emmylou","F",68,73,141
"8362","Emnet","F",5,15,20
"8363","Emon","M",13,15,28
"8364","Emoni","F",122,115,237
"8365","Emoni","M",8,7,15
"8366","Emonie","F",30,22,52
"8367","Emonii","F",8,9,17
"8368","Emonni","F",6,6,12
"8369","Emoree","F",24,15,39
"8370","Emori","F",59,58,117
"8371","Emori","M",9,5,14
"8372","Emorie","F",60,61,121
"8373","Emory","F",454,447,901
"8374","Emory","M",270,268,538
"8375","Emperor","M",10,5,15
"8376","Empress","F",66,95,161
"8377","Emrah","M",5,5,10
"8378","Emran","M",30,31,61
"8379","Emre","M",30,37,67
"8380","Emree","F",64,50,114
"8381","Emrey","F",22,13,35
"8382","Emri","F",35,29,64
"8383","Emrick","M",17,15,32
"8384","Emrie","F",89,123,212
"8385","Emrik","M",11,7,18
"8386","Emry","F",135,131,266
"8387","Emry","M",36,49,85
"8388","Emrys","F",21,19,40
"8389","Emrys","M",53,66,119
"8390","Emsley","F",69,54,123
"8391","Emuna","F",5,9,14
"8392","Emunah","F",15,16,31
"8393","Emy","F",37,45,82
"8394","Emya","F",20,13,33
"8395","Emyah","F",7,9,16
"8396","Emyiah","F",7,7,14
"8397","Emylee","F",19,11,30
"8398","Emylia","F",13,15,28
"8399","Emyr","M",5,6,11
"8400","Emyrson","F",5,5,10
"8401","Ena","F",49,40,89
"8402","Enas","F",7,5,12
"8403","Enaya","F",18,17,35
"8404","Ender","M",98,129,227
"8405","Endia","F",17,18,35
"8406","Endrit","M",8,5,13
"8407","Endy","M",9,6,15
"8408","Enedina","F",6,11,17
"8409","Enes","M",7,10,17
"8410","Enessa","F",5,6,11
"8411","England","F",19,19,38
"8412","England","M",5,5,10
"8413","Enid","F",20,15,35
"8414","Eniola","F",13,16,29
"8415","Enisa","F",5,5,10
"8416","Eniya","F",14,11,25
"8417","Eniyah","F",31,25,56
"8418","Enki","M",5,7,12
"8419","Enma","F",7,6,13
"8420","Enmanuel","M",31,25,56
"8421","Enna","F",22,24,46
"8422","Ennio","M",11,7,18
"8423","Ennis","M",7,12,19
"8424","Eno","M",6,7,13
"8425","Enoc","M",45,27,72
"8426","Enoch","M",296,340,636
"8427","Enola","F",10,14,24
"8428","Enora","F",7,9,16
"8429","Enos","M",32,37,69
"8430","Enrico","M",20,27,47
"8431","Enrique","M",711,693,1404
"8432","Enslee","F",10,8,18
"8433","Ensley","F",71,76,147
"8434","Enslie","F",12,9,21
"8435","Envy","F",34,35,69
"8436","Enya","F",37,37,74
"8437","Enyla","F",8,9,17
"8438","Enza","F",6,10,16
"8439","Enzi","M",7,6,13
"8440","Enzio","M",14,9,23
"8441","Enzlee","F",7,5,12
"8442","Enzley","F",5,5,10
"8443","Enzo","M",1042,1138,2180
"8444","Eoghan","M",29,22,51
"8445","Eoin","M",57,55,112
"8446","Eon","M",8,11,19
"8447","Eowyn","F",69,78,147
"8448","Ephraim","M",229,244,473
"8449","Ephram","M",13,13,26
"8450","Ephrata","F",7,8,15
"8451","Ephrem","M",10,14,24
"8452","Epic","M",8,16,24
"8453","Epiphany","F",16,13,29
"8454","Eponine","F",6,6,12
"8455","Era","F",26,34,60
"8456","Erabella","F",23,20,43
"8457","Eralynn","F",10,12,22
"8458","Erandi","F",10,11,21
"8459","Erandy","F",8,14,22
"8460","Erasmo","M",22,25,47
"8461","Erdem","M",11,14,25
"8462","Eren","M",57,53,110
"8463","Erendira","F",6,7,13
"8464","Erez","M",10,8,18
"8465","Erfan","M",5,5,10
"8466","Eri","F",11,5,16
"8467","Eriah","F",9,5,14
"8468","Erial","F",12,8,20
"8469","Erian","F",14,12,26
"8470","Erian","M",13,16,29
"8471","Eriana","F",40,52,92
"8472","Eriane","F",14,11,25
"8473","Erianna","F",39,44,83
"8474","Eriberto","M",18,8,26
"8475","Eric","F",5,5,10
"8476","Eric","M",3035,2909,5944
"8477","Erica","F",416,346,762
"8478","Erich","M",27,29,56
"8479","Erick","M",1367,1597,2964
"8480","Ericka","F",77,77,154
"8481","Erickson","M",28,39,67
"8482","Ericson","M",20,20,40
"8483","Erie","F",6,8,14
"8484","Eriel","F",36,29,65
"8485","Erielle","F",25,40,65
"8486","Erik","M",1013,937,1950
"8487","Erika","F",388,381,769
"8488","Erikson","M",11,18,29
"8489","Erilyn","F",5,7,12
"8490","Erilynn","F",5,6,11
"8491","Erin","F",969,920,1889
"8492","Erin","M",59,41,100
"8493","Erina","F",21,32,53
"8494","Erinn","F",15,13,28
"8495","Erioluwa","F",5,8,13
"8496","Erioluwa","M",7,6,13
"8497","Erion","M",24,24,48
"8498","Eriona","F",8,6,14
"8499","Erionna","F",16,15,31
"8500","Eris","F",67,78,145
"8501","Eris","M",13,12,25
"8502","Eriyah","F",9,10,19
"8503","Eriyana","F",7,8,15
"8504","Eriyanna","F",11,11,22
"8505","Eriyonna","F",7,5,12
"8506","Erlin","M",14,8,22
"8507","Erma","F",25,12,37
"8508","Ermias","M",9,9,18
"8509","Ernest","M",216,208,424
"8510","Ernestina","F",6,10,16
"8511","Ernestine","F",5,12,17
"8512","Ernesto","M",410,359,769
"8513","Ernie","M",23,28,51
"8514","Ernst","M",6,6,12
"8515","Ero","M",5,5,10
"8516","Erol","M",6,9,15
"8517","Eron","M",20,18,38
"8518","Eros","M",66,64,130
"8519","Errol","M",28,25,53
"8520","Erron","M",11,10,21
"8521","Erva","F",5,8,13
"8522","Ervin","M",94,86,180
"8523","Erwin","M",47,53,100
"8524","Eryk","M",21,17,38
"8525","Eryka","F",8,5,13
"8526","Erykah","F",17,22,39
"8527","Eryn","F",123,114,237
"8528","Erynn","F",41,34,75
"8529","Eryx","M",8,5,13
"8530","Erza","F",20,25,45
"8531","Erza","M",5,9,14
"8532","Esa","M",21,37,58
"8533","Esabella","F",37,33,70
"8534","Esai","M",63,48,111
"8535","Esaiah","M",6,8,14
"8536","Esaias","M",35,30,65
"8537","Esau","M",39,48,87
"8538","Esbeidy","F",10,6,16
"8539","Esben","M",5,7,12
"8540","Esbeydi","F",6,7,13
"8541","Escher","M",23,27,50
"8542","Esdras","M",52,60,112
"8543","Esequiel","M",15,15,30
"8544","Esha","F",55,45,100
"8545","Eshaal","F",43,56,99
"8546","Eshaan","M",54,55,109
"8547","Eshal","F",24,27,51
"8548","Eshan","M",67,51,118
"8549","Eshani","F",8,9,17
"8550","Eshawn","M",5,8,13
"8551","Eshwar","M",6,5,11
"8552","Esiah","M",11,21,32
"8553","Esias","M",5,8,13
"8554","Esli","F",14,5,19
"8555","Esly","F",8,6,14
"8556","Esma","F",32,35,67
"8557","Esmae","F",59,81,140
"8558","Esmarie","F",6,6,12
"8559","Esmay","F",18,20,38
"8560","Esme","F",418,426,844
"8561","Esmee","F",59,62,121
"8562","Esmeralda","F",880,864,1744
"8563","Esmerelda","F",23,24,47
"8564","Esmond","M",14,9,23
"8565","Esneider","M",9,6,15
"8566","Espen","F",9,17,26
"8567","Espen","M",37,31,68
"8568","Esperanza","F",296,264,560
"8569","Espn","F",9,8,17
"8570","Espn","M",8,8,16
"8571","Espyn","F",19,12,31
"8572","Esra","F",14,24,38
"8573","Esraa","F",12,13,25
"8574","Essa","M",33,35,68
"8575","Essam","M",13,6,19
"8576","Essence","F",157,135,292
"8577","Essex","M",6,6,12
"8578","Essiah","M",8,9,17
"8579","Essie","F",32,38,70
"8580","Estaban","M",8,5,13
"8581","Esteban","M",774,759,1533
"8582","Estee","F",11,16,27
"8583","Estefani","F",61,52,113
"8584","Estefania","F",195,123,318
"8585","Estefanny","F",12,5,17
"8586","Estefany","F",143,141,284
"8587","Estela","F",96,73,169
"8588","Estella","F",316,302,618
"8589","Estelle","F",341,339,680
"8590","Esten","M",6,11,17
"8591","Estephania","F",16,10,26
"8592","Estephanie","F",15,16,31
"8593","Estephany","F",7,7,14
"8594","Ester","F",111,111,222
"8595","Estevan","M",106,89,195
"8596","Esteven","M",5,7,12
"8597","Esthela","F",8,8,16
"8598","Esther","F",1614,1789,3403
"8599","Esti","F",11,7,18
"8600","Estiben","M",6,7,13
"8601","Estiven","M",7,6,13
"8602","Eston","M",29,13,42
"8603","Estrella","F",353,349,702
"8604","Estrellita","F",15,16,31
"8605","Estuardo","M",20,9,29
"8606","Esty","F",39,42,81
"8607","Esvin","M",18,11,29
"8608","Etai","M",9,5,14
"8609","Eternity","F",84,79,163
"8610","Ethan","F",18,14,32
"8611","Ethan","M",15049,13758,28807
"8612","Ethanael","M",7,5,12
"8613","Ethaniel","M",36,44,80
"8614","Ethanjames","M",7,11,18
"8615","Ethel","F",12,25,37
"8616","Ethen","M",93,89,182
"8617","Ethyn","M",47,51,98
"8618","Etienne","M",18,32,50
"8619","Etta","F",242,256,498
"8620","Ettel","F",9,5,14
"8621","Etty","F",30,23,53
"8622","Euan","M",21,22,43
"8623","Eudora","F",7,9,16
"8624","Eugene","M",272,298,570
"8625","Eugenia","F",36,40,76
"8626","Eugenie","F",12,7,19
"8627","Eugenio","M",32,44,76
"8628","Eula","F",6,6,12
"8629","Eulalia","F",40,41,81
"8630","Eunice","F",145,150,295
"8631","Eunique","F",9,7,16
"8632","Euphemia","F",9,5,14
"8633","Euriah","M",7,6,13
"8634","Eusebio","M",15,13,28
"8635","Eustace","M",8,8,16
"8636","Eva","F",3756,3777,7533
"8637","Eva","M",7,5,12
"8638","Evaan","M",18,28,46
"8639","Evah","F",29,23,52
"8640","Evalee","F",37,43,80
"8641","Evaleen","F",6,9,15
"8642","Evaleena","F",5,7,12
"8643","Evaleigh","F",17,16,33
"8644","Evalena","F",15,17,32
"8645","Evalene","F",9,8,17
"8646","Evalette","F",5,12,17
"8647","Evalie","F",8,10,18
"8648","Evalin","F",7,7,14
"8649","Evalina","F",74,97,171
"8650","Evaline","F",24,25,49
"8651","Evalise","F",7,10,17
"8652","Evaluna","F",23,25,48
"8653","Evalyn","F",320,318,638
"8654","Evalyna","F",11,5,16
"8655","Evalynn","F",247,229,476
"8656","Evalynne","F",28,19,47
"8657","Evalyse","F",7,6,13
"8658","Evamaria","F",10,6,16
"8659","Evamarie","F",34,38,72
"8660","Evan","F",97,86,183
"8661","Evan","M",5896,5576,11472
"8662","Evana","F",31,37,68
"8663","Evander","M",99,116,215
"8664","Evanee","F",11,19,30
"8665","Evangaline","F",10,5,15
"8666","Evangelene","F",13,13,26
"8667","Evangelia","F",20,24,44
"8668","Evangelina","F",155,170,325
"8669","Evangeline","F",1219,1324,2543
"8670","Evangelos","M",23,21,44
"8671","Evangelyn","F",17,13,30
"8672","Evangelyne","F",8,13,21
"8673","Evangelynn","F",9,10,19
"8674","Evani","F",9,17,26
"8675","Evania","F",7,9,16
"8676","Evanie","F",10,17,27
"8677","Evann","F",6,5,11
"8678","Evann","M",9,8,17
"8679","Evanna","F",37,46,83
"8680","Evanny","F",5,8,13
"8681","Evans","F",6,7,13
"8682","Evans","M",38,55,93
"8683","Evany","F",24,24,48
"8684","Evaristo","M",7,10,17
"8685","Evarose","F",9,9,18
"8686","Eve","F",677,698,1375
"8687","Eveah","F",5,6,11
"8688","Evee","F",28,42,70
"8689","Eveleen","F",12,10,22
"8690","Evelette","F",17,9,26
"8691","Evelia","F",15,24,39
"8692","Evelin","F",92,97,189
"8693","Evelina","F",175,202,377
"8694","Eveline","F",30,52,82
"8695","Evelio","M",9,9,18
"8696","Evely","F",5,10,15
"8697","Evelyn","F",9352,10060,19412
"8698","Evelyn","M",17,8,25
"8699","Evelyna","F",10,7,17
"8700","Evelyne","F",26,32,58
"8701","Evelynn","F",718,843,1561
"8702","Evelynne","F",61,51,112
"8703","Evelynrose","F",5,9,14
"8704","Even","M",13,17,30
"8705","Eveny","F",6,8,14
"8706","Ever","F",110,84,194
"8707","Ever","M",146,133,279
"8708","Everardo","M",70,87,157
"8709","Everest","F",29,47,76
"8710","Everest","M",111,143,254
"8711","Everet","M",12,9,21
"8712","Everett","F",45,49,94
"8713","Everett","M",3044,3495,6539
"8714","Everette","F",25,24,49
"8715","Everette","M",64,71,135
"8716","Everhett","M",35,29,64
"8717","Everitt","M",14,22,36
"8718","Everlea","F",13,7,20
"8719","Everlee","F",240,257,497
"8720","Everlei","F",5,7,12
"8721","Everleigh","F",474,538,1012
"8722","Everley","F",132,136,268
"8723","Everli","F",16,12,28
"8724","Everlie","F",54,55,109
"8725","Everly","F",2324,2873,5197
"8726","Everlyn","F",33,30,63
"8727","Everlynn","F",20,19,39
"8728","Everrett","M",7,6,13
"8729","Everson","M",19,42,61
"8730","Evert","M",11,14,25
"8731","Everton","M",12,12,24
"8732","Evette","F",48,39,87
"8733","Evey","F",54,55,109
"8734","Evgenia","F",5,5,10
"8735","Evi","F",19,19,38
"8736","Evia","F",18,14,32
"8737","Evian","F",9,7,16
"8738","Eviana","F",63,49,112
"8739","Evianna","F",44,36,80
"8740","Evie","F",611,784,1395
"8741","Evienne","F",6,5,11
"8742","Evin","F",5,8,13
"8743","Evin","M",75,64,139
"8744","Evita","F",19,15,34
"8745","Evlyn","F",16,9,25
"8746","Evlynn","F",8,10,18
"8747","Evolet","F",80,75,155
"8748","Evoleth","F",5,10,15
"8749","Evolett","F",11,10,21
"8750","Evolette","F",20,9,29
"8751","Evon","F",5,5,10
"8752","Evonna","F",13,8,21
"8753","Evonne","F",8,19,27
"8754","Evony","F",17,14,31
"8755","Evren","M",30,42,72
"8756","Evrett","M",18,7,25
"8757","Evva","F",8,7,15
"8758","Evvie","F",5,15,20
"8759","Evvy","F",5,6,11
"8760","Evy","F",61,44,105
"8761","Evyenia","F",7,5,12
"8762","Evyn","F",39,45,84
"8763","Evyn","M",13,13,26
"8764","Evynn","F",21,20,41
"8765","Evynne","F",5,6,11
"8766","Ewa","F",9,10,19
"8767","Ewan","M",139,134,273
"8768","Ewen","M",5,8,13
"8769","Exander","M",10,6,16
"8770","Exavier","M",42,28,70
"8771","Excel","F",7,5,12
"8772","Exodus","F",5,7,12
"8773","Exodus","M",25,24,49
"8774","Exton","M",9,9,18
"8775","Exzavier","M",10,10,20
"8776","Eyad","M",66,96,162
"8777","Eyal","M",13,17,30
"8778","Eyan","M",44,47,91
"8779","Eyana","F",7,9,16
"8780","Eyanna","F",7,5,12
"8781","Eyas","M",5,6,11
"8782","Eyasu","M",5,5,10
"8783","Eydan","M",13,23,36
"8784","Eyden","M",33,35,68
"8785","Eyla","F",16,19,35
"8786","Eylan","M",5,6,11
"8787","Eyleen","F",15,16,31
"8788","Eylin","F",13,12,25
"8789","Eymen","M",12,12,24
"8790","Eymi","F",19,14,33
"8791","Eyob","M",11,11,22
"8792","Eyoel","M",18,16,34
"8793","Eyra","F",5,8,13
"8794","Eytan","M",11,12,23
"8795","Eythan","M",22,25,47
"8796","Eyuel","M",6,5,11
"8797","Eyva","F",8,7,15
"8798","Ezabella","F",27,16,43
"8799","Ezaiah","M",5,5,10
"8800","Ezana","M",35,32,67
"8801","Ezariah","M",15,21,36
"8802","Ezekiah","M",6,10,16
"8803","Ezekial","M",36,34,70
"8804","Ezekiel","M",2777,3341,6118
"8805","Ezel","M",6,9,15
"8806","Ezequias","M",9,16,25
"8807","Ezequiel","M",487,563,1050
"8808","Ezeriah","M",11,12,23
"8809","Eziah","M",19,32,51
"8810","Eziel","M",5,7,12
"8811","Ezinne","F",5,6,11
"8812","Ezio","M",81,84,165
"8813","Ezmae","F",21,29,50
"8814","Ezmay","F",7,5,12
"8815","Ezme","F",11,9,20
"8816","Ezmeralda","F",18,25,43
"8817","Ezmerelda","F",11,6,17
"8818","Ezra","F",208,197,405
"8819","Ezra","M",4318,4830,9148
"8820","Ezrael","M",18,31,49
"8821","Ezrah","F",31,36,67
"8822","Ezrah","M",96,125,221
"8823","Ezreal","M",11,16,27
"8824","Ezri","F",55,49,104
"8825","Ezri","M",5,14,19
"8826","Ezrie","F",5,9,14
"8827","Ezriel","M",41,30,71
"8828","Faaiz","M",5,7,12
"8829","Fabian","M",936,865,1801
"8830","Fabiana","F",59,50,109
"8831","Fabianna","F",8,7,15
"8832","Fabien","M",10,8,18
"8833","Fabiha","F",5,5,10
"8834","Fabio","M",48,58,106
"8835","Fabiola","F",100,90,190
"8836","Fable","F",16,13,29
"8837","Fabrice","M",12,7,19
"8838","Fabricio","M",31,34,65
"8839","Fabrizio","M",43,36,79
"8840","Fadel","M",13,9,22
"8841","Fadi","M",15,10,25
"8842","Fadil","M",7,7,14
"8843","Faduma","F",7,17,24
"8844","Fadumo","F",12,11,23
"8845","Fady","M",11,5,16
"8846","Fae","F",22,29,51
"8847","Faelyn","F",16,19,35
"8848","Faelynn","F",12,12,24
"8849","Fahad","M",68,53,121
"8850","Fahd","M",13,19,32
"8851","Fahed","M",7,10,17
"8852","Faheem","M",15,13,28
"8853","Fahim","M",7,8,15
"8854","Fahima","F",9,7,16
"8855","Faiga","F",50,56,106
"8856","Faigy","F",109,125,234
"8857","Fairy","F",5,10,15
"8858","Faisal","M",66,60,126
"8859","Faith","F",3305,3035,6340
"8860","Faith","M",8,5,13
"8861","Faithe","F",13,7,20
"8862","Faithful","F",10,7,17
"8863","Faithlyn","F",24,21,45
"8864","Faithlynn","F",29,32,61
"8865","Faiz","M",15,9,24
"8866","Faiza","F",28,34,62
"8867","Faizah","F",7,11,18
"8868","Faizan","M",24,19,43
"8869","Fajr","F",13,27,40
"8870","Falcon","M",20,21,41
"8871","Fallon","F",226,241,467
"8872","Fallon","M",36,37,73
"8873","Fallou","M",5,11,16
"8874","Fallyn","F",84,70,154
"8875","Fallynn","F",6,7,13
"8876","Falon","F",35,20,55
"8877","Falon","M",5,5,10
"8878","Falyn","F",32,33,65
"8879","Falynn","F",31,32,63
"8880","Fancy","F",12,8,20
"8881","Fannie","F",50,42,92
"8882","Fanny","F",50,28,78
"8883","Fanta","F",25,36,61
"8884","Fanuel","M",7,11,18
"8885","Fany","F",7,5,12
"8886","Faolan","M",8,8,16
"8887","Fara","F",8,8,16
"8888","Farah","F",172,156,328
"8889","Faraz","M",9,7,16
"8890","Fardin","M",5,5,10
"8891","Fardosa","F",6,5,11
"8892","Fardowsa","F",12,9,21
"8893","Fareed","M",31,17,48
"8894","Fareedah","F",12,13,25
"8895","Fares","M",42,40,82
"8896","Farhan","M",52,58,110
"8897","Farhiya","F",9,14,23
"8898","Faria","F",6,5,11
"8899","Farid","M",22,35,57
"8900","Farida","F",54,52,106
"8901","Fariha","F",15,12,27
"8902","Faris","M",117,91,208
"8903","Fariza","F",7,9,16
"8904","Faron","M",13,9,22
"8905","Farouk","M",14,12,26
"8906","Farrah","F",360,278,638
"8907","Farrell","M",11,10,21
"8908","Farren","F",14,23,37
"8909","Farris","F",5,6,11
"8910","Farris","M",11,14,25
"8911","Farryn","F",17,18,35
"8912","Faruq","M",6,6,12
"8913","Faryn","F",12,16,28
"8914","Farzad","M",8,6,14
"8915","Farzona","F",8,11,19
"8916","Fate","F",5,7,12
"8917","Fateh","M",26,49,75
"8918","Fatema","F",26,21,47
"8919","Fathima","F",16,9,25
"8920","Fatih","M",6,5,11
"8921","Fatiha","F",13,12,25
"8922","Fatima","F",1042,1059,2101
"8923","Fatimah","F",107,116,223
"8924","Fatimata","F",20,20,40
"8925","Fatimatou","F",7,6,13
"8926","Fatimazahra","F",6,12,18
"8927","Fatma","F",23,31,54
"8928","Fatmata","F",9,7,16
"8929","Fatou","F",39,46,85
"8930","Fatoumata","F",73,94,167
"8931","Fatuma","F",25,34,59
"8932","Fauna","F",6,7,13
"8933","Faustin","M",6,6,12
"8934","Faustina","F",26,24,50
"8935","Faustino","M",18,20,38
"8936","Fausto","M",37,38,75
"8937","Favian","M",47,49,96
"8938","Favio","M",10,7,17
"8939","Faviola","F",7,13,20
"8940","Favor","F",27,22,49
"8941","Favour","F",30,36,66
"8942","Fawaz","M",10,17,27
"8943","Fawkes","M",6,8,14
"8944","Fawn","F",20,20,40
"8945","Fay","F",25,45,70
"8946","Faye","F",292,345,637
"8947","Fayelynn","F",8,11,19
"8948","Fayez","M",6,7,13
"8949","Faylinn","F",6,6,12
"8950","Fayrouz","F",5,5,10
"8951","Fayth","F",47,62,109
"8952","Faythe","F",16,8,24
"8953","Feather","F",15,7,22
"8954","Febe","F",20,13,33
"8955","Federica","F",5,11,16
"8956","Federico","M",62,66,128
"8957","Fedor","M",15,11,26
"8958","Fedora","F",6,5,11
"8959","Feiga","F",8,5,13
"8960","Felicia","F",76,49,125
"8961","Feliciano","M",16,15,31
"8962","Felicitas","F",6,6,12
"8963","Felicity","F",906,917,1823
"8964","Feliks","M",6,7,13
"8965","Felipe","M",291,305,596
"8966","Felisha","F",5,8,13
"8967","Felix","F",17,8,25
"8968","Felix","M",1374,1502,2876
"8969","Felton","M",8,7,15
"8970","Fender","M",5,6,11
"8971","Fenix","F",7,11,18
"8972","Fenix","M",44,49,93
"8973","Fenna","F",13,10,23
"8974","Fennec","M",5,5,10
"8975","Fenris","M",14,8,22
"8976","Fenton","M",38,32,70
"8977","Feras","M",12,12,24
"8978","Ferdinand","M",20,35,55
"8979","Fergus","M",21,19,40
"8980","Fermin","M",41,38,79
"8981","Fern","F",86,86,172
"8982","Fernanda","F",551,684,1235
"8983","Fernando","M",1346,1241,2587
"8984","Ferris","F",9,9,18
"8985","Ferris","M",45,47,92
"8986","Feven","F",8,13,21
"8987","Feynman","M",20,6,26
"8988","Feyza","F",6,7,13
"8989","Fia","F",26,21,47
"8990","Fianna","F",24,19,43
"8991","Fidel","M",96,92,188
"8992","Fidencio","M",6,7,13
"8993","Field","M",7,8,15
"8994","Fielder","M",6,8,14
"8995","Fielding","M",9,13,22
"8996","Fields","M",9,11,20
"8997","Filiberto","M",11,15,26
"8998","Filip","M",75,93,168
"8999","Filipe","M",5,7,12
"9000","Filippo","M",12,16,28
"9001","Filomena","F",22,26,48
"9002","Fin","M",21,17,38
"9003","Fina","F",5,5,10
"9004","Finch","M",14,8,22
"9005","Findlay","F",6,9,15
"9006","Findlay","M",22,25,47
"9007","Findley","F",9,10,19
"9008","Findley","M",29,26,55
"9009","Finian","M",18,25,43
"9010","Finlay","F",10,18,28
"9011","Finlay","M",64,55,119
"9012","Finlee","F",68,77,145
"9013","Finlee","M",12,17,29
"9014","Finleigh","F",110,84,194
"9015","Finley","F",1601,1719,3320
"9016","Finley","M",1057,1242,2299
"9017","Finn","F",26,28,54
"9018","Finn","M",1895,2277,4172
"9019","Finneas","M",23,39,62
"9020","Finnegan","M",763,813,1576
"9021","Finneus","M",7,14,21
"9022","Finnian","M",166,186,352
"9023","Finnick","M",56,149,205
"9024","Finnigan","M",75,103,178
"9025","Finnlee","F",11,10,21
"9026","Finnlee","M",14,23,37
"9027","Finnleigh","F",23,24,47
"9028","Finnley","F",173,184,357
"9029","Finnley","M",323,419,742
"9030","Finnly","M",11,11,22
"9031","Fintan","M",22,26,48
"9032","Fiona","F",1492,1547,3039
"9033","Fionn","M",31,29,60
"9034","Fionna","F",19,20,39
"9035","Fionnuala","F",7,10,17
"9036","Fiora","F",19,22,41
"9037","Fiorela","F",6,5,11
"9038","Fiorella","F",49,85,134
"9039","Firas","M",13,21,34
"9040","Firdaus","F",5,10,15
"9041","Firdaws","F",5,6,11
"9042","Fischer","M",104,92,196
"9043","Fishel","M",10,15,25
"9044","Fisher","M",292,308,600
"9045","Fitz","M",33,39,72
"9046","Fitzgerald","M",73,86,159
"9047","Fitzpatrick","M",9,10,19
"9048","Fitzwilliam","M",8,8,16
"9049","Fiza","F",13,10,23
"9050","Flannery","F",10,10,20
"9051","Flavia","F",10,22,32
"9052","Flavio","M",27,37,64
"9053","Fletcher","M",386,401,787
"9054","Fleur","F",11,12,23
"9055","Flint","M",74,85,159
"9056","Flor","F",82,84,166
"9057","Flora","F",176,192,368
"9058","Florence","F",214,246,460
"9059","Florencia","F",26,16,42
"9060","Florencio","M",13,9,22
"9061","Florentino","M",11,14,25
"9062","Florian","M",17,18,35
"9063","Floyd","M",107,116,223
"9064","Flynn","F",21,22,43
"9065","Flynn","M",361,374,735
"9066","Flynt","M",13,5,18
"9067","Folasade","F",15,9,24
"9068","Ford","M",325,342,667
"9069","Fordham","M",7,6,13
"9070","Forest","F",5,6,11
"9071","Forest","M",134,176,310
"9072","Forever","F",30,24,54
"9073","Forrest","M",390,417,807
"9074","Fortune","F",7,11,18
"9075","Fortune","M",10,5,15
"9076","Foster","F",10,11,21
"9077","Foster","M",195,211,406
"9078","Fotini","F",5,5,10
"9079","Fouad","M",11,12,23
"9080","Fowler","M",10,7,17
"9081","Fox","F",6,12,18
"9082","Fox","M",195,323,518
"9083","Foxx","M",13,11,24
"9084","Fradel","F",26,21,47
"9085","Frady","F",17,20,37
"9086","Fraida","F",16,18,34
"9087","Fraidy","F",39,40,79
"9088","Frances","F",607,716,1323
"9089","Frances","M",6,5,11
"9090","Francesca","F",744,762,1506
"9091","Francesco","M",131,134,265
"9092","Franceska","F",5,10,15
"9093","Franchesca","F",30,42,72
"9094","Francheska","F",32,27,59
"9095","Francia","F",10,5,15
"9096","Francine","F",55,72,127
"9097","Francis","F",64,79,143
"9098","Francis","M",619,636,1255
"9099","Francisca","F",42,59,101
"9100","Francisco","M",1482,1440,2922
"9101","Franciszek","M",5,9,14
"9102","Franck","M",6,5,11
"9103","Franco","M",253,353,606
"9104","Francois","M",20,15,35
"9105","Frandy","M",10,5,15
"9106","Frank","M",942,951,1893
"9107","Frankee","F",19,14,33
"9108","Franki","F",28,20,48
"9109","Frankie","F",271,282,553
"9110","Frankie","M",205,199,404
"9111","Franklin","M",688,737,1425
"9112","Franklyn","F",6,9,15
"9113","Franklyn","M",22,23,45
"9114","Franko","M",6,20,26
"9115","Franky","M",31,57,88
"9116","Fransisco","M",14,18,32
"9117","Franz","M",15,20,35
"9118","Franziska","F",5,6,11
"9119","Fraser","M",5,5,10
"9120","Fraya","F",22,21,43
"9121","Frayda","F",5,8,13
"9122","Frazier","M",9,16,25
"9123","Fred","M",100,107,207
"9124","Freda","F",12,16,28
"9125","Freddie","M",83,82,165
"9126","Freddrick","M",5,6,11
"9127","Freddy","M",206,154,360
"9128","Frederic","M",39,40,79
"9129","Frederick","M",556,579,1135
"9130","Frederico","M",5,7,12
"9131","Frederik","M",18,9,27
"9132","Fredi","M",7,8,15
"9133","Fredric","M",11,15,26
"9134","Fredrick","M",149,125,274
"9135","Fredrik","M",13,10,23
"9136","Fredy","M",94,82,176
"9137","Freedom","F",26,25,51
"9138","Freedom","M",16,18,34
"9139","Freeman","M",26,31,57
"9140","Freida","F",19,23,42
"9141","Freja","F",28,34,62
"9142","Freya","F",766,991,1757
"9143","Freyah","F",9,17,26
"9144","Freyja","F",139,180,319
"9145","Frida","F",325,348,673
"9146","Frieda","F",25,47,72
"9147","Friedrich","M",20,12,32
"9148","Frimet","F",21,18,39
"9149","Frimmy","F",6,9,15
"9150","Frimy","F",8,7,15
"9151","Fritz","M",43,50,93
"9152","Froilan","M",6,8,14
"9153","Frost","M",8,5,13
"9154","Froylan","M",14,10,24
"9155","Fuad","M",10,15,25
"9156","Fuller","M",8,7,15
"9157","Fulton","M",35,42,77
"9158","Furious","M",5,6,11
"9159","Furkan","M",9,8,17
"9160","Furqan","M",6,6,12
"9161","Future","M",17,21,38
"9162","Fynlee","F",25,38,63
"9163","Fynleigh","F",11,7,18
"9164","Fynley","F",5,7,12
"9165","Fynlie","F",5,8,13
"9166","Fynn","F",6,11,17
"9167","Fynn","M",107,105,212
"9168","Fynnigan","M",5,5,10
"9169","Fynnley","F",7,8,15
"9170","Fyodor","M",5,9,14
"9171","Gabbanelli","F",15,7,22
"9172","Gabbie","F",8,11,19
"9173","Gabbriella","F",9,14,23
"9174","Gabby","F",48,36,84
"9175","Gabe","M",88,51,139
"9176","Gaberial","M",11,5,16
"9177","Gaberiel","M",18,11,29
"9178","Gabi","F",7,7,14
"9179","Gabino","M",29,28,57
"9180","Gable","M",18,11,29
"9181","Gabrial","M",20,17,37
"9182","Gabrian","M",5,6,11
"9183","Gabriana","F",7,12,19
"9184","Gabrianna","F",17,19,36
"9185","Gabriel","F",52,49,101
"9186","Gabriel","M",10839,10142,20981
"9187","Gabriela","F",1259,1243,2502
"9188","Gabriele","F",18,11,29
"9189","Gabriele","M",18,20,38
"9190","Gabriell","F",11,7,18
"9191","Gabriell","M",8,9,17
"9192","Gabriella","F",4606,4215,8821
"9193","Gabriellah","F",8,7,15
"9194","Gabrielle","F",1597,1410,3007
"9195","Gabrielle","M",16,11,27
"9196","Gabrielly","F",8,5,13
"9197","Gabrien","M",6,7,13
"9198","Gabryel","M",19,9,28
"9199","Gabryela","F",7,7,14
"9200","Gabryella","F",21,22,43
"9201","Gabryelle","F",5,8,13
"9202","Gaby","F",41,42,83
"9203","Gad","M",9,9,18
"9204","Gaddiel","M",5,16,21
"9205","Gadiel","M",71,90,161
"9206","Gadsden","M",5,6,11
"9207","Gael","F",7,8,15
"9208","Gael","M",1782,2239,4021
"9209","Gaelle","F",12,18,30
"9210","Gaetano","M",16,25,41
"9211","Gage","M",1530,1284,2814
"9212","Gahel","M",5,6,11
"9213","Gaia","F",92,98,190
"9214","Gaige","F",6,5,11
"9215","Gaige","M",134,123,257
"9216","Gail","F",15,20,35
"9217","Gaines","M",18,29,47
"9218","Gaius","M",15,22,37
"9219","Gala","F",47,55,102
"9220","Galadriel","F",6,5,11
"9221","Galaxy","F",11,18,29
"9222","Galaxy","M",5,5,10
"9223","Gale","M",8,8,16
"9224","Galen","M",47,32,79
"9225","Galena","F",6,7,13
"9226","Gali","F",6,7,13
"9227","Galia","F",20,16,36
"9228","Galilea","F",446,594,1040
"9229","Galileah","F",29,16,45
"9230","Galilee","F",25,44,69
"9231","Galileo","M",30,20,50
"9232","Galina","F",12,6,18
"9233","Galvin","M",14,21,35
"9234","Gamal","M",8,6,14
"9235","Gamaliel","M",40,43,83
"9236","Gamble","M",7,11,18
"9237","Gamila","F",5,6,11
"9238","Gannon","M",531,345,876
"9239","Ganon","M",22,16,38
"9240","Garang","M",5,6,11
"9241","Gardenia","F",13,9,22
"9242","Gardner","M",11,7,18
"9243","Garen","M",28,26,54
"9244","Gareth","M",102,104,206
"9245","Garett","M",27,23,50
"9246","Garin","M",18,9,27
"9247","Garland","M",21,22,43
"9248","Garner","F",5,5,10
"9249","Garner","M",22,22,44
"9250","Garnet","F",7,15,22
"9251","Garon","M",7,8,15
"9252","Garren","M",32,26,58
"9253","Garret","M",61,43,104
"9254","Garreth","M",8,7,15
"9255","Garrett","M",1349,1144,2493
"9256","Garrick","M",35,37,72
"9257","Garrison","M",193,170,363
"9258","Garron","M",8,8,16
"9259","Garrus","M",12,9,21
"9260","Garry","M",26,37,63
"9261","Garth","M",20,12,32
"9262","Garv","M",5,8,13
"9263","Garvey","M",6,10,16
"9264","Garvin","M",12,5,17
"9265","Gary","M",476,442,918
"9266","Garyn","M",11,5,16
"9267","Garyson","M",6,7,13
"9268","Gaspar","M",29,30,59
"9269","Gaspard","M",8,7,15
"9270","Gaston","M",29,30,59
"9271","Gates","M",12,17,29
"9272","Gatlin","M",187,149,336
"9273","Gatlyn","M",16,16,32
"9274","Gatsby","M",12,17,29
"9275","Gauge","M",251,211,462
"9276","Gaurav","M",12,7,19
"9277","Gauri","F",18,12,30
"9278","Gautam","M",17,21,38
"9279","Gautham","M",34,28,62
"9280","Gavan","M",9,11,20
"9281","Gaven","M",55,39,94
"9282","Gavin","F",5,5,10
"9283","Gavin","M",5768,4913,10681
"9284","Gavino","M",26,31,57
"9285","Gavriel","M",73,80,153
"9286","Gavriella","F",19,10,29
"9287","Gavrielle","F",6,5,11
"9288","Gavyn","F",8,8,16
"9289","Gavyn","M",171,130,301
"9290","Gavynn","M",10,7,17
"9291","Gayatri","F",10,9,19
"9292","Geanna","F",12,11,23
"9293","Gedalya","M",8,7,15
"9294","Gedeon","M",10,10,20
"9295","Geena","F",8,7,15
"9296","Gehrig","M",22,13,35
"9297","Geisha","F",18,6,24
"9298","Gelila","F",8,26,34
"9299","Gem","F",8,14,22
"9300","Gema","F",75,55,130
"9301","Gemini","F",11,19,30
"9302","Gemini","M",13,16,29
"9303","Gemma","F",1169,1264,2433
"9304","Gena","F",14,10,24
"9305","Genaro","M",65,60,125
"9306","Genavie","F",12,7,19
"9307","Genavieve","F",25,31,56
"9308","Gene","M",67,77,144
"9309","Genecis","F",6,7,13
"9310","Genelle","F",7,5,12
"9311","General","M",13,13,26
"9312","Genesee","F",11,10,21
"9313","Genesi","F",7,6,13
"9314","Genesis","F",4157,4325,8482
"9315","Genesis","M",93,96,189
"9316","Genessa","F",11,14,25
"9317","Genessis","F",42,43,85
"9318","Genesys","F",26,20,46
"9319","Geneva","F",203,194,397
"9320","Genevie","F",31,29,60
"9321","Genevieve","F",1771,1723,3494
"9322","Genisis","F",22,29,51
"9323","Genisys","F",9,6,15
"9324","Geniyah","F",10,5,15
"9325","Genna","F",18,10,28
"9326","Gennady","M",6,11,17
"9327","Gennaro","M",16,23,39
"9328","Gennesis","F",19,24,43
"9329","Geno","M",54,50,104
"9330","Genova","F",8,7,15
"9331","Genoveva","F",7,14,21
"9332","Gentri","F",8,7,15
"9333","Gentry","F",112,110,222
"9334","Gentry","M",97,96,193
"9335","Genysis","F",5,5,10
"9336","Geo","M",19,23,42
"9337","Geoffrey","M",80,80,160
"9338","Geonna","F",7,7,14
"9339","Geordan","M",11,9,20
"9340","George","M",3042,3288,6330
"9341","Georges","M",11,10,21
"9342","Georgette","F",35,24,59
"9343","Georgi","M",7,8,15
"9344","Georgia","F",1433,1405,2838
"9345","Georgiana","F",118,105,223
"9346","Georgianna","F",28,26,54
"9347","Georgie","F",26,39,65
"9348","Georgina","F",129,133,262
"9349","Georgio","M",18,20,38
"9350","Georgios","M",22,15,37
"9351","Georgiy","M",10,5,15
"9352","Geovani","M",33,33,66
"9353","Geovanna","F",20,24,44
"9354","Geovanni","M",112,116,228
"9355","Geovanny","M",59,57,116
"9356","Geovany","M",42,38,80
"9357","Geovonni","M",12,8,20
"9358","Gerald","M",312,283,595
"9359","Geraldine","F",130,138,268
"9360","Geraldo","M",12,13,25
"9361","Gerard","M",179,159,338
"9362","Gerardo","M",742,680,1422
"9363","Geremiah","M",32,30,62
"9364","Geremy","M",15,27,42
"9365","Geri","F",6,5,11
"9366","Germain","M",6,9,15
"9367","Germaine","M",14,6,20
"9368","German","M",155,170,325
"9369","Germani","F",11,22,33
"9370","Germany","F",12,27,39
"9371","Geronimo","M",46,47,93
"9372","Gerrard","M",9,10,19
"9373","Gerrit","M",29,21,50
"9374","Gerry","M",7,20,27
"9375","Gershom","M",8,6,14
"9376","Gershon","M",24,26,50
"9377","Gerson","M",77,115,192
"9378","Gertrude","F",26,36,62
"9379","Getsemani","F",29,22,51
"9380","Ghaith","M",8,8,16
"9381","Ghala","F",8,13,21
"9382","Ghali","M",8,8,16
"9383","Ghalia","F",12,14,26
"9384","Ghassan","M",17,19,36
"9385","Ghazal","F",14,10,24
"9386","Ghazi","M",14,9,23
"9387","Ghina","F",6,14,20
"9388","Ghita","F",6,6,12
"9389","Gia","F",873,868,1741
"9390","Giabella","F",26,13,39
"9391","Giacomo","M",25,23,48
"9392","Giada","F",203,178,381
"9393","Giah","F",6,5,11
"9394","Gian","M",151,140,291
"9395","Giana","F",312,287,599
"9396","Gianah","F",5,6,11
"9397","Giancarlo","M",265,205,470
"9398","Giancarlos","M",21,25,46
"9399","Gianella","F",35,50,85
"9400","Gianelle","F",7,5,12
"9401","Gianfranco","M",27,21,48
"9402","Giani","F",10,7,17
"9403","Giani","M",8,9,17
"9404","Gianina","F",9,9,18
"9405","Giankarlo","M",5,6,11
"9406","Gianluca","M",100,166,266
"9407","Gianlucas","M",7,5,12
"9408","Gianlucca","M",9,10,19
"9409","Gianmarco","M",43,20,63
"9410","Giann","M",7,6,13
"9411","Gianna","F",3170,3209,6379
"9412","Giannah","F",20,13,33
"9413","Gianni","F",69,60,129
"9414","Gianni","M",498,448,946
"9415","Gianny","M",11,6,17
"9416","Giavana","F",21,30,51
"9417","Giavanna","F",272,223,495
"9418","Giavanni","F",7,16,23
"9419","Giavonna","F",37,51,88
"9420","Giavonni","F",13,8,21
"9421","Giavonni","M",7,5,12
"9422","Gibran","M",36,30,66
"9423","Gibson","F",16,10,26
"9424","Gibson","M",220,227,447
"9425","Gideon","M",1050,1016,2066
"9426","Gift","F",11,5,16
"9427","Gigi","F",38,68,106
"9428","Gil","M",32,32,64
"9429","Gila","F",12,7,19
"9430","Gilad","M",7,7,14
"9431","Gilbert","M",209,213,422
"9432","Gilberto","M",189,178,367
"9433","Gilda","F",9,9,18
"9434","Gildardo","M",11,13,24
"9435","Gilead","M",11,5,16
"9436","Giles","M",20,17,37
"9437","Gillian","F",120,105,225
"9438","Gilmer","M",6,6,12
"9439","Gimena","F",19,11,30
"9440","Gina","F",101,112,213
"9441","Ginevra","F",14,15,29
"9442","Ginger","F",68,56,124
"9443","Ginna","F",7,13,20
"9444","Ginny","F",20,23,43
"9445","Gino","M",187,192,379
"9446","Gio","M",46,50,96
"9447","Gioia","F",17,25,42
"9448","Giomar","M",10,9,19
"9449","Gionna","F",27,34,61
"9450","Gionni","M",126,88,214
"9451","Giordana","F",7,5,12
"9452","Giordano","M",6,7,13
"9453","Giorgi","M",10,13,23
"9454","Giorgia","F",19,23,42
"9455","Giorgio","M",75,82,157
"9456","Giovana","F",12,14,26
"9457","Giovani","M",294,248,542
"9458","Giovanna","F",344,363,707
"9459","Giovanni","F",12,10,22
"9460","Giovanni","M",3127,2919,6046
"9461","Giovannie","M",17,10,27
"9462","Giovanny","M",169,139,308
"9463","Giovany","M",33,23,56
"9464","Giovonni","M",45,44,89
"9465","Girl","F",15,11,26
"9466","Gisel","F",20,22,42
"9467","Gisela","F",51,46,97
"9468","Gisele","F",139,153,292
"9469","Gisell","F",29,22,51
"9470","Gisella","F",35,33,68
"9471","Giselle","F",1484,1457,2941
"9472","Gissel","F",38,36,74
"9473","Gissele","F",8,6,14
"9474","Gissell","F",13,16,29
"9475","Gisselle","F",185,184,369
"9476","Gita","F",11,7,18
"9477","Gittel","F",51,39,90
"9478","Gitty","F",120,138,258
"9479","Giulia","F",83,98,181
"9480","Giulian","M",16,10,26
"9481","Giuliana","F",684,561,1245
"9482","Giulianna","F",77,66,143
"9483","Giuliano","M",35,33,68
"9484","Giulietta","F",62,101,163
"9485","Giuliette","F",8,10,18
"9486","Giulio","M",7,10,17
"9487","Giuseppe","M",112,121,233
"9488","Giuseppina","F",8,7,15
"9489","Giyanna","F",5,6,11
"9490","Gizel","F",9,6,15
"9491","Gizelle","F",85,103,188
"9492","Gladis","F",17,12,29
"9493","Gladys","F",83,71,154
"9494","Gleb","M",20,10,30
"9495","Glen","M",94,84,178
"9496","Glenda","F",27,33,60
"9497","Glendon","M",26,12,38
"9498","Glendy","F",12,13,25
"9499","Glenn","M",165,171,336
"9500","Glenna","F",8,11,19
"9501","Gloria","F",595,563,1158
"9502","Gloriana","F",30,17,47
"9503","Glorianna","F",10,11,21
"9504","Glorious","F",7,5,12
"9505","Glory","F",83,111,194
"9506","Glory","M",10,9,19
"9507","Glynn","M",5,5,10
"9508","Goddess","F",40,38,78
"9509","Godfrey","M",6,8,14
"9510","Godric","M",40,36,76
"9511","Godson","M",5,10,15
"9512","Godwin","M",18,18,36
"9513","Gohan","M",27,27,54
"9514","Goku","M",7,13,20
"9515","Golda","F",45,40,85
"9516","Golden","F",17,16,33
"9517","Golden","M",28,17,45
"9518","Goldie","F",79,115,194
"9519","Goldy","F",48,45,93
"9520","Goliath","M",6,5,11
"9521","Gonzalo","M",168,135,303
"9522","Gordon","M",278,218,496
"9523","Gorgeous","F",9,13,22
"9524","Gotham","M",46,50,96
"9525","Gowtham","M",9,6,15
"9526","Grace","F",7630,7531,15161
"9527","Grace","M",10,15,25
"9528","Graceann","F",18,19,37
"9529","Gracee","F",39,44,83
"9530","Graceland","F",8,7,15
"9531","Gracelee","F",10,10,20
"9532","Gracelin","F",13,12,25
"9533","Gracelyn","F",919,909,1828
"9534","Gracelynn","F",836,871,1707
"9535","Gracelynne","F",23,25,48
"9536","Gracen","F",95,125,220
"9537","Gracen","M",74,79,153
"9538","Graceson","M",37,39,76
"9539","Gracey","F",65,60,125
"9540","Graceyn","F",25,46,71
"9541","Graci","F",44,27,71
"9542","Gracia","F",20,19,39
"9543","Graciana","F",10,8,18
"9544","Gracianna","F",6,7,13
"9545","Gracie","F",1946,1799,3745
"9546","Gracieann","F",9,9,18
"9547","Graciela","F",114,107,221
"9548","Graciella","F",46,40,86
"9549","Gracielynn","F",8,6,14
"9550","Graciemae","F",7,7,14
"9551","Gracilyn","F",10,5,15
"9552","Gracin","F",8,9,17
"9553","Gracin","M",19,26,45
"9554","Gracious","F",7,7,14
"9555","Graclyn","F",21,15,36
"9556","Graclynn","F",11,12,23
"9557","Gracy","F",20,53,73
"9558","Gracyn","F",216,220,436
"9559","Gracyn","M",16,12,28
"9560","Gracynn","F",20,15,35
"9561","Graden","M",22,19,41
"9562","Grady","M",957,934,1891
"9563","Gradyn","M",17,17,34
"9564","Grae","F",10,14,24
"9565","Graecyn","F",7,7,14
"9566","Graelyn","F",14,17,31
"9567","Graelynn","F",6,8,14
"9568","Graeme","M",137,117,254
"9569","Graeson","M",47,45,92
"9570","Graesyn","M",10,11,21
"9571","Grafton","M",5,15,20
"9572","Graham","F",10,12,22
"9573","Graham","M",2375,2237,4612
"9574","Grahm","M",24,27,51
"9575","Grainger","M",13,14,27
"9576","Graisen","M",5,6,11
"9577","Graison","M",24,26,50
"9578","Graisyn","M",8,8,16
"9579","Gram","M",13,19,32
"9580","Granger","M",62,110,172
"9581","Granite","M",5,11,16
"9582","Grant","M",2357,2340,4697
"9583","Grantham","M",9,11,20
"9584","Grantley","M",13,14,27
"9585","Grason","M",16,16,32
"9586","Gray","F",45,44,89
"9587","Gray","M",141,140,281
"9588","Grayce","F",52,36,88
"9589","Graycee","F",16,21,37
"9590","Graycelyn","F",5,6,11
"9591","Graycen","F",47,53,100
"9592","Graycen","M",25,30,55
"9593","Graycie","F",14,15,29
"9594","Grayden","M",110,96,206
"9595","Graydon","M",87,63,150
"9596","Grayer","M",7,11,18
"9597","Graylan","M",5,8,13
"9598","Graylee","F",11,8,19
"9599","Graylen","M",5,11,16
"9600","Graylin","F",7,5,12
"9601","Graylon","M",9,17,26
"9602","Graylyn","F",6,11,17
"9603","Graysen","F",33,34,67
"9604","Graysen","M",269,348,617
"9605","Graysin","M",5,11,16
"9606","Grayson","F",169,157,326
"9607","Grayson","M",7887,8622,16509
"9608","Graysyn","M",7,11,18
"9609","Grayton","M",12,16,28
"9610","Graziella","F",13,14,27
"9611","Grecia","F",171,164,335
"9612","Greenlee","F",45,33,78
"9613","Greenleigh","F",13,17,30
"9614","Greenley","F",18,14,32
"9615","Greenly","F",5,9,14
"9616","Greer","F",88,98,186
"9617","Greer","M",25,18,43
"9618","Greg","M",34,37,71
"9619","Gregg","M",15,13,28
"9620","Greggory","M",6,6,12
"9621","Gregor","M",8,12,20
"9622","Gregorio","M",73,74,147
"9623","Gregory","M",982,913,1895
"9624","Greicy","F",5,20,25
"9625","Greisy","F",5,17,22
"9626","Gresham","M",7,9,16
"9627","Greta","F",533,471,1004
"9628","Gretchen","F",162,169,331
"9629","Gretel","F",36,57,93
"9630","Grethel","F",12,6,18
"9631","Gretta","F",51,62,113
"9632","Grettel","F",44,85,129
"9633","Grettell","F",8,12,20
"9634","Grey","F",71,64,135
"9635","Grey","M",233,317,550
"9636","Greycen","M",14,15,29
"9637","Greyden","M",21,13,34
"9638","Greydon","M",19,16,35
"9639","Greylon","M",5,12,17
"9640","Greysen","F",18,17,35
"9641","Greysen","M",178,213,391
"9642","Greysin","M",15,14,29
"9643","Greyson","F",46,38,84
"9644","Greyson","M",3591,4295,7886
"9645","Greyston","M",6,6,12
"9646","Greysun","M",8,5,13
"9647","Greysyn","M",9,12,21
"9648","Greyton","M",5,5,10
"9649","Gricelda","F",5,6,11
"9650","Grier","F",10,23,33
"9651","Grier","M",12,11,23
"9652","Griffen","M",35,29,64
"9653","Griffey","M",7,13,20
"9654","Griffin","F",22,26,48
"9655","Griffin","M",1608,1688,3296
"9656","Griffith","M",13,12,25
"9657","Griffyn","F",9,6,15
"9658","Griffyn","M",18,23,41
"9659","Grigor","M",7,7,14
"9660","Grisel","F",8,5,13
"9661","Griselda","F",44,54,98
"9662","Grover","M",19,17,36
"9663","Gryffin","M",49,59,108
"9664","Gryphon","M",25,25,50
"9665","Guadalupe","F",505,457,962
"9666","Guadalupe","M",64,69,133
"9667","Guhan","M",12,9,21
"9668","Guilherme","M",12,15,27
"9669","Guiliana","F",32,18,50
"9670","Guilianna","F",6,8,14
"9671","Guillermo","M",387,321,708
"9672","Guinevere","F",176,140,316
"9673","Guliana","F",5,10,15
"9674","Gulianna","F",17,14,31
"9675","Gunnar","F",5,6,11
"9676","Gunnar","M",824,791,1615
"9677","Gunner","M",1581,1445,3026
"9678","Gunnison","M",12,5,17
"9679","Gunter","M",17,11,28
"9680","Gunther","M",26,19,45
"9681","Gurbani","F",8,11,19
"9682","Gurfateh","M",18,21,39
"9683","Gurjot","M",6,8,14
"9684","Gurkirat","M",5,5,10
"9685","Gurleen","F",25,18,43
"9686","Gurman","M",7,15,22
"9687","Gurnaaz","F",7,7,14
"9688","Gurnoor","F",21,29,50
"9689","Gurnoor","M",10,7,17
"9690","Gurseerat","F",5,11,16
"9691","Gurshaan","M",10,6,16
"9692","Gurshan","M",6,9,15
"9693","Gurtaj","M",8,6,14
"9694","Gurveer","M",14,14,28
"9695","Gus","M",163,202,365
"9696","Gustav","M",22,28,50
"9697","Gustave","M",10,7,17
"9698","Gustavo","M",541,515,1056
"9699","Guthrie","M",14,16,30
"9700","Guy","M",153,139,292
"9701","Gwen","F",376,371,747
"9702","Gwendalyn","F",35,39,74
"9703","Gwendalynn","F",8,11,19
"9704","Gwendelyn","F",10,12,22
"9705","Gwendolen","F",27,27,54
"9706","Gwendolyn","F",791,824,1615
"9707","Gwendolynn","F",25,33,58
"9708","Gweneth","F",33,35,68
"9709","Gwenevere","F",49,48,97
"9710","Gwenevieve","F",5,7,12
"9711","Gwenith","F",6,8,14
"9712","Gwenivere","F",27,25,52
"9713","Gwenn","F",5,10,15
"9714","Gwenna","F",5,6,11
"9715","Gwenyth","F",146,143,289
"9716","Gwyn","F",10,11,21
"9717","Gwyndolyn","F",11,8,19
"9718","Gwyneth","F",236,194,430
"9719","Gwynevere","F",18,16,34
"9720","Gwynn","F",29,19,48
"9721","Gyan","M",9,14,23
"9722","Gyanna","F",5,8,13
"9723","Gyasi","M",6,7,13
"9724","Gypsy","F",26,21,47
"9725","Haadi","M",18,15,33
"9726","Haadiya","F",6,5,11
"9727","Haakon","M",21,30,51
"9728","Haaris","M",6,8,14
"9729","Haasini","F",15,17,32
"9730","Habib","M",21,19,40
"9731","Habiba","F",28,25,53
"9732","Habon","F",5,5,10
"9733","Hadasa","F",43,34,77
"9734","Hadasah","F",11,5,16
"9735","Hadasha","F",7,5,12
"9736","Hadassa","F",75,56,131
"9737","Hadassah","F",402,440,842
"9738","Hadden","F",5,5,10
"9739","Hadden","M",7,5,12
"9740","Haddie","F",162,148,310
"9741","Haddon","M",39,52,91
"9742","Haddy","F",8,13,21
"9743","Hadeel","F",23,23,46
"9744","Hadelyn","F",7,7,14
"9745","Haden","F",6,7,13
"9746","Haden","M",62,48,110
"9747","Hades","M",7,12,19
"9748","Hadessah","F",10,13,23
"9749","Hadi","M",77,87,164
"9750","Hadia","F",20,24,44
"9751","Hadiya","F",29,24,53
"9752","Hadiyah","F",15,15,30
"9753","Hadja","F",5,8,13
"9754","Hadlea","F",15,9,24
"9755","Hadlee","F",345,392,737
"9756","Hadlei","F",9,5,14
"9757","Hadleigh","F",284,317,601
"9758","Hadley","F",2970,2871,5841
"9759","Hadley","M",37,33,70
"9760","Hadli","F",21,14,35
"9761","Hadlie","F",39,39,78
"9762","Hadlyn","F",7,13,20
"9763","Hadrian","M",29,33,62
"9764","Hadriel","M",9,7,16
"9765","Hadyn","F",9,9,18
"9766","Hadyn","M",7,10,17
"9767","Haeden","M",10,6,16
"9768","Haedyn","F",17,13,30
"9769","Haedyn","M",8,12,20
"9770","Haelyn","F",14,11,25
"9771","Haelynn","F",9,5,14
"9772","Haeven","F",6,9,15
"9773","Haevyn","F",18,11,29
"9774","Hafsa","F",102,110,212
"9775","Hafsah","F",29,25,54
"9776","Hagan","F",7,5,12
"9777","Hagan","M",43,48,91
"9778","Hagen","F",19,10,29
"9779","Hagen","M",116,128,244
"9780","Haggai","M",6,8,14
"9781","Haidar","M",18,14,32
"9782","Haidee","F",12,6,18
"9783","Haiden","F",73,55,128
"9784","Haiden","M",209,176,385
"9785","Haider","M",50,52,102
"9786","Haidy","F",10,5,15
"9787","Haidyn","F",86,115,201
"9788","Haidyn","M",21,28,49
"9789","Haidynn","F",8,12,20
"9790","Haifa","F",9,6,15
"9791","Haigen","M",5,7,12
"9792","Haile","F",14,9,23
"9793","Hailee","F",335,289,624
"9794","Haileigh","F",44,30,74
"9795","Hailey","F",4236,3918,8154
"9796","Hailie","F",159,125,284
"9797","Haily","F",34,25,59
"9798","Hailyn","F",22,24,46
"9799","Hailynn","F",16,21,37
"9800","Haislee","F",12,14,26
"9801","Haisley","F",63,100,163
"9802","Haitham","M",17,12,29
"9803","Haiven","F",14,18,32
"9804","Haivyn","F",12,12,24
"9805","Haizel","F",14,13,27
"9806","Haizen","M",5,7,12
"9807","Haizlee","F",20,20,40
"9808","Haizley","F",29,37,66
"9809","Hajar","F",23,22,45
"9810","Hajer","F",11,10,21
"9811","Hajira","F",6,8,14
"9812","Hajra","F",13,14,27
"9813","Hakan","M",10,9,19
"9814","Hakeem","M",160,235,395
"9815","Hakim","M",25,28,53
"9816","Hal","M",20,15,35
"9817","Hala","F",48,62,110
"9818","Halah","F",7,8,15
"9819","Halden","M",9,16,25
"9820","Hale","M",22,20,42
"9821","Halee","F",17,12,29
"9822","Haleem","M",7,7,14
"9823","Haleema","F",14,15,29
"9824","Haleigh","F",200,172,372
"9825","Halen","F",28,27,55
"9826","Halen","M",41,36,77
"9827","Halena","F",10,9,19
"9828","Haley","F",1133,999,2132
"9829","Hali","F",35,18,53
"9830","Halia","F",32,19,51
"9831","Halie","F",33,25,58
"9832","Halil","M",7,5,12
"9833","Halim","M",5,12,17
"9834","Halima","F",73,69,142
"9835","Halimah","F",7,14,21
"9836","Halina","F",27,23,50
"9837","Halle","F",301,276,577
"9838","Hallee","F",27,32,59
"9839","Halleigh","F",12,11,23
"9840","Hallelujah","F",9,6,15
"9841","Halley","F",43,32,75
"9842","Halli","F",12,11,23
"9843","Hallie","F",542,533,1075
"9844","Hally","F",9,6,15
"9845","Halo","F",128,179,307
"9846","Halo","M",15,25,40
"9847","Halona","F",13,11,24
"9848","Halston","F",6,17,23
"9849","Halston","M",14,23,37
"9850","Halyn","F",8,6,14
"9851","Halynn","F",10,9,19
"9852","Hamad","M",30,23,53
"9853","Hamda","F",11,11,22
"9854","Hamdan","M",18,25,43
"9855","Hamdi","F",20,25,45
"9856","Hamdi","M",8,6,14
"9857","Hamed","M",12,13,25
"9858","Hamid","M",12,21,33
"9859","Hamilton","M",86,97,183
"9860","Hamish","M",20,11,31
"9861","Hammad","M",12,12,24
"9862","Hammond","M",6,8,14
"9863","Hamna","F",12,9,21
"9864","Hampton","F",14,10,24
"9865","Hampton","M",76,57,133
"9866","Hamsa","M",6,6,12
"9867","Hamse","M",5,7,12
"9868","Hamsini","F",9,8,17
"9869","Hamza","M",433,492,925
"9870","Hamzah","M",42,46,88
"9871","Hamze","M",7,12,19
"9872","Hamzeh","M",6,6,12
"9873","Han","F",19,12,31
"9874","Han","M",22,19,41
"9875","Hana","F",326,334,660
"9876","Hanaa","F",8,13,21
"9877","Hanaan","F",9,9,18
"9878","Hanad","M",20,16,36
"9879","Hanah","F",25,20,45
"9880","Hanalei","F",11,8,19
"9881","Hanan","F",60,67,127
"9882","Haneef","M",16,14,30
"9883","Haneen","F",45,46,91
"9884","Hani","M",16,19,35
"9885","Hania","F",36,31,67
"9886","Haniel","M",22,27,49
"9887","Hanif","M",16,14,30
"9888","Hanifa","F",9,9,18
"9889","Hanish","M",8,13,21
"9890","Haniya","F",60,97,157
"9891","Haniyah","F",16,10,26
"9892","Hank","M",531,629,1160
"9893","Hanley","F",18,15,33
"9894","Hanley","M",25,15,40
"9895","Hanna","F",596,583,1179
"9896","Hanna","M",7,5,12
"9897","Hannah","F",6398,5976,12374
"9898","Hannahgrace","F",8,6,14
"9899","Hannalee","F",6,5,11
"9900","Hannan","F",5,8,13
"9901","Hannia","F",18,16,34
"9902","Hannibal","M",19,16,35
"9903","Hans","M",121,131,252
"9904","Hansel","M",90,72,162
"9905","Hansen","M",20,36,56
"9906","Hansika","F",8,6,14
"9907","Hansini","F",7,6,13
"9908","Hanson","M",42,38,80
"9909","Hanzalah","M",5,8,13
"9910","Hanzel","M",7,9,16
"9911","Hao","M",12,8,20
"9912","Haoran","M",6,8,14
"9913","Haoxuan","M",5,7,12
"9914","Haoyu","M",6,7,13
"9915","Harbor","F",61,67,128
"9916","Harbor","M",24,27,51
"9917","Harbour","F",8,8,16
"9918","Harbour","M",7,6,13
"9919","Harden","M",7,5,12
"9920","Hardin","M",5,8,13
"9921","Harding","M",6,6,12
"9922","Hardy","M",43,47,90
"9923","Hareem","F",32,44,76
"9924","Harel","M",8,11,19
"9925","Harfateh","M",9,5,14
"9926","Hargun","F",14,23,37
"9927","Hari","M",20,30,50
"9928","Hariharan","M",7,5,12
"9929","Harini","F",27,30,57
"9930","Haris","M",60,57,117
"9931","Harish","M",6,10,16
"9932","Harjas","M",6,9,15
"9933","Harjot","M",9,8,17
"9934","Harlan","F",33,27,60
"9935","Harlan","M",273,271,544
"9936","Harland","M",31,49,80
"9937","Harlee","F",331,462,793
"9938","Harlee","M",10,18,28
"9939","Harleen","F",96,117,213
"9940","Harlei","F",17,22,39
"9941","Harleigh","F",249,285,534
"9942","Harlem","F",89,93,182
"9943","Harlem","M",201,183,384
"9944","Harlen","F",5,8,13
"9945","Harlen","M",59,54,113
"9946","Harlequin","F",5,6,11
"9947","Harlequinn","F",5,6,11
"9948","Harley","F",1127,1422,2549
"9949","Harley","M",387,374,761
"9950","Harleyquinn","F",21,20,41
"9951","Harli","F",33,48,81
"9952","Harlie","F",150,156,306
"9953","Harlin","F",7,6,13
"9954","Harlin","M",18,32,50
"9955","Harlo","F",18,17,35
"9956","Harlon","M",9,18,27
"9957","Harlow","F",757,781,1538
"9958","Harlow","M",24,34,58
"9959","Harlowe","F",43,47,90
"9960","Harlym","F",26,19,45
"9961","Harlyn","F",76,202,278
"9962","Harlyn","M",9,12,21
"9963","Harlynn","F",65,114,179
"9964","Harman","M",13,10,23
"9965","Harmani","F",10,15,25
"9966","Harmon","M",19,27,46
"9967","Harmonee","F",65,76,141
"9968","Harmoney","F",19,18,37
"9969","Harmoni","F",283,271,554
"9970","Harmonie","F",136,134,270
"9971","Harmonii","F",30,31,61
"9972","Harmony","F",1745,1703,3448
"9973","Harnoor","F",17,20,37
"9974","Harold","M",283,285,568
"9975","Haron","M",9,7,16
"9976","Haroon","M",44,58,102
"9977","Haroun","M",11,20,31
"9978","Harper","F",10283,10733,21016
"9979","Harper","M",341,294,635
"9980","Harriet","F",181,174,355
"9981","Harriett","F",10,10,20
"9982","Harrington","M",10,8,18
"9983","Harris","F",7,9,16
"9984","Harris","M",203,211,414
"9985","Harrison","F",6,8,14
"9986","Harrison","M",3333,3646,6979
"9987","Harry","M",300,372,672
"9988","Harseerat","F",6,5,11
"9989","Harsh","M",14,7,21
"9990","Harsha","M",10,10,20
"9991","Harshaan","M",5,8,13
"9992","Harshika","F",8,5,13
"9993","Harshil","M",5,8,13
"9994","Harshini","F",9,13,22
"9995","Harshith","M",6,7,13
"9996","Harshitha","F",6,11,17
"9997","Hart","F",5,8,13
"9998","Hart","M",20,13,33
"9999","Hartford","M",7,5,12
"10000","Hartlee","F",26,23,49
"10001","Hartleigh","F",9,11,20
"10002","Hartley","F",132,141,273
"10003","Hartley","M",22,15,37
"10004","Hartlyn","F",23,16,39
"10005","Hartlynn","F",9,13,22
"10006","Haru","F",6,14,20
"10007","Haru","M",15,14,29
"10008","Haruka","F",11,10,21
"10009","Haruki","M",17,18,35
"10010","Harumi","F",5,6,11
"10011","Harun","M",44,51,95
"10012","Harut","M",7,10,17
"10013","Haruto","M",16,15,31
"10014","Harveer","M",5,8,13
"10015","Harvest","F",15,23,38
"10016","Harvest","M",5,7,12
"10017","Harvey","F",8,13,21
"10018","Harvey","M",694,770,1464
"10019","Harvi","F",6,5,11
"10020","Harvin","M",8,12,20
"10021","Hasaan","M",7,9,16
"10022","Hasan","M",125,148,273
"10023","Hasani","M",23,33,56
"10024","Haseeb","M",17,10,27
"10025","Haset","F",14,15,29
"10026","Hashem","M",16,26,42
"10027","Hashim","M",67,90,157
"10028","Hashir","M",39,25,64
"10029","Hasini","F",24,13,37
"10030","Haskell","M",7,9,16
"10031","Hasna","F",8,13,21
"10032","Hasnain","M",12,13,25
"10033","Hassan","M",317,298,615
"10034","Hasset","F",19,22,41
"10035","Haston","M",5,9,14
"10036","Hatcher","M",38,34,72
"10037","Hatem","M",9,6,15
"10038","Hatice","F",9,8,17
"10039","Hatim","M",11,5,16
"10040","Hatley","F",9,10,19
"10041","Hattan","M",9,12,21
"10042","Hattie","F",653,616,1269
"10043","Hava","F",12,7,19
"10044","Havah","F",9,5,14
"10045","Havana","F",52,54,106
"10046","Havanah","F",5,5,10
"10047","Havanna","F",18,24,42
"10048","Havannah","F",15,11,26
"10049","Haven","F",991,1098,2089
"10050","Haven","M",138,125,263
"10051","Havilah","F",24,23,47
"10052","Havish","M",18,10,28
"10053","Havisha","F",6,10,16
"10054","Havoc","M",9,11,20
"10055","Havok","M",6,7,13
"10056","Havyn","F",60,67,127
"10057","Havynn","F",5,8,13
"10058","Hawa","F",87,82,169
"10059","Hawi","F",5,9,14
"10060","Hawk","M",55,52,107
"10061","Hawke","M",12,16,28
"10062","Hawken","M",18,21,39
"10063","Hawkins","M",59,87,146
"10064","Hawthorne","M",25,36,61
"10065","Hawwa","F",10,6,16
"10066","Haya","F",69,79,148
"10067","Hayaan","M",5,8,13
"10068","Hayat","F",27,31,58
"10069","Haydan","M",7,6,13
"10070","Haydee","F",31,33,64
"10071","Hayden","F",1708,1569,3277
"10072","Hayden","M",2729,2373,5102
"10073","Hayder","M",8,7,15
"10074","Haydin","F",13,12,25
"10075","Haydin","M",13,11,24
"10076","Haydn","F",10,8,18
"10077","Haydn","M",28,30,58
"10078","Haydon","M",34,25,59
"10079","Haydyn","F",11,7,18
"10080","Haydyn","M",15,8,23
"10081","Hayes","F",26,25,51
"10082","Hayes","M",529,709,1238
"10083","Haygen","M",20,13,33
"10084","Hayk","M",12,16,28
"10085","Hayla","F",9,14,23
"10086","Hayle","F",16,16,32
"10087","Haylea","F",11,6,17
"10088","Haylee","F",665,519,1184
"10089","Hayleen","F",5,5,10
"10090","Haylei","F",23,17,40
"10091","Hayleigh","F",181,124,305
"10092","Haylen","F",40,43,83
"10093","Haylen","M",6,5,11
"10094","Hayley","F",565,476,1041
"10095","Hayli","F",10,23,33
"10096","Haylie","F",186,157,343
"10097","Haylin","F",8,14,22
"10098","Haylo","F",9,6,15
"10099","Haylynn","F",12,9,21
"10100","Hays","M",16,17,33
"10101","Hayslee","F",25,6,31
"10102","Hayston","M",7,5,12
"10103","Haytham","M",16,11,27
"10104","Hayven","F",93,96,189
"10105","Hayven","M",11,15,26
"10106","Hayvin","F",6,5,11
"10107","Haywood","M",13,10,23
"10108","Hayze","M",18,19,37
"10109","Hayzel","F",48,50,98
"10110","Hayzen","M",12,17,29
"10111","Hayzlee","F",15,20,35
"10112","Hazael","M",30,23,53
"10113","Hazaiah","M",12,13,25
"10114","Haze","F",6,9,15
"10115","Haze","M",35,48,83
"10116","Hazel","F",4288,4634,8922
"10117","Hazel","M",12,17,29
"10118","Hazelee","F",11,7,18
"10119","Hazeleigh","F",8,10,18
"10120","Hazelgrace","F",22,15,37
"10121","Hazell","F",13,17,30
"10122","Hazelle","F",23,26,49
"10123","Hazely","F",16,26,42
"10124","Hazelyn","F",19,28,47
"10125","Hazelynn","F",16,33,49
"10126","Hazem","M",15,10,25
"10127","Hazen","F",12,11,23
"10128","Hazen","M",49,66,115
"10129","Haziel","M",44,50,94
"10130","Hazim","M",6,7,13
"10131","Haziq","M",5,11,16
"10132","Hazlee","F",9,7,16
"10133","Hazleigh","F",8,13,21
"10134","Hazley","F",15,13,28
"10135","Hazyl","F",17,15,32
"10136","Hazzel","F",9,10,19
"10137","Heartly","F",5,7,12
"10138","Heartlyn","F",5,5,10
"10139","Heath","M",269,247,516
"10140","Heather","F",281,271,552
"10141","Heaven","F",940,993,1933
"10142","Heaven","M",16,17,33
"10143","Heavenlee","F",43,37,80
"10144","Heavenleigh","F",16,21,37
"10145","Heavenli","F",5,6,11
"10146","Heavenly","F",280,342,622
"10147","Heavenlyjoy","F",9,11,20
"10148","Heavyn","F",18,22,40
"10149","Heba","F",29,34,63
"10150","Hebe","F",9,19,28
"10151","Heber","M",38,24,62
"10152","Hector","M",1191,1094,2285
"10153","Hedy","F",9,17,26
"10154","Heela","F",13,8,21
"10155","Heer","F",21,14,35
"10156","Heidi","F",953,885,1838
"10157","Heidy","F",134,125,259
"10158","Heily","F",21,32,53
"10159","Heinrich","M",21,23,44
"10160","Heiress","F",15,34,49
"10161","Heitor","M",7,9,16
"10162","Hektor","M",11,7,18
"10163","Helaina","F",23,23,46
"10164","Helaman","M",14,8,22
"10165","Helayna","F",8,9,17
"10166","Helem","F",9,7,16
"10167","Helen","F",762,813,1575
"10168","Helena","F",581,598,1179
"10169","Helene","F",41,33,74
"10170","Heli","F",7,5,12
"10171","Helia","F",5,6,11
"10172","Helina","F",7,10,17
"10173","Helio","M",8,12,20
"10174","Helios","M",20,22,42
"10175","Helix","M",14,16,30
"10176","Hellen","F",80,91,171
"10177","Heloise","F",11,10,21
"10178","Hemen","F",8,5,13
"10179","Hemi","F",9,7,16
"10180","Hemingway","M",5,7,12
"10181","Henchy","F",6,15,21
"10182","Hendel","F",7,5,12
"10183","Henderson","M",33,29,62
"10184","Hendrick","M",50,76,126
"10185","Hendricks","M",19,19,38
"10186","Hendrik","M",64,71,135
"10187","Hendrix","F",43,63,106
"10188","Hendrix","M",692,789,1481
"10189","Hendry","M",8,10,18
"10190","Hendryx","M",7,15,22
"10191","Hendy","F",9,12,21
"10192","Henlee","F",53,42,95
"10193","Henleigh","F",40,37,77
"10194","Henley","F",558,602,1160
"10195","Henley","M",104,89,193
"10196","Henli","F",9,7,16
"10197","Henlie","F",9,9,18
"10198","Henna","F",35,27,62
"10199","Hennessey","F",27,14,41
"10200","Hennessy","F",38,43,81
"10201","Hennessy","M",5,6,11
"10202","Henning","M",11,16,27
"10203","Henny","F",49,28,77
"10204","Henok","M",12,9,21
"10205","Henri","F",6,8,14
"10206","Henri","M",103,119,222
"10207","Henrick","M",11,19,30
"10208","Henrietta","F",60,65,125
"10209","Henriette","F",9,7,16
"10210","Henrik","M",266,269,535
"10211","Henrique","M",15,13,28
"10212","Henrry","M",30,16,46
"10213","Henry","F",10,12,22
"10214","Henry","M",10157,10323,20480
"10215","Henryk","M",31,27,58
"10216","Henslee","F",11,19,30
"10217","Hensley","F",115,164,279
"10218","Hensley","M",10,7,17
"10219","Henson","M",33,28,61
"10220","Henya","F",10,8,18
"10221","Henzley","F",12,5,17
"10222","Hephzibah","F",10,10,20
"10223","Hera","F",39,37,76
"10224","Heran","F",13,9,22
"10225","Herbert","M",79,80,159
"10226","Hercules","M",17,19,36
"10227","Heriberto","M",96,83,179
"10228","Herlinda","F",10,14,24
"10229","Herman","M",91,80,171
"10230","Hermela","F",14,12,26
"10231","Hermes","M",13,9,22
"10232","Herminio","M",6,8,14
"10233","Hermione","F",57,71,128
"10234","Hernan","M",65,76,141
"10235","Hero","F",11,20,31
"10236","Hero","M",57,49,106
"10237","Heron","M",15,8,23
"10238","Herschel","M",27,27,54
"10239","Hersh","M",20,21,41
"10240","Hershel","M",49,40,89
"10241","Hershy","M",38,41,79
"10242","Herson","M",6,12,18
"10243","Heru","M",19,21,40
"10244","Hesham","M",7,9,16
"10245","Hessa","F",5,9,14
"10246","Hesston","M",25,24,49
"10247","Heston","M",54,76,130
"10248","Hetvi","F",10,7,17
"10249","Hewitt","M",18,18,36
"10250","Heyden","M",8,7,15
"10251","Heydi","F",20,19,39
"10252","Hezekiah","M",374,374,748
"10253","Hezron","M",5,5,10
"10254","Hiba","F",60,54,114
"10255","Hibah","F",6,8,14
"10256","Hibba","F",13,11,24
"10257","Hibo","F",5,9,14
"10258","Hidaya","F",11,9,20
"10259","Hidayah","F",6,10,16
"10260","Hieu","M",10,9,19
"10261","Hifza","F",5,5,10
"10262","Hikari","F",8,17,25
"10263","Hikaru","M",7,5,12
"10264","Hikma","F",9,9,18
"10265","Hila","F",12,10,22
"10266","Hilario","M",28,26,54
"10267","Hilary","F",56,26,82
"10268","Hilda","F",49,39,88
"10269","Hilde","F",10,9,19
"10270","Hildegard","F",6,10,16
"10271","Hiliana","F",8,10,18
"10272","Hillary","F",137,171,308
"10273","Hillel","M",26,29,55
"10274","Hilton","M",16,24,40
"10275","Himani","F",7,6,13
"10276","Hina","F",5,8,13
"10277","Hinako","F",5,5,10
"10278","Hinata","F",22,23,45
"10279","Hind","F",11,12,23
"10280","Hinda","F",50,34,84
"10281","Hindy","F",46,59,105
"10282","Hinley","F",22,17,39
"10283","Hinsley","F",6,9,15
"10284","Hipolito","M",6,9,15
"10285","Hira","F",15,23,38
"10286","Hiram","M",116,90,206
"10287","Hiro","M",74,77,151
"10288","Hiroki","M",8,14,22
"10289","Hiroshi","M",13,11,24
"10290","Hiroto","M",13,6,19
"10291","Hisham","M",26,38,64
"10292","Hixon","M",5,5,10
"10293","Hiya","F",7,7,14
"10294","Hiyab","F",12,23,35
"10295","Hiyan","M",5,6,11
"10296","Hobbes","M",12,7,19
"10297","Hobbs","M",8,5,13
"10298","Hobie","M",9,10,19
"10299","Hoda","F",11,10,21
"10300","Hodan","F",14,16,30
"10301","Hogan","M",36,28,64
"10302","Holden","F",13,12,25
"10303","Holden","M",1250,1347,2597
"10304","Holdyn","M",33,39,72
"10305","Holiday","F",19,18,37
"10306","Holland","F",332,316,648
"10307","Holland","M",50,55,105
"10308","Hollee","F",9,6,15
"10309","Holley","F",49,42,91
"10310","Holli","F",19,14,33
"10311","Holliday","F",7,6,13
"10312","Hollie","F",83,81,164
"10313","Hollis","F",106,126,232
"10314","Hollis","M",176,124,300
"10315","Hollister","M",6,7,13
"10316","Holly","F",653,585,1238
"10317","Hollyann","F",5,5,10
"10318","Hollyn","F",37,56,93
"10319","Hollynn","F",7,6,13
"10320","Holston","M",15,7,22
"10321","Holt","M",67,68,135
"10322","Holten","M",13,18,31
"10323","Holton","M",43,35,78
"10324","Holy","F",8,9,17
"10325","Homer","M",29,24,53
"10326","Homero","M",31,26,57
"10327","Honest","F",18,9,27
"10328","Honest","M",10,10,20
"10329","Honestee","F",10,16,26
"10330","Honesti","F",50,47,97
"10331","Honestie","F",7,12,19
"10332","Honesty","F",233,212,445
"10333","Honey","F",49,50,99
"10334","Honor","F",123,102,225
"10335","Honor","M",46,70,116
"10336","Honora","F",19,16,35
"10337","Honour","F",14,22,36
"10338","Honour","M",5,11,16
"10339","Hooper","M",8,6,14
"10340","Hoor","F",6,9,15
"10341","Hoorain","F",15,51,66
"10342","Hooria","F",9,14,23
"10343","Hooriya","F",7,5,12
"10344","Hope","F",1433,1324,2757
"10345","Hope","M",5,7,12
"10346","Hopelynn","F",10,10,20
"10347","Hopper","M",5,5,10
"10348","Horace","M",23,23,46
"10349","Horacio","M",35,22,57
"10350","Horatio","M",9,16,25
"10351","Horizon","F",6,7,13
"10352","Hosanna","F",58,76,134
"10353","Hosea","M",66,56,122
"10354","Hossam","M",5,5,10
"10355","Houston","F",14,10,24
"10356","Houston","M",264,285,549
"10357","Howard","M",194,239,433
"10358","Howie","M",9,11,20
"10359","Hoyt","M",124,107,231
"10360","Hridaan","M",14,21,35
"10361","Hriday","M",8,13,21
"10362","Hridhaan","M",19,13,32
"10363","Hrihaan","M",7,6,13
"10364","Hser","F",8,13,21
"10365","Hser","M",6,7,13
"10366","Huai","F",5,5,10
"10367","Huber","M",10,9,19
"10368","Hubert","M",37,37,74
"10369","Huck","M",90,99,189
"10370","Huckleberry","M",25,27,52
"10371","Huda","F",65,65,130
"10372","Hudsen","M",32,28,60
"10373","Hudson","F",115,127,242
"10374","Hudson","M",6033,6098,12131
"10375","Hudsyn","F",30,52,82
"10376","Hudsyn","M",22,23,45
"10377","Huey","M",15,30,45
"10378","Hugh","M",262,262,524
"10379","Hughes","M",15,8,23
"10380","Hughston","M",7,8,15
"10381","Hugo","M",708,717,1425
"10382","Humaira","F",16,15,31
"10383","Humberto","M",145,129,274
"10384","Humza","M",29,35,64
"10385","Hung","M",9,6,15
"10386","Hunner","M",18,19,37
"10387","Hunt","M",8,7,15
"10388","Hunter","F",356,335,691
"10389","Hunter","M",8316,7613,15929
"10390","Huntington","M",7,11,18
"10391","Huntlee","F",6,10,16
"10392","Huntlee","M",7,5,12
"10393","Huntleigh","F",11,11,22
"10394","Huntley","F",39,31,70
"10395","Huntley","M",55,61,116
"10396","Hurley","M",25,14,39
"10397","Husain","M",11,11,22
"10398","Husam","M",8,13,21
"10399","Husayn","M",15,17,32
"10400","Husna","F",33,42,75
"10401","Hussain","M",86,93,179
"10402","Hussam","M",5,9,14
"10403","Hussein","M",135,123,258
"10404","Hussien","M",7,8,15
"10405","Huston","M",24,15,39
"10406","Hutch","M",30,24,54
"10407","Hutchinson","M",12,12,24
"10408","Hutson","M",60,35,95
"10409","Hutton","M",31,18,49
"10410","Huxlee","M",8,7,15
"10411","Huxley","F",21,26,47
"10412","Huxley","M",215,257,472
"10413","Huxton","M",30,42,72
"10414","Huy","M",21,7,28
"10415","Huzaifa","M",15,22,37
"10416","Huzaifah","M",5,8,13
"10417","Hyacinth","F",9,6,15
"10418","Hyatt","M",16,18,34
"10419","Hyde","M",10,13,23
"10420","Hydee","F",6,7,13
"10421","Hyder","M",5,10,15
"10422","Hykeem","M",6,12,18
"10423","Hyla","F",10,5,15
"10424","Hyland","M",10,5,15
"10425","Hynlee","F",8,5,13
"10426","Hyrum","M",96,115,211
"10427","Iaan","M",7,17,24
"10428","Iain","M",50,44,94
"10429","Iam","M",18,21,39
"10430","Ian","F",13,9,22
"10431","Ian","M",5310,5048,10358
"10432","Iana","F",15,10,25
"10433","Iann","M",30,26,56
"10434","Ianna","F",23,37,60
"10435","Iason","M",6,6,12
"10436","Ibn","M",17,10,27
"10437","Ibraheem","M",76,68,144
"10438","Ibrahim","M",698,815,1513
"10439","Ibrahima","M",37,39,76
"10440","Ibrohim","M",6,6,12
"10441","Ibtisam","F",13,18,31
"10442","Icarus","M",10,18,28
"10443","Icelyn","F",8,9,17
"10444","Icelynn","F",9,11,20
"10445","Icker","M",10,8,18
"10446","Ida","F",159,192,351
"10447","Idalia","F",22,37,59
"10448","Idalie","F",12,18,30
"10449","Idalis","F",5,5,10
"10450","Idaly","F",22,18,40
"10451","Idan","M",29,22,51
"10452","Idania","F",8,5,13
"10453","Idella","F",10,10,20
"10454","Iden","M",31,22,53
"10455","Idil","F",8,5,13
"10456","Idman","F",6,6,12
"10457","Idrees","M",23,30,53
"10458","Idris","M",138,175,313
"10459","Idriss","M",11,13,24
"10460","Idrissa","M",8,7,15
"10461","Idy","F",17,23,40
"10462","Ifeanyichukwu","M",8,7,15
"10463","Ifeoluwa","F",21,22,43
"10464","Ifeoluwa","M",7,8,15
"10465","Ifrah","F",16,10,26
"10466","Ifunanya","F",5,8,13
"10467","Ignacio","M",231,227,458
"10468","Ignatius","M",60,61,121
"10469","Ignazio","M",8,6,14
"10470","Igor","M",16,16,32
"10471","Ihan","M",8,13,21
"10472","Ihsan","M",30,29,59
"10473","Ijeoma","F",5,5,10
"10474","Ikaika","M",31,33,64
"10475","Ike","M",95,54,149
"10476","Ikechukwu","M",13,12,25
"10477","Ikenna","M",13,17,30
"10478","Iker","M",2174,1630,3804
"10479","Ikhlaas","F",5,5,10
"10480","Ikhlas","F",17,20,37
"10481","Ikram","F",9,9,18
"10482","Ikram","M",6,5,11
"10483","Ikran","F",7,7,14
"10484","Iktan","M",8,8,16
"10485","Ila","F",213,196,409
"10486","Ilah","F",26,24,50
"10487","Ilai","M",13,17,30
"10488","Ilan","F",5,9,14
"10489","Ilan","M",101,106,207
"10490","Ilana","F",83,87,170
"10491","Ilani","F",17,20,37
"10492","Ilany","F",6,7,13
"10493","Ilaria","F",26,28,54
"10494","Ilay","M",17,12,29
"10495","Ileah","F",8,7,15
"10496","Ileana","F",64,97,161
"10497","Ileanna","F",10,9,19
"10498","Ilee","F",10,8,18
"10499","Ileen","F",10,11,21
"10500","Ileigh","F",5,6,11
"10501","Ilena","F",8,12,20
"10502","Ilene","F",34,26,60
"10503","Iley","F",11,11,22
"10504","Ilham","F",11,14,25
"10505","Ilhan","F",6,30,36
"10506","Ilhan","M",13,8,21
"10507","Ilia","F",13,14,27
"10508","Ilia","M",9,7,16
"10509","Ilian","M",7,6,13
"10510","Iliana","F",302,331,633
"10511","Iliani","F",5,7,12
"10512","Ilianna","F",38,41,79
"10513","Iliany","F",9,7,16
"10514","Ilias","M",28,34,62
"10515","Ilija","M",6,7,13
"10516","Ilijah","M",24,26,50
"10517","Ilina","F",9,7,16
"10518","Ilithyia","F",10,11,21
"10519","Iliya","F",5,5,10
"10520","Iliya","M",8,7,15
"10521","Iliyah","F",13,14,27
"10522","Iliza","F",10,11,21
"10523","Illa","F",11,13,24
"10524","Illeana","F",9,9,18
"10525","Illiana","F",74,69,143
"10526","Illianna","F",22,23,45
"10527","Illias","M",7,7,14
"10528","Illyana","F",25,27,52
"10529","Illyanna","F",16,11,27
"10530","Ilma","F",6,7,13
"10531","Ilona","F",36,35,71
"10532","Ilsa","F",9,10,19
"10533","Ilse","F",33,24,57
"10534","Ily","F",72,47,119
"10535","Ilya","F",7,15,22
"10536","Ilya","M",36,27,63
"10537","Ilyaas","M",9,7,16
"10538","Ilyana","F",68,71,139
"10539","Ilyanna","F",13,26,39
"10540","Ilyas","M",86,97,183
"10541","Ilynn","F",5,5,10
"10542","Ilyse","F",7,5,12
"10543","Ilyssa","F",8,19,27
"10544","Imaad","M",7,9,16
"10545","Imaan","F",31,26,57
"10546","Imaan","M",8,8,16
"10547","Imad","M",11,12,23
"10548","Iman","F",104,106,210
"10549","Iman","M",28,28,56
"10550","Imane","F",5,11,16
"10551","Imani","F",580,568,1148
"10552","Imani","M",19,25,44
"10553","Imanol","M",24,7,31
"10554","Imanuel","M",7,9,16
"10555","Imara","F",19,29,48
"10556","Imari","F",22,35,57
"10557","Imari","M",49,40,89
"10558","Imelda","F",18,34,52
"10559","Imer","M",10,7,17
"10560","Imir","M",6,8,14
"10561","Immanuel","M",238,209,447
"10562","Imogen","F",141,168,309
"10563","Imogene","F",33,45,78
"10564","Imoni","F",11,11,22
"10565","Imraan","M",15,10,25
"10566","Imran","M",183,191,374
"10567","Imrane","M",5,6,11
"10568","Ina","F",56,51,107
"10569","Inaaya","F",86,119,205
"10570","Inaayah","F",7,7,14
"10571","Inaki","M",11,9,20
"10572","Inanna","F",8,8,16
"10573","Inara","F",130,103,233
"10574","Inari","F",12,23,35
"10575","Inas","F",7,6,13
"10576","Inaya","F",97,114,211
"10577","Inayah","F",32,44,76
"10578","Indee","F",6,6,12
"10579","Independence","F",5,6,11
"10580","Indi","F",25,34,59
"10581","India","F",262,262,524
"10582","Indiana","F",73,83,156
"10583","Indiana","M",74,72,146
"10584","Indica","F",17,29,46
"10585","Indie","F",146,206,352
"10586","Indie","M",8,12,20
"10587","Indigo","F",120,118,238
"10588","Indigo","M",52,44,96
"10589","Indio","M",10,8,18
"10590","Indira","F",47,59,106
"10591","Indiya","F",11,9,20
"10592","Indiyah","F",6,5,11
"10593","Indra","F",28,21,49
"10594","Indy","F",46,57,103
"10595","Indy","M",30,26,56
"10596","Indya","F",18,32,50
"10597","Ines","F",97,83,180
"10598","Inessa","F",25,16,41
"10599","Inez","F",62,86,148
"10600","Infant","M",7,7,14
"10601","Infiniti","F",7,6,13
"10602","Infinity","F",23,27,50
"10603","Inga","F",22,19,41
"10604","Ingrid","F",282,320,602
"10605","Inigo","M",16,11,27
"10606","Iniko","M",6,5,11
"10607","Inioluwa","F",14,10,24
"10608","Inioluwa","M",8,10,18
"10609","Iniya","F",17,16,33
"10610","Inman","M",9,9,18
"10611","Inna","F",27,19,46
"10612","Inoke","M",7,6,13
"10613","Insiya","F",7,8,15
"10614","Insiyah","F",6,7,13
"10615","Intisar","F",5,6,11
"10616","Io","F",5,16,21
"10617","Ioan","M",6,6,12
"10618","Ioane","M",5,5,10
"10619","Ioanna","F",15,23,38
"10620","Ioannis","M",22,29,51
"10621","Iola","F",11,10,21
"10622","Iolani","F",5,7,12
"10623","Ion","M",11,7,18
"10624","Iona","F",64,58,122
"10625","Ione","F",26,23,49
"10626","Ionna","F",7,11,18
"10627","Ipek","F",7,5,12
"10628","Iqlas","F",5,5,10
"10629","Iqra","F",60,64,124
"10630","Ira","F",97,125,222
"10631","Ira","M",198,218,416
"10632","Irah","F",5,5,10
"10633","Irah","M",9,6,15
"10634","Irais","F",12,13,25
"10635","Iram","M",35,25,60
"10636","Iran","M",11,12,23
"10637","Ireland","F",272,223,495
"10638","Ireland","M",5,5,10
"10639","Irelia","F",9,5,14
"10640","Irelyn","F",65,78,143
"10641","Irelynd","F",6,6,12
"10642","Irelynn","F",100,99,199
"10643","Iremide","F",8,10,18
"10644","Iremide","M",10,10,20
"10645","Irena","F",31,30,61
"10646","Irene","F",451,444,895
"10647","Ireoluwa","F",12,16,28
"10648","Ireoluwa","M",12,14,26
"10649","Ireri","F",5,7,12
"10650","Irfan","M",15,15,30
"10651","Irha","F",6,11,17
"10652","Iriana","F",16,15,31
"10653","Irianna","F",11,7,18
"10654","Iridessa","F",9,13,22
"10655","Irie","F",182,147,329
"10656","Irie","M",22,24,46
"10657","Irina","F",96,98,194
"10658","Iris","F",1499,1736,3235
"10659","Irisa","F",11,9,20
"10660","Irish","F",8,10,18
"10661","Irlanda","F",26,21,47
"10662","Irma","F",67,71,138
"10663","Iroh","M",6,10,16
"10664","Irsa","F",5,8,13
"10665","Irvin","M",112,107,219
"10666","Irving","M",100,139,239
"10667","Irwin","M",18,16,34
"10668","Irys","F",11,8,19
"10669","Isa","F",72,73,145
"10670","Isa","M",110,114,224
"10671","Isaac","F",12,11,23
"10672","Isaac","M",9935,9671,19606
"10673","Isaak","M",122,106,228
"10674","Isabeau","F",19,19,38
"10675","Isabel","F",2156,2100,4256
"10676","Isabela","F",367,346,713
"10677","Isabele","F",7,6,13
"10678","Isabell","F",185,159,344
"10679","Isabella","F",15574,14722,30296
"10680","Isabella","M",21,11,32
"10681","Isabellagrace","F",9,7,16
"10682","Isabellah","F",22,12,34
"10683","Isabellamarie","F",9,5,14
"10684","Isabellarose","F",9,10,19
"10685","Isabelle","F",3213,3008,6221
"10686","Isabelly","F",9,5,14
"10687","Isac","M",42,39,81
"10688","Isacc","M",39,27,66
"10689","Isadora","F",171,136,307
"10690","Isadore","M",10,13,23
"10691","Isael","M",75,75,150
"10692","Isahi","M",5,6,11
"10693","Isai","M",196,183,379
"10694","Isaia","M",17,8,25
"10695","Isaiah","F",18,17,35
"10696","Isaiah","M",7583,7454,15037
"10697","Isaiahs","M",10,5,15
"10698","Isaias","M",520,537,1057
"10699","Isaic","M",9,11,20
"10700","Isaih","M",19,10,29
"10701","Isaiha","M",8,8,16
"10702","Isais","M",7,6,13
"10703","Isaiyah","M",9,10,19
"10704","Isak","M",34,26,60
"10705","Isaly","F",9,6,15
"10706","Isam","M",5,7,12
"10707","Isamar","F",34,23,57
"10708","Isatou","F",9,6,15
"10709","Isaura","F",16,13,29
"10710","Isayah","M",17,22,39
"10711","Isela","F",71,84,155
"10712","Isella","F",9,9,18
"10713","Iselle","F",9,6,15
"10714","Isha","F",125,132,257
"10715","Ishaan","M",233,242,475
"10716","Ishaani","F",7,6,13
"10717","Ishaaq","M",14,7,21
"10718","Ishak","M",6,6,12
"10719","Ishan","M",114,114,228
"10720","Ishana","F",20,18,38
"10721","Ishani","F",58,51,109
"10722","Ishanvi","F",26,43,69
"10723","Ishaq","M",37,33,70
"10724","Ishi","F",6,8,14
"10725","Ishika","F",34,38,72
"10726","Ishita","F",19,15,34
"10727","Ishitha","F",7,12,19
"10728","Ishmael","M",148,131,279
"10729","Isiah","M",178,194,372
"10730","Isiaha","M",8,5,13
"10731","Isidora","F",20,21,41
"10732","Isidore","M",11,11,22
"10733","Isidro","M",76,68,144
"10734","Isileli","M",5,5,10
"10735","Isis","F",117,53,170
"10736","Iskander","M",6,7,13
"10737","Isla","F",2270,2504,4774
"10738","Islah","F",8,47,55
"10739","Islam","M",14,14,28
"10740","Island","F",20,32,52
"10741","Islay","F",12,15,27
"10742","Isley","F",69,92,161
"10743","Isley","M",15,20,35
"10744","Ismaeel","M",23,23,46
"10745","Ismael","M",769,791,1560
"10746","Ismahan","F",11,12,23
"10747","Ismail","M",158,170,328
"10748","Ismerai","F",9,12,21
"10749","Isobel","F",92,129,221
"10750","Isobella","F",8,10,18
"10751","Isolde","F",21,19,40
"10752","Isra","F",66,60,126
"10753","Israa","F",27,25,52
"10754","Israel","F",60,51,111
"10755","Israel","M",1571,1663,3234
"10756","Israella","F",7,9,16
"10757","Isreal","M",59,59,118
"10758","Isrrael","M",8,12,20
"10759","Issa","F",28,25,53
"10760","Issa","M",54,80,134
"10761","Issabella","F",69,63,132
"10762","Issabelle","F",14,6,20
"10763","Issac","M",505,433,938
"10764","Issachar","M",9,10,19
"10765","Issaiah","M",5,14,19
"10766","Issak","M",8,7,15
"10767","Issam","M",12,5,17
"10768","Issiah","M",10,10,20
"10769","Isyss","F",20,8,28
"10770","Iszabella","F",14,6,20
"10771","Ita","F",17,13,30
"10772","Itai","M",19,21,40
"10773","Italee","F",5,6,11
"10774","Itali","F",7,5,12
"10775","Italia","F",106,97,203
"10776","Italo","M",7,9,16
"10777","Italy","F",100,96,196
"10778","Itamar","M",14,17,31
"10779","Itati","F",9,6,15
"10780","Itay","M",12,9,21
"10781","Ithan","M",5,17,22
"10782","Ithiel","M",10,5,15
"10783","Itiel","M",5,5,10
"10784","Itsuki","M",6,5,11
"10785","Itza","F",12,9,21
"10786","Itzabella","F",12,21,33
"10787","Itzae","F",9,15,24
"10788","Itzae","M",52,66,118
"10789","Itzael","M",21,21,42
"10790","Itzamara","F",6,24,30
"10791","Itzayana","F",226,367,593
"10792","Itzayanna","F",9,11,20
"10793","Itzel","F",651,654,1305
"10794","Itzia","F",17,16,33
"10795","Itzuri","F",5,7,12
"10796","Itzy","F",5,6,11
"10797","Iva","F",98,125,223
"10798","Ivaan","M",35,59,94
"10799","Ivah","F",10,10,20
"10800","Ivalee","F",9,11,20
"10801","Ivan","F",6,6,12
"10802","Ivan","M",3038,3146,6184
"10803","Ivana","F",183,208,391
"10804","Ivania","F",13,11,24
"10805","Ivanka","F",37,111,148
"10806","Ivanna","F",467,532,999
"10807","Ivannah","F",12,9,21
"10808","Ivar","M",10,14,24
"10809","Ivee","F",22,22,44
"10810","Ivelisse","F",21,16,37
"10811","Iven","M",19,15,34
"10812","Iver","M",33,47,80
"10813","Iverson","M",46,64,110
"10814","Ivery","F",6,15,21
"10815","Ives","M",5,5,10
"10816","Iveth","F",23,12,35
"10817","Ivett","F",18,12,30
"10818","Ivette","F",70,61,131
"10819","Ivey","F",116,141,257
"10820","Iviana","F",13,15,28
"10821","Ivianna","F",7,9,16
"10822","Ivie","F",72,85,157
"10823","Ivin","M",8,5,13
"10824","Iviona","F",13,11,24
"10825","Ivionna","F",10,7,17
"10826","Ivo","M",15,11,26
"10827","Ivon","M",8,11,19
"10828","Ivonna","F",6,9,15
"10829","Ivonne","F",49,28,77
"10830","Ivor","M",7,6,13
"10831","Ivoree","F",5,8,13
"10832","Ivori","F",15,17,32
"10833","Ivorie","F",19,15,34
"10834","Ivory","F",394,458,852
"10835","Ivory","M",36,27,63
"10836","Ivry","F",8,5,13
"10837","Ivy","F",2498,2797,5295
"10838","Ivy","M",12,12,24
"10839","Ivyana","F",35,21,56
"10840","Ivyanna","F",25,34,59
"10841","Ivylynn","F",11,7,18
"10842","Ivyonna","F",26,21,47
"10843","Ivyrose","F",12,19,31
"10844","Ixchel","F",22,24,46
"10845","Iya","F",23,17,40
"10846","Iyad","M",6,12,18
"10847","Iyah","F",8,7,15
"10848","Iyan","M",11,14,25
"10849","Iyana","F",100,69,169
"10850","Iyanah","F",16,17,33
"10851","Iyani","F",10,5,15
"10852","Iyanna","F",142,143,285
"10853","Iyannah","F",17,11,28
"10854","Iyla","F",112,114,226
"10855","Iylah","F",13,26,39
"10856","Iyonna","F",53,48,101
"10857","Iza","F",16,19,35
"10858","Izaac","M",128,77,205
"10859","Izaak","M",90,65,155
"10860","Izaan","M",24,22,46
"10861","Izabel","F",126,113,239
"10862","Izabela","F",68,54,122
"10863","Izabell","F",60,40,100
"10864","Izabella","F",1410,1216,2626
"10865","Izabellah","F",22,16,38
"10866","Izabelle","F",217,169,386
"10867","Izac","M",19,16,35
"10868","Izack","M",13,9,22
"10869","Izadora","F",15,16,31
"10870","Izaeah","M",6,11,17
"10871","Izael","M",19,35,54
"10872","Izai","M",5,5,10
"10873","Izaiah","M",529,516,1045
"10874","Izaias","M",12,9,21
"10875","Izaiyah","M",9,5,14
"10876","Izak","M",46,37,83
"10877","Izamar","F",9,9,18
"10878","Izan","M",93,69,162
"10879","Izara","F",5,6,11
"10880","Izaya","M",25,29,54
"10881","Izayah","M",173,167,340
"10882","Izayiah","M",13,14,27
"10883","Izeah","M",10,10,20
"10884","Izek","M",34,18,52
"10885","Izekiel","M",9,11,20
"10886","Izel","F",82,49,131
"10887","Izel","M",11,7,18
"10888","Izela","F",7,7,14
"10889","Izell","M",5,5,10
"10890","Izelle","F",6,6,12
"10891","Izen","M",14,11,25
"10892","Izeyah","M",12,12,24
"10893","Iziah","M",26,20,46
"10894","Izik","M",21,28,49
"10895","Izmael","M",21,12,33
"10896","Izna","F",5,6,11
"10897","Izora","F",5,6,11
"10898","Izrael","M",55,59,114
"10899","Izreal","M",13,11,24
"10900","Izsak","M",5,6,11
"10901","Izyaan","M",5,5,10
"10902","Izyan","M",9,14,23
"10903","Izyk","M",19,12,31
"10904","Izza","F",10,10,20
"10905","Izzabell","F",11,11,22
"10906","Izzabella","F",166,130,296
"10907","Izzabelle","F",28,30,58
"10908","Izzac","M",15,8,23
"10909","Izzah","F",15,8,23
"10910","Izzak","M",7,5,12
"10911","Izziah","M",5,7,12
"10912","Izzie","F",15,16,31
"10913","Izzy","F",55,60,115
"10914","Izzy","M",14,20,34
"10915","Jaad","M",6,9,15
"10916","Jaalah","F",6,10,16
"10917","Jaaliyah","F",18,17,35
"10918","Jaanvi","F",11,14,25
"10919","Jaasia","F",5,6,11
"10920","Jaasiel","M",33,33,66
"10921","Jaasritha","F",5,8,13
"10922","Jaaziah","M",19,17,36
"10923","Jaaziel","M",21,18,39
"10924","Jabari","M",219,234,453
"10925","Jabarri","M",9,8,17
"10926","Jabbar","M",7,6,13
"10927","Jabdiel","M",5,5,10
"10928","Jaber","M",9,7,16
"10929","Jabes","M",11,10,21
"10930","Jabez","M",25,24,49
"10931","Jabin","M",11,10,21
"10932","Jabir","M",16,9,25
"10933","Jabria","F",25,22,47
"10934","Jabriel","M",31,24,55
"10935","Jabril","M",44,43,87
"10936","Jac","M",8,16,24
"10937","Jacai","M",10,13,23
"10938","Jacalyn","F",6,7,13
"10939","Jacari","M",81,75,156
"10940","Jacarri","M",16,19,35
"10941","Jacayden","M",5,8,13
"10942","Jaccob","M",11,13,24
"10943","Jace","F",35,37,72
"10944","Jace","M",5329,5169,10498
"10945","Jacee","F",37,25,62
"10946","Jaceion","M",50,61,111
"10947","Jacek","M",8,21,29
"10948","Jacelyn","F",105,83,188
"10949","Jacelynn","F",75,48,123
"10950","Jacen","M",115,122,237
"10951","Jaceon","M",133,114,247
"10952","Jacere","M",8,7,15
"10953","Jacey","F",171,168,339
"10954","Jacey","M",16,7,23
"10955","Jaceyon","M",52,58,110
"10956","Jachai","M",9,12,21
"10957","Jachin","M",20,10,30
"10958","Jaci","F",96,88,184
"10959","Jacian","M",6,8,14
"10960","Jacie","F",104,84,188
"10961","Jaciel","M",27,31,58
"10962","Jacieon","M",8,6,14
"10963","Jacier","M",6,7,13
"10964","Jacinda","F",28,19,47
"10965","Jacinta","F",33,23,56
"10966","Jacinto","M",23,26,49
"10967","Jacion","M",46,51,97
"10968","Jack","F",6,11,17
"10969","Jack","M",8488,8367,16855
"10970","Jackelin","F",30,22,52
"10971","Jackeline","F",132,71,203
"10972","Jackelyn","F",59,43,102
"10973","Jackie","F",94,91,185
"10974","Jackie","M",90,85,175
"10975","Jacklyn","F",95,89,184
"10976","Jacklynn","F",46,40,86
"10977","Jackman","M",5,7,12
"10978","Jacks","M",7,7,14
"10979","Jacksen","M",22,19,41
"10980","Jackson","F",24,25,49
"10981","Jackson","M",12242,11210,23452
"10982","Jackston","M",16,13,29
"10983","Jacksyn","F",5,8,13
"10984","Jacksyn","M",13,13,26
"10985","Jacky","F",8,5,13
"10986","Jacky","M",35,30,65
"10987","Jaclyn","F",158,148,306
"10988","Jaclynn","F",38,33,71
"10989","Jacob","F",22,14,36
"10990","Jacob","M",15914,14416,30330
"10991","Jacobe","M",18,18,36
"10992","Jacobi","F",6,5,11
"10993","Jacobi","M",134,137,271
"10994","Jacobie","M",23,18,41
"10995","Jacobo","M",68,78,146
"10996","Jacoby","M",393,330,723
"10997","Jacolby","M",29,34,63
"10998","Jacorey","M",44,42,86
"10999","Jacori","M",26,30,56
"11000","Jacorian","M",11,13,24
"11001","Jacory","M",30,23,53
"11002","Jacque","M",13,14,27
"11003","Jacquees","M",15,22,37
"11004","Jacquelin","F",42,23,65
"11005","Jacqueline","F",1229,1130,2359
"11006","Jacquelyn","F",208,156,364
"11007","Jacquelynn","F",23,20,43
"11008","Jacques","M",90,72,162
"11009","Jacquez","M",18,18,36
"11010","Jacson","M",10,6,16
"11011","Jacy","F",38,32,70
"11012","Jacy","M",10,6,16
"11013","Jacyon","M",7,6,13
"11014","Jad","M",170,207,377
"11015","Jada","F",1052,829,1881
"11016","Jadah","F",30,27,57
"11017","Jadalee","F",13,10,23
"11018","Jadalyn","F",25,24,49
"11019","Jadalynn","F",30,29,59
"11020","Jadan","M",14,11,25
"11021","Jadarian","M",8,5,13
"11022","Jadarius","M",32,29,61
"11023","Jadarrius","M",7,8,15
"11024","Jadaya","F",10,11,21
"11025","Jade","F",2559,2685,5244
"11026","Jade","M",47,53,100
"11027","Jadelyn","F",54,59,113
"11028","Jadelynn","F",36,44,80
"11029","Jaden","F",81,83,164
"11030","Jaden","M",2005,1768,3773
"11031","Jadence","F",14,5,19
"11032","Jader","M",8,10,18
"11033","Jadesola","F",6,6,12
"11034","Jadeveon","M",6,8,14
"11035","Jadeyn","F",13,16,29
"11036","Jadie","F",13,11,24
"11037","Jadiel","M",339,312,651
"11038","Jadien","M",8,8,16
"11039","Jadin","M",15,16,31
"11040","Jadis","M",8,5,13
"11041","Jadon","M",232,185,417
"11042","Jadore","F",51,55,106
"11043","Jadrian","M",17,14,31
"11044","Jadriel","M",17,17,34
"11045","Jadrien","M",12,9,21
"11046","Jady","F",5,5,10
"11047","Jadyn","F",109,106,215
"11048","Jadyn","M",71,43,114
"11049","Jadynn","F",15,9,24
"11050","Jadzia","F",23,27,50
"11051","Jae","F",23,25,48
"11052","Jae","M",38,42,80
"11053","Jaece","M",12,19,31
"11054","Jaeceon","M",21,32,53
"11055","Jaecion","M",16,23,39
"11056","Jaecob","M",6,6,12
"11057","Jaeda","F",58,47,105
"11058","Jaedah","F",8,5,13
"11059","Jaedan","M",9,6,15
"11060","Jaeden","F",9,10,19
"11061","Jaeden","M",123,99,222
"11062","Jaedin","M",10,7,17
"11063","Jaedon","M",41,28,69
"11064","Jaedyn","F",48,35,83
"11065","Jaedyn","M",82,57,139
"11066","Jaedynn","F",6,7,13
"11067","Jaeger","M",31,33,64
"11068","Jael","F",151,145,296
"11069","Jael","M",128,140,268
"11070","Jaela","F",64,62,126
"11071","Jaelah","F",41,32,73
"11072","Jaelani","F",16,12,28
"11073","Jaeleah","F",7,5,12
"11074","Jaelee","F",20,27,47
"11075","Jaeleen","F",13,8,21
"11076","Jaeleigh","F",13,14,27
"11077","Jaelen","M",26,21,47
"11078","Jaelene","F",14,16,30
"11079","Jaeli","F",8,7,15
"11080","Jaeliana","F",18,9,27
"11081","Jaelianna","F",6,8,14
"11082","Jaelin","F",9,5,14
"11083","Jaelin","M",18,17,35
"11084","Jaelle","F",28,34,62
"11085","Jaelon","M",10,12,22
"11086","Jaely","F",6,5,11
"11087","Jaelyn","F",488,488,976
"11088","Jaelyn","M",40,32,72
"11089","Jaelyne","F",5,11,16
"11090","Jaelynn","F",493,442,935
"11091","Jaelynne","F",9,24,33
"11092","Jaemarie","F",7,9,16
"11093","Jaeonna","F",7,7,14
"11094","Jaeshawn","M",5,5,10
"11095","Jaeson","M",7,17,24
"11096","Jaevian","M",5,8,13
"11097","Jaevin","M",9,10,19
"11098","Jaevion","M",18,22,40
"11099","Jaevon","M",9,14,23
"11100","Jafar","M",17,19,36
"11101","Jafari","M",6,5,11
"11102","Jafet","M",68,47,115
"11103","Jafeth","M",16,17,33
"11104","Jager","M",14,22,36
"11105","Jaggar","M",7,6,13
"11106","Jagger","F",10,14,24
"11107","Jagger","M",390,433,823
"11108","Jago","M",11,10,21
"11109","Jah","M",9,13,22
"11110","Jahaan","M",7,10,17
"11111","Jahaira","F",11,10,21
"11112","Jahan","M",8,22,30
"11113","Jahanna","F",6,7,13
"11114","Jahara","F",13,5,18
"11115","Jahari","F",5,13,18
"11116","Jahari","M",53,64,117
"11117","Jahaziel","M",48,70,118
"11118","Jahcere","M",5,9,14
"11119","Jahdai","F",10,9,19
"11120","Jahdiel","M",39,47,86
"11121","Jaheem","M",39,29,68
"11122","Jaheim","M",76,72,148
"11123","Jaheir","M",6,7,13
"11124","Jahel","M",12,13,25
"11125","Jahi","M",20,18,38
"11126","Jahid","M",8,8,16
"11127","Jahiem","M",40,28,68
"11128","Jahir","M",79,90,169
"11129","Jahira","F",10,5,15
"11130","Jahkai","M",23,16,39
"11131","Jahkari","M",17,12,29
"11132","Jahkeem","M",10,14,24
"11133","Jahki","M",18,19,37
"11134","Jahking","M",12,8,20
"11135","Jahlani","M",12,11,23
"11136","Jahlayah","F",7,5,12
"11137","Jahleah","F",9,7,16
"11138","Jahleel","M",37,51,88
"11139","Jahlia","F",13,7,20
"11140","Jahlil","M",109,111,220
"11141","Jahliyah","F",17,7,24
"11142","Jahmai","M",12,7,19
"11143","Jahmal","M",10,17,27
"11144","Jahmar","M",12,10,22
"11145","Jahmari","M",45,49,94
"11146","Jahmeer","M",6,6,12
"11147","Jahmeir","M",14,15,29
"11148","Jahmel","M",12,8,20
"11149","Jahmere","M",21,19,40
"11150","Jahmier","M",13,11,24
"11151","Jahmil","M",6,6,12
"11152","Jahmir","M",132,100,232
"11153","Jahmiya","F",7,8,15
"11154","Jahnae","F",11,10,21
"11155","Jahnavi","F",19,12,31
"11156","Jahnia","F",7,6,13
"11157","Jahniya","F",16,15,31
"11158","Jahniyah","F",18,13,31
"11159","Jahnya","F",6,9,15
"11160","Jahnyla","F",5,11,16
"11161","Jahrell","M",6,5,11
"11162","Jahriel","M",5,6,11
"11163","Jahsai","M",8,10,18
"11164","Jahshua","M",5,7,12
"11165","Jahsiah","M",43,41,84
"11166","Jahsir","M",36,22,58
"11167","Jahson","M",6,5,11
"11168","Jahvier","M",6,7,13
"11169","Jahvon","M",10,8,18
"11170","Jahzara","F",57,79,136
"11171","Jahzeel","M",7,8,15
"11172","Jahziah","M",8,15,23
"11173","Jahziel","M",29,34,63
"11174","Jahzier","M",6,7,13
"11175","Jahzion","M",5,7,12
"11176","Jahzir","M",14,10,24
"11177","Jai","F",45,42,87
"11178","Jai","M",148,139,287
"11179","Jaia","F",24,20,44
"11180","Jaiah","F",8,7,15
"11181","Jaiana","F",13,6,19
"11182","Jaianna","F",9,18,27
"11183","Jaice","M",49,56,105
"11184","Jaicee","F",44,38,82
"11185","Jaiceon","M",74,82,156
"11186","Jaicion","M",11,12,23
"11187","Jaida","F",302,241,543
"11188","Jaidah","F",34,39,73
"11189","Jaidan","F",7,6,13
"11190","Jaidan","M",34,18,52
"11191","Jaide","F",51,56,107
"11192","Jaiden","F",107,90,197
"11193","Jaiden","M",1352,1225,2577
"11194","Jaidence","F",8,10,18
"11195","Jaidin","M",10,5,15
"11196","Jaidon","M",28,28,56
"11197","Jaidy","F",10,8,18
"11198","Jaidyn","F",95,92,187
"11199","Jaidyn","M",98,113,211
"11200","Jaidynn","F",13,6,19
"11201","Jaielle","F",9,10,19
"11202","Jaila","F",56,70,126
"11203","Jailah","F",42,44,86
"11204","Jailani","F",11,13,24
"11205","Jailee","F",40,28,68
"11206","Jaileen","F",16,22,38
"11207","Jaileigh","F",10,11,21
"11208","Jailen","F",8,6,14
"11209","Jailen","M",17,34,51
"11210","Jailene","F",39,39,78
"11211","Jailey","F",14,16,30
"11212","Jailon","M",5,6,11
"11213","Jailyn","F",141,133,274
"11214","Jailyn","M",11,14,25
"11215","Jailyne","F",66,97,163
"11216","Jailynn","F",84,92,176
"11217","Jaimarie","F",8,13,21
"11218","Jaime","F",69,58,127
"11219","Jaime","M",606,655,1261
"11220","Jaimee","F",31,27,58
"11221","Jaimeson","M",13,12,25
"11222","Jaimie","F",22,23,45
"11223","Jaina","F",112,111,223
"11224","Jainil","M",5,5,10
"11225","Jaion","M",14,10,24
"11226","Jaiona","F",8,6,14
"11227","Jaionna","F",12,21,33
"11228","Jair","M",198,222,420
"11229","Jaira","F",9,7,16
"11230","Jaire","M",11,13,24
"11231","Jairo","M",251,234,485
"11232","Jairon","M",7,15,22
"11233","Jairus","M",83,49,132
"11234","Jaise","M",12,23,35
"11235","Jaisen","M",15,12,27
"11236","Jaisley","F",8,5,13
"11237","Jaislyn","F",7,8,15
"11238","Jaison","M",34,24,58
"11239","Jaiveer","M",7,10,17
"11240","Jaiven","M",18,17,35
"11241","Jaiveon","M",11,12,23
"11242","Jaivion","M",24,22,46
"11243","Jaivon","M",15,21,36
"11244","Jaivyn","M",10,7,17
"11245","Jaiya","F",36,31,67
"11246","Jaiyah","F",8,14,22
"11247","Jaiyana","F",24,26,50
"11248","Jaiyden","M",7,15,22
"11249","Jajuan","M",22,25,47
"11250","Jak","M",31,17,48
"11251","Jakaden","M",17,12,29
"11252","Jakai","F",10,7,17
"11253","Jakai","M",128,119,247
"11254","Jakaiden","M",21,30,51
"11255","Jakaila","F",6,7,13
"11256","Jakailyn","F",6,7,13
"11257","Jakaiya","F",5,10,15
"11258","Jakara","F",5,6,11
"11259","Jakari","F",10,9,19
"11260","Jakari","M",136,155,291
"11261","Jakarion","M",5,5,10
"11262","Jakarri","M",14,9,23
"11263","Jakayden","M",39,33,72
"11264","Jakayla","F",172,210,382
"11265","Jakaylah","F",13,16,29
"11266","Jakaylee","F",7,7,14
"11267","Jake","M",1916,1576,3492
"11268","Jakeb","M",8,14,22
"11269","Jakeem","M",38,28,66
"11270","Jakel","M",7,5,12
"11271","Jakelin","F",7,6,13
"11272","Jakelyn","F",10,5,15
"11273","Jakeria","F",7,6,13
"11274","Jakhai","M",17,16,33
"11275","Jakhari","M",31,30,61
"11276","Jakhi","M",80,66,146
"11277","Jakhia","F",5,9,14
"11278","Jaki","M",8,10,18
"11279","Jakia","F",10,7,17
"11280","Jakiah","F",17,14,31
"11281","Jakim","M",6,7,13
"11282","Jakin","M",10,5,15
"11283","Jaking","M",18,18,36
"11284","Jakira","F",27,31,58
"11285","Jakiya","F",37,23,60
"11286","Jakiyah","F",54,45,99
"11287","Jakob","M",545,472,1017
"11288","Jakobe","M",158,173,331
"11289","Jakobi","M",100,90,190
"11290","Jakobie","M",12,18,30
"11291","Jakoby","M",73,62,135
"11292","Jakolby","M",11,6,17
"11293","Jakorey","M",5,7,12
"11294","Jakori","M",17,22,39
"11295","Jakota","M",7,9,16
"11296","Jaksen","M",5,7,12
"11297","Jakson","M",48,34,82
"11298","Jakub","M",92,78,170
"11299","Jakya","F",12,10,22
"11300","Jakye","M",17,16,33
"11301","Jakyia","F",7,9,16
"11302","Jakyiah","F",7,5,12
"11303","Jakyla","F",24,31,55
"11304","Jakylah","F",8,10,18
"11305","Jakylee","F",5,5,10
"11306","Jakyra","F",24,26,50
"11307","Jakyren","M",8,5,13
"11308","Jakyrie","M",13,13,26
"11309","Jala","F",21,25,46
"11310","Jalah","F",9,8,17
"11311","Jalaila","F",5,9,14
"11312","Jalaina","F",7,5,12
"11313","Jalaiya","F",14,10,24
"11314","Jalaiyah","F",14,14,28
"11315","Jalal","M",8,19,27
"11316","Jalan","M",9,11,20
"11317","Jalana","F",6,7,13
"11318","Jalani","F",39,39,78
"11319","Jalani","M",25,17,42
"11320","Jalasia","F",5,6,11
"11321","Jalaya","F",87,66,153
"11322","Jalayah","F",117,105,222
"11323","Jalayia","F",12,8,20
"11324","Jalayiah","F",5,5,10
"11325","Jalayla","F",20,10,30
"11326","Jalayna","F",19,12,31
"11327","Jalaysia","F",28,27,55
"11328","Jalea","F",24,12,36
"11329","Jaleah","F",175,158,333
"11330","Jalee","F",16,6,22
"11331","Jaleeah","F",8,11,19
"11332","Jaleel","M",98,97,195
"11333","Jaleena","F",14,10,24
"11334","Jaleesa","F",40,56,96
"11335","Jaleeyah","F",14,6,20
"11336","Jalei","F",5,10,15
"11337","Jaleia","F",9,12,21
"11338","Jaleiah","F",11,8,19
"11339","Jaleigh","F",28,35,63
"11340","Jaleigha","F",24,16,40
"11341","Jalen","F",10,11,21
"11342","Jalen","M",468,481,949
"11343","Jalena","F",24,20,44
"11344","Jalene","F",11,7,18
"11345","Jalexa","F",9,15,24
"11346","Jaley","F",8,9,17
"11347","Jaleya","F",12,9,21
"11348","Jaleyah","F",29,33,62
"11349","Jalia","F",48,44,92
"11350","Jaliah","F",46,33,79
"11351","Jalicia","F",13,12,25
"11352","Jalie","F",7,5,12
"11353","Jalil","M",47,68,115
"11354","Jalila","F",8,5,13
"11355","Jalin","F",5,5,10
"11356","Jalin","M",12,18,30
"11357","Jalina","F",20,17,37
"11358","Jalisa","F",57,41,98
"11359","Jalise","F",11,7,18
"11360","Jalissa","F",69,59,128
"11361","Jaliya","F",20,17,37
"11362","Jaliyah","F",516,492,1008
"11363","Jalon","M",36,21,57
"11364","Jaloni","F",7,11,18
"11365","Jaloni","M",6,9,15
"11366","Jalyn","F",43,28,71
"11367","Jalyn","M",20,14,34
"11368","Jalynn","F",83,83,166
"11369","Jalynne","F",7,5,12
"11370","Jalyric","F",8,7,15
"11371","Jalyssa","F",39,42,81
"11372","Jama","M",5,5,10
"11373","Jamaal","M",65,70,135
"11374","Jamael","M",6,5,11
"11375","Jamahl","M",7,7,14
"11376","Jamai","M",6,7,13
"11377","Jamaica","F",12,7,19
"11378","Jamail","M",8,5,13
"11379","Jamaine","M",9,12,21
"11380","Jamair","M",6,7,13
"11381","Jamaiya","F",5,5,10
"11382","Jamal","M",328,353,681
"11383","Jamale","M",8,6,14
"11384","Jamall","M",8,10,18
"11385","Jamani","F",10,15,25
"11386","Jamani","M",10,8,18
"11387","Jamar","M",191,204,395
"11388","Jamara","F",8,8,16
"11389","Jamarcus","M",85,95,180
"11390","Jamare","M",8,10,18
"11391","Jamaree","M",19,22,41
"11392","Jamari","F",29,26,55
"11393","Jamari","M",521,478,999
"11394","Jamaria","F",30,30,60
"11395","Jamariah","F",6,11,17
"11396","Jamarian","M",26,28,54
"11397","Jamarie","M",9,12,21
"11398","Jamarii","M",10,10,20
"11399","Jamario","M",16,15,31
"11400","Jamarion","M",216,205,421
"11401","Jamarious","M",20,11,31
"11402","Jamarius","M",26,28,54
"11403","Jamariyah","F",5,11,16
"11404","Jamarkus","M",5,6,11
"11405","Jamarr","M",16,9,25
"11406","Jamarri","M",28,29,57
"11407","Jamarrion","M",11,9,20
"11408","Jamason","M",6,7,13
"11409","Jamauri","M",39,36,75
"11410","Jamaya","F",41,79,120
"11411","Jame","M",7,5,12
"11412","Jamee","F",12,9,21
"11413","Jameel","M",34,41,75
"11414","Jameela","F",16,17,33
"11415","Jameelah","F",14,14,28
"11416","Jameer","M",56,61,117
"11417","Jameil","M",6,5,11
"11418","Jameir","M",23,30,53
"11419","Jameis","M",28,21,49
"11420","Jameison","M",14,5,19
"11421","Jamel","M",119,103,222
"11422","Jamela","F",8,6,14
"11423","Jamelia","F",14,12,26
"11424","Jamell","M",27,18,45
"11425","Jamella","F",5,7,12
"11426","Jamelle","M",8,7,15
"11427","Jamen","M",5,12,17
"11428","Jamera","F",9,5,14
"11429","Jamere","M",54,52,106
"11430","Jameria","F",29,16,45
"11431","Jamerson","M",22,17,39
"11432","James","F",39,65,104
"11433","James","M",14773,14776,29549
"11434","Jamese","F",10,5,15
"11435","Jamesen","M",11,10,21
"11436","Jamesha","F",13,9,22
"11437","Jamesmichael","M",5,11,16
"11438","Jameson","F",53,59,112
"11439","Jameson","M",2845,3259,6104
"11440","Jamesyn","F",9,12,21
"11441","Jamesyn","M",6,17,23
"11442","Jamey","F",12,18,30
"11443","Jamey","M",23,19,42
"11444","Jameya","F",9,7,16
"11445","Jameyah","F",9,5,14
"11446","Jamez","M",20,11,31
"11447","Jami","F",25,8,33
"11448","Jamia","F",74,90,164
"11449","Jamiah","F",69,76,145
"11450","Jamiah","M",8,7,15
"11451","Jamian","M",14,15,29
"11452","Jamichael","M",38,32,70
"11453","Jamie","F",638,621,1259
"11454","Jamie","M",277,279,556
"11455","Jamiee","F",6,6,12
"11456","Jamiel","M",11,7,18
"11457","Jamielynn","F",16,17,33
"11458","Jamien","M",12,10,22
"11459","Jamier","M",52,38,90
"11460","Jamiere","M",16,11,27
"11461","Jamieson","M",34,31,65
"11462","Jamil","M",110,91,201
"11463","Jamila","F",106,118,224
"11464","Jamilah","F",46,50,96
"11465","Jamilet","F",7,19,26
"11466","Jamileth","F",40,36,76
"11467","Jamilla","F",12,11,23
"11468","Jamillah","F",6,7,13
"11469","Jamin","M",45,44,89
"11470","Jamion","M",9,5,14
"11471","Jamir","M",361,336,697
"11472","Jamira","F",26,22,48
"11473","Jamiracle","F",16,21,37
"11474","Jamirah","F",19,21,40
"11475","Jamire","M",28,25,53
"11476","Jamis","M",12,16,28
"11477","Jamisen","F",7,16,23
"11478","Jamisen","M",15,19,34
"11479","Jamison","F",46,39,85
"11480","Jamison","M",683,675,1358
"11481","Jamisyn","F",15,22,37
"11482","Jamiya","F",120,83,203
"11483","Jamiyah","F",156,156,312
"11484","Jamon","M",39,34,73
"11485","Jamond","M",8,7,15
"11486","Jamoni","F",7,5,12
"11487","Jamoni","M",12,7,19
"11488","Jamonte","M",16,12,28
"11489","Jamora","F",7,6,13
"11490","Jamori","M",9,6,15
"11491","Jamya","F",122,102,224
"11492","Jamyah","F",29,36,65
"11493","Jamyia","F",21,13,34
"11494","Jamyiah","F",29,18,47
"11495","Jamyla","F",23,26,49
"11496","Jamylah","F",11,14,25
"11497","Jamyra","F",24,25,49
"11498","Jamyrah","F",9,9,18
"11499","Jamyria","F",7,5,12
"11500","Jamyson","M",7,9,16
"11501","Jan","F",8,5,13
"11502","Jan","M",93,84,177
"11503","Jana","F",265,299,564
"11504","Janae","F",267,242,509
"11505","Janai","F",73,54,127
"11506","Janais","F",5,6,11
"11507","Janaiyah","F",7,13,20
"11508","Janaki","F",5,8,13
"11509","Janalee","F",14,7,21
"11510","Janalyn","F",6,8,14
"11511","Janani","F",13,15,28
"11512","Janari","F",5,7,12
"11513","Janari","M",6,5,11
"11514","Janaria","F",7,8,15
"11515","Janasia","F",29,9,38
"11516","Janat","F",8,12,20
"11517","Janay","F",53,35,88
"11518","Janaya","F",70,82,152
"11519","Janayah","F",26,21,47
"11520","Janaye","F",18,14,32
"11521","Janayla","F",10,14,24
"11522","Jancarlo","M",22,27,49
"11523","Jancarlos","M",48,36,84
"11524","Jandel","M",11,6,17
"11525","Jandiel","M",11,10,21
"11526","Jane","F",1111,1129,2240
"11527","Janea","F",14,13,27
"11528","Janee","F",12,5,17
"11529","Janeen","F",6,7,13
"11530","Janeisy","F",7,5,12
"11531","Janel","F",31,35,66
"11532","Janeli","F",14,17,31
"11533","Janelis","F",14,6,20
"11534","Janeliz","F",7,9,16
"11535","Janell","F",44,42,86
"11536","Janella","F",25,24,49
"11537","Janelle","F",677,663,1340
"11538","Janelli","F",8,7,15
"11539","Janellie","F",8,6,14
"11540","Janelly","F",95,77,172
"11541","Janely","F",72,59,131
"11542","Janelys","F",11,9,20
"11543","Janessa","F",395,312,707
"11544","Janet","F",154,162,316
"11545","Janeth","F",89,78,167
"11546","Janett","F",8,12,20
"11547","Janetta","F",6,8,14
"11548","Janette","F",53,54,107
"11549","Janeva","F",5,9,14
"11550","Janey","F",34,39,73
"11551","Jani","F",5,24,29
"11552","Jania","F",32,26,58
"11553","Janiah","F",120,98,218
"11554","Janice","F",198,164,362
"11555","Janie","F",170,157,327
"11556","Janiece","F",25,24,49
"11557","Janiel","M",50,34,84
"11558","Janielle","F",8,6,14
"11559","Janielys","F",9,13,22
"11560","Janila","F",8,8,16
"11561","Janilah","F",13,10,23
"11562","Janina","F",17,12,29
"11563","Janine","F",50,41,91
"11564","Janique","F",13,6,19
"11565","Janis","F",30,23,53
"11566","Janise","F",14,11,25
"11567","Janisha","F",9,7,16
"11568","Janita","F",12,6,18
"11569","Janiya","F",269,236,505
"11570","Janiyah","F",578,550,1128
"11571","Janiyha","F",5,8,13
"11572","Janiyla","F",25,29,54
"11573","Janiylah","F",21,12,33
"11574","Janna","F",82,87,169
"11575","Jannah","F",91,92,183
"11576","Jannat","F",90,78,168
"11577","Jannatul","F",17,14,31
"11578","Jannelle","F",10,17,27
"11579","Jannelly","F",8,9,17
"11580","Jannely","F",14,11,25
"11581","Jannet","F",11,6,17
"11582","Jannette","F",8,9,17
"11583","Janney","F",52,57,109
"11584","Jannie","F",7,9,16
"11585","Janoah","M",13,21,34
"11586","Janora","F",7,6,13
"11587","Jansen","M",46,40,86
"11588","Janson","M",17,34,51
"11589","Janthony","M",8,6,14
"11590","Jantzen","M",8,17,25
"11591","January","F",22,20,42
"11592","Januel","M",15,29,44
"11593","Janvi","F",14,12,26
"11594","Janya","F",38,41,79
"11595","Janyah","F",30,19,49
"11596","Janyia","F",11,7,18
"11597","Janyiah","F",22,22,44
"11598","Janyla","F",91,102,193
"11599","Janylah","F",60,62,122
"11600","Janziel","M",10,9,19
"11601","Jaonna","F",7,9,16
"11602","Japhet","M",16,11,27
"11603","Japheth","M",43,39,82
"11604","Japji","F",17,7,24
"11605","Japleen","F",9,7,16
"11606","Japneet","F",5,9,14
"11607","Jaquan","M",101,109,210
"11608","Jaquarius","M",17,7,24
"11609","Jaquavion","M",5,9,14
"11610","Jaquavious","M",7,5,12
"11611","Jaquel","M",7,6,13
"11612","Jaquelin","F",37,30,67
"11613","Jaqueline","F",140,127,267
"11614","Jaquelyn","F",39,29,68
"11615","Jaquez","M",18,31,49
"11616","Jara","F",7,7,14
"11617","Jaramiah","M",6,5,11
"11618","Jared","M",1007,829,1836
"11619","Jarek","M",25,17,42
"11620","Jarel","M",13,19,32
"11621","Jareli","F",7,8,15
"11622","Jarell","M",45,39,84
"11623","Jarely","F",19,26,45
"11624","Jaren","M",67,40,107
"11625","Jaret","M",13,14,27
"11626","Jareth","M",52,62,114
"11627","Jaretssi","F",22,8,30
"11628","Jarett","M",26,21,47
"11629","Jaretzi","F",17,18,35
"11630","Jaretzy","F",38,23,61
"11631","Jari","M",7,12,19
"11632","Jaria","F",5,5,10
"11633","Jariah","F",66,56,122
"11634","Jariah","M",12,11,23
"11635","Jarian","M",10,5,15
"11636","Jariel","M",98,112,210
"11637","Jarielis","F",5,5,10
"11638","Jarielys","F",9,6,15
"11639","Jarin","M",12,10,22
"11640","Jaritza","F",17,14,31
"11641","Jarius","M",21,19,40
"11642","Jariya","F",19,13,32
"11643","Jariyah","F",70,67,137
"11644","Jarod","M",38,28,66
"11645","Jarom","M",14,18,32
"11646","Jaron","M",107,98,205
"11647","Jarred","M",43,45,88
"11648","Jarrel","M",7,7,14
"11649","Jarrell","M",37,41,78
"11650","Jarren","M",34,33,67
"11651","Jarret","M",14,9,23
"11652","Jarrett","M",165,129,294
"11653","Jarrod","M",74,42,116
"11654","Jarron","M",18,17,35
"11655","Jarvin","M",6,5,11
"11656","Jarvis","M",133,156,289
"11657","Jaryah","F",7,11,18
"11658","Jaryn","M",12,10,22
"11659","Jasai","M",37,34,71
"11660","Jasaiah","M",9,9,18
"11661","Jasani","F",12,16,28
"11662","Jasani","M",7,6,13
"11663","Jasaun","M",6,5,11
"11664","Jase","F",12,8,20
"11665","Jase","M",2289,1580,3869
"11666","Jasean","M",27,13,40
"11667","Jaselle","F",24,25,49
"11668","Jaselyn","F",18,16,34
"11669","Jaselynn","F",7,7,14
"11670","Jasen","M",55,45,100
"11671","Jaseon","M",9,9,18
"11672","Jaser","M",6,6,12
"11673","Jasey","F",27,22,49
"11674","Jashan","M",16,12,28
"11675","Jashaun","M",25,17,42
"11676","Jashawn","M",44,39,83
"11677","Jasher","M",11,10,21
"11678","Jashon","M",15,16,31
"11679","Jashua","M",11,13,24
"11680","Jashun","M",9,7,16
"11681","Jasia","F",21,19,40
"11682","Jasiah","F",30,32,62
"11683","Jasiah","M",446,485,931
"11684","Jasiel","F",9,9,18
"11685","Jasiel","M",104,74,178
"11686","Jasim","M",15,11,26
"11687","Jasion","M",10,11,21
"11688","Jasir","M",46,59,105
"11689","Jasiri","F",6,19,25
"11690","Jasiya","F",12,10,22
"11691","Jasiyah","F",33,22,55
"11692","Jasiyah","M",30,23,53
"11693","Jasleen","F",82,70,152
"11694","Jaslene","F",74,58,132
"11695","Jaslin","F",20,19,39
"11696","Jasline","F",7,8,15
"11697","Jaslyn","F",131,144,275
"11698","Jaslynn","F",108,89,197
"11699","Jasmarie","F",5,10,15
"11700","Jasmeen","F",15,7,22
"11701","Jasmin","F",310,281,591
"11702","Jasmina","F",29,19,48
"11703","Jasmine","F",2793,2625,5418
"11704","Jasmyn","F",82,61,143
"11705","Jasmyne","F",33,20,53
"11706","Jasmynn","F",8,6,14
"11707","Jasneet","F",14,6,20
"11708","Jasnoor","F",14,9,23
"11709","Jason","F",6,7,13
"11710","Jason","M",4990,4851,9841
"11711","Jasper","F",42,41,83
"11712","Jasper","M",1855,1885,3740
"11713","Jasraj","M",9,10,19
"11714","Jasser","M",5,5,10
"11715","Jassiah","M",15,25,40
"11716","Jassiel","M",38,40,78
"11717","Jassim","M",9,14,23
"11718","Jassir","M",5,7,12
"11719","Jasslyn","F",11,7,18
"11720","Jasson","M",22,27,49
"11721","Jaston","M",8,11,19
"11722","Jatavion","M",7,7,14
"11723","Jatavious","M",6,10,16
"11724","Jaterrion","M",5,6,11
"11725","Jathan","M",36,39,75
"11726","Jathniel","M",8,13,21
"11727","Jatin","M",5,5,10
"11728","Jatniel","M",20,33,53
"11729","Jatziri","F",29,20,49
"11730","Jatziry","F",31,21,52
"11731","Javae","F",5,6,11
"11732","Javaeh","F",10,13,23
"11733","Javan","M",49,47,96
"11734","Javanni","M",5,5,10
"11735","Javante","M",16,11,27
"11736","Javar","M",10,11,21
"11737","Javari","M",48,40,88
"11738","Javarion","M",10,7,17
"11739","Javarious","M",14,9,23
"11740","Javaris","M",19,19,38
"11741","Javarius","M",10,9,19
"11742","Javaughn","M",18,14,32
"11743","Javaya","F",9,6,15
"11744","Javayah","F",9,7,16
"11745","Javeah","F",22,28,50
"11746","Javeion","M",7,7,14
"11747","Javell","M",13,10,23
"11748","Javen","M",112,71,183
"11749","Javeon","M",56,34,90
"11750","Javery","M",6,6,12
"11751","Javi","M",17,23,40
"11752","Javia","F",5,7,12
"11753","Javian","M",103,86,189
"11754","Javid","M",7,12,19
"11755","Javiel","M",12,10,22
"11756","Javien","M",61,45,106
"11757","Javier","M",1695,1624,3319
"11758","Javin","M",58,36,94
"11759","Javion","M",241,261,502
"11760","Javis","M",12,8,20
"11761","Javon","M",259,215,474
"11762","Javoni","M",13,7,20
"11763","Javonna","F",7,8,15
"11764","Javonni","M",24,15,39
"11765","Javonta","M",8,5,13
"11766","Javontae","M",35,25,60
"11767","Javontay","M",5,6,11
"11768","Javonte","M",45,49,94
"11769","Javyn","M",6,8,14
"11770","Jawad","M",53,60,113
"11771","Jawan","M",6,7,13
"11772","Jax","F",38,21,59
"11773","Jax","M",1858,1797,3655
"11774","Jaxan","M",12,10,22
"11775","Jaxden","M",8,9,17
"11776","Jaxel","M",7,5,12
"11777","Jaxen","M",395,338,733
"11778","Jaxi","F",8,8,16
"11779","Jaxie","F",24,11,35
"11780","Jaxiel","M",29,27,56
"11781","Jaxin","M",79,56,135
"11782","Jaxn","M",5,6,11
"11783","Jaxon","F",22,20,42
"11784","Jaxon","M",8045,8054,16099
"11785","Jaxsen","M",127,118,245
"11786","Jaxsin","M",28,19,47
"11787","Jaxson","F",10,10,20
"11788","Jaxson","M",5044,4868,9912
"11789","Jaxsten","M",5,9,14
"11790","Jaxstin","M",9,6,15
"11791","Jaxston","M",83,69,152
"11792","Jaxstyn","M",7,7,14
"11793","Jaxsun","M",8,10,18
"11794","Jaxsyn","F",14,15,29
"11795","Jaxsyn","M",76,72,148
"11796","Jaxten","M",48,42,90
"11797","Jaxtin","M",30,30,60
"11798","Jaxton","M",755,790,1545
"11799","Jaxtyn","M",40,43,83
"11800","Jaxx","F",9,6,15
"11801","Jaxx","M",179,185,364
"11802","Jaxxen","M",9,16,25
"11803","Jaxxon","M",173,185,358
"11804","Jaxxson","M",15,18,33
"11805","Jaxxton","M",8,5,13
"11806","Jaxxyn","M",5,8,13
"11807","Jaxyn","F",24,26,50
"11808","Jaxyn","M",93,107,200
"11809","Jaxzen","M",13,10,23
"11810","Jaxzon","M",15,7,22
"11811","Jay","F",8,6,14
"11812","Jay","M",797,800,1597
"11813","Jaya","F",131,109,240
"11814","Jayah","F",25,27,52
"11815","Jayan","M",23,30,53
"11816","Jayana","F",42,49,91
"11817","Jayani","F",32,17,49
"11818","Jayanna","F",39,31,70
"11819","Jayanth","M",5,6,11
"11820","Jayce","F",64,89,153
"11821","Jayce","M",3113,2954,6067
"11822","Jaycean","M",8,6,14
"11823","Jaycee","F",440,396,836
"11824","Jaycee","M",53,67,120
"11825","Jayceion","M",47,37,84
"11826","Jaycelyn","F",9,17,26
"11827","Jaycelynn","F",5,11,16
"11828","Jaycen","M",61,63,124
"11829","Jayceon","F",12,7,19
"11830","Jayceon","M",1371,1461,2832
"11831","Jayceona","F",10,8,18
"11832","Jayci","F",53,43,96
"11833","Jaycie","F",102,114,216
"11834","Jaycieon","M",5,7,12
"11835","Jaycion","M",83,101,184
"11836","Jayco","M",5,5,10
"11837","Jaycob","M",186,166,352
"11838","Jayd","F",5,7,12
"11839","Jayda","F",642,509,1151
"11840","Jaydah","F",62,54,116
"11841","Jaydan","F",13,5,18
"11842","Jaydan","M",125,130,255
"11843","Jayde","F",322,440,762
"11844","Jaydee","F",24,11,35
"11845","Jaydee","M",20,21,41
"11846","Jaydeen","M",22,18,40
"11847","Jaydelin","F",7,8,15
"11848","Jayden","F",437,389,826
"11849","Jayden","M",11518,10063,21581
"11850","Jaydence","F",12,13,25
"11851","Jaydence","M",10,13,23
"11852","Jaydenn","M",22,16,38
"11853","Jaydian","M",11,9,20
"11854","Jaydien","M",5,9,14
"11855","Jaydin","F",15,16,31
"11856","Jaydin","M",80,75,155
"11857","Jaydn","M",10,10,20
"11858","Jaydon","M",203,195,398
"11859","Jaydrian","M",17,9,26
"11860","Jaydy","F",5,6,11
"11861","Jaydyn","F",14,11,25
"11862","Jaydyn","M",48,36,84
"11863","Jaye","F",14,22,36
"11864","Jaye","M",15,9,24
"11865","Jayel","F",7,5,12
"11866","Jayelle","F",10,8,18
"11867","Jayen","M",12,7,19
"11868","Jayke","M",14,6,20
"11869","Jayko","M",18,24,42
"11870","Jaykob","M",30,28,58
"11871","Jayla","F",1382,1377,2759
"11872","Jaylaa","F",8,13,21
"11873","Jaylah","F",664,543,1207
"11874","Jaylan","F",17,13,30
"11875","Jaylan","M",69,65,134
"11876","Jaylani","F",114,106,220
"11877","Jaylanie","F",47,46,93
"11878","Jaylea","F",10,5,15
"11879","Jayleah","F",16,10,26
"11880","Jaylean","F",18,11,29
"11881","Jaylee","F",375,353,728
"11882","Jaylee","M",5,7,12
"11883","Jayleen","F",750,716,1466
"11884","Jayleene","F",10,8,18
"11885","Jaylei","F",11,11,22
"11886","Jayleigh","F",76,78,154
"11887","Jaylen","F",147,160,307
"11888","Jaylen","M",994,888,1882
"11889","Jaylena","F",8,5,13
"11890","Jaylene","F",400,382,782
"11891","Jaylenn","F",11,5,16
"11892","Jaylenn","M",7,5,12
"11893","Jaylenne","F",19,13,32
"11894","Jayleon","M",5,7,12
"11895","Jayley","F",15,16,31
"11896","Jayli","F",30,27,57
"11897","Jaylia","F",10,11,21
"11898","Jayliah","F",24,15,39
"11899","Jayliana","F",40,38,78
"11900","Jayliani","F",9,6,15
"11901","Jaylianie","F",8,9,17
"11902","Jaylianis","F",5,7,12
"11903","Jaylianna","F",22,16,38
"11904","Jaylie","F",45,38,83
"11905","Jaylin","F",288,244,532
"11906","Jaylin","M",170,142,312
"11907","Jaylina","F",12,12,24
"11908","Jayline","F",42,55,97
"11909","Jaylinn","F",43,23,66
"11910","Jaylinne","F",5,9,14
"11911","Jaylissa","F",6,5,11
"11912","Jayln","M",8,5,13
"11913","Jaylon","M",166,157,323
"11914","Jaylyn","F",164,157,321
"11915","Jaylyn","M",28,28,56
"11916","Jaylyne","F",5,5,10
"11917","Jaylynn","F",390,322,712
"11918","Jaylynn","M",20,9,29
"11919","Jaylynne","F",11,11,22
"11920","Jaymar","M",19,21,40
"11921","Jaymarie","F",13,10,23
"11922","Jaymason","M",6,9,15
"11923","Jayme","F",58,75,133
"11924","Jayme","M",20,26,46
"11925","Jaymee","F",43,36,79
"11926","Jaymen","M",7,5,12
"11927","Jaymere","M",8,6,14
"11928","Jaymes","M",41,40,81
"11929","Jaymeson","M",37,35,72
"11930","Jaymi","F",12,12,24
"11931","Jaymian","M",11,7,18
"11932","Jaymie","F",58,37,95
"11933","Jaymie","M",7,6,13
"11934","Jaymin","M",16,14,30
"11935","Jaymir","M",9,10,19
"11936","Jaymison","M",18,12,30
"11937","Jaymon","M",9,8,17
"11938","Jaymz","M",11,7,18
"11939","Jayna","F",75,80,155
"11940","Jayne","F",81,90,171
"11941","Jaynee","F",24,12,36
"11942","Jaynie","F",19,20,39
"11943","Jayon","M",32,26,58
"11944","Jayonna","F",34,32,66
"11945","Jayquan","M",32,20,52
"11946","Jayr","M",5,6,11
"11947","Jayren","M",37,30,67
"11948","Jayro","M",10,6,16
"11949","Jayron","M",13,18,31
"11950","Jaysa","F",15,13,28
"11951","Jayse","M",158,141,299
"11952","Jaysean","M",20,15,35
"11953","Jaysen","M",97,79,176
"11954","Jayseon","M",5,10,15
"11955","Jayshaun","M",15,12,27
"11956","Jayshawn","M",34,51,85
"11957","Jayshon","M",16,19,35
"11958","Jaysiah","M",10,15,25
"11959","Jaysie","F",10,6,16
"11960","Jaysin","M",12,7,19
"11961","Jayson","M",760,633,1393
"11962","Jaysten","M",5,5,10
"11963","Jayston","M",10,16,26
"11964","Jaythan","M",38,45,83
"11965","Jayton","M",35,29,64
"11966","Jayvan","M",10,5,15
"11967","Jayven","M",129,103,232
"11968","Jayveon","M",76,54,130
"11969","Jayvian","M",53,69,122
"11970","Jayvien","M",39,43,82
"11971","Jayvier","M",10,17,27
"11972","Jayvin","M",41,40,81
"11973","Jayvion","M",204,184,388
"11974","Jayvon","M",98,72,170
"11975","Jayvyn","M",10,14,24
"11976","Jayzen","M",15,9,24
"11977","Jayzon","M",6,7,13
"11978","Jazae","F",5,7,12
"11979","Jazael","M",8,7,15
"11980","Jazalyn","F",14,8,22
"11981","Jazalynn","F",11,9,20
"11982","Jazara","F",6,22,28
"11983","Jazarah","F",7,13,20
"11984","Jazaria","F",27,25,52
"11985","Jazariah","F",23,25,48
"11986","Jaze","M",12,6,18
"11987","Jazel","F",28,30,58
"11988","Jazell","F",24,13,37
"11989","Jazelle","F",169,167,336
"11990","Jazelyn","F",6,9,15
"11991","Jazhiel","M",9,9,18
"11992","Jaziah","F",50,43,93
"11993","Jaziah","M",74,61,135
"11994","Jaziel","M",223,276,499
"11995","Jazier","M",7,9,16
"11996","Jazilyn","F",15,6,21
"11997","Jazion","M",13,14,27
"11998","Jazira","F",6,5,11
"11999","Jaziya","F",18,11,29
"12000","Jaziyah","F",57,50,107
"12001","Jaziyah","M",7,7,14
"12002","Jazleen","F",65,55,120
"12003","Jazlene","F",38,39,77
"12004","Jazlin","F",24,37,61
"12005","Jazline","F",8,9,17
"12006","Jazlyn","F",626,599,1225
"12007","Jazlyne","F",17,16,33
"12008","Jazlynn","F",367,346,713
"12009","Jazlynne","F",7,10,17
"12010","Jazmarie","F",14,13,27
"12011","Jazmin","F",729,705,1434
"12012","Jazmine","F",700,578,1278
"12013","Jazmyn","F",175,181,356
"12014","Jazmyne","F",82,51,133
"12015","Jazmynn","F",13,16,29
"12016","Jazon","M",11,8,19
"12017","Jazper","M",14,13,27
"12018","Jazyiah","F",7,11,18
"12019","Jazz","F",14,18,32
"12020","Jazz","M",15,14,29
"12021","Jazzalyn","F",15,8,23
"12022","Jazzalynn","F",7,7,14
"12023","Jazzelle","F",10,9,19
"12024","Jazzlene","F",5,5,10
"12025","Jazzlin","F",9,7,16
"12026","Jazzlyn","F",168,155,323
"12027","Jazzlyne","F",6,6,12
"12028","Jazzlynn","F",84,79,163
"12029","Jazzmin","F",21,21,42
"12030","Jazzmine","F",21,28,49
"12031","Jazzmyn","F",18,20,38
"12032","Jazzmyne","F",6,5,11
"12033","Jazzy","F",5,7,12
"12034","Jb","M",8,6,14
"12035","Jc","M",27,22,49
"12036","Jceon","M",27,19,46
"12037","Jcion","M",8,9,17
"12038","Jd","M",11,21,32
"12039","Jden","M",12,6,18
"12040","Jean","F",67,75,142
"12041","Jean","M",154,182,336
"12042","Jeana","F",20,14,34
"12043","Jeancarlo","M",33,17,50
"12044","Jeancarlos","M",63,50,113
"12045","Jeanelle","F",22,19,41
"12046","Jeanette","F",97,77,174
"12047","Jeanie","F",13,11,24
"12048","Jeanine","F",17,27,44
"12049","Jeanluc","M",20,24,44
"12050","Jeanna","F",25,23,48
"12051","Jeanne","F",40,36,76
"12052","Jeannette","F",37,32,69
"12053","Jeannie","F",24,30,54
"12054","Jeannine","F",5,9,14
"12055","Jeanpaul","M",21,15,36
"12056","Jeanpierre","M",21,14,35
"12057","Jeb","M",37,23,60
"12058","Jebediah","M",27,29,56
"12059","Jed","M",76,64,140
"12060","Jedadiah","M",7,5,12
"12061","Jedaiah","M",13,15,28
"12062","Jedd","M",17,11,28
"12063","Jedediah","M",60,63,123
"12064","Jedi","M",13,32,45
"12065","Jediah","M",27,47,74
"12066","Jedidiah","F",5,5,10
"12067","Jedidiah","M",343,319,662
"12068","Jedrek","M",5,14,19
"12069","Jeet","M",11,6,17
"12070","Jeevan","M",24,19,43
"12071","Jeferson","M",15,14,29
"12072","Jeff","M",72,58,130
"12073","Jefferson","M",378,428,806
"12074","Jeffery","M",303,310,613
"12075","Jeffrey","M",1257,1163,2420
"12076","Jeffry","M",38,33,71
"12077","Jefry","M",10,8,18
"12078","Jehan","F",5,9,14
"12079","Jehan","M",8,6,14
"12080","Jehiel","M",9,5,14
"12081","Jehieli","F",16,7,23
"12082","Jehu","M",33,22,55
"12083","Jeidy","F",8,5,13
"12084","Jeilani","F",12,5,17
"12085","Jeilany","F",6,7,13
"12086","Jeily","F",5,22,27
"12087","Jeilyn","F",22,17,39
"12088","Jeimy","F",32,43,75
"12089","Jeiren","M",6,7,13
"12090","Jeison","M",29,22,51
"12091","Jekhi","M",8,8,16
"12092","Jelani","F",16,22,38
"12093","Jelani","M",88,99,187
"12094","Jeleah","F",6,5,11
"12095","Jelena","F",49,58,107
"12096","Jelina","F",9,8,17
"12097","Jelissa","F",10,11,21
"12098","Jeliyah","F",9,6,15
"12099","Jema","F",15,21,36
"12100","Jemar","M",7,7,14
"12101","Jemari","M",14,8,22
"12102","Jemarion","M",6,5,11
"12103","Jemiah","F",6,8,14
"12104","Jemima","F",35,44,79
"12105","Jemimah","F",31,29,60
"12106","Jemina","F",6,5,11
"12107","Jemma","F",409,487,896
"12108","Jemuel","M",8,5,13
"12109","Jena","F",53,34,87
"12110","Jenae","F",24,21,45
"12111","Jenai","F",23,11,34
"12112","Jenalise","F",5,7,12
"12113","Jenan","F",8,12,20
"12114","Jenaro","M",9,6,15
"12115","Jenasis","F",20,21,41
"12116","Jenavee","F",9,5,14
"12117","Jenavie","F",11,13,24
"12118","Jenavieve","F",39,47,86
"12119","Jenaya","F",16,15,31
"12120","Jenayah","F",8,5,13
"12121","Jencarlo","M",15,7,22
"12122","Jencarlos","M",89,72,161
"12123","Jenelle","F",90,74,164
"12124","Jenelly","F",5,5,10
"12125","Jenesis","F",222,234,456
"12126","Jenesis","M",9,11,20
"12127","Jenessa","F",59,52,111
"12128","Jenesys","F",14,8,22
"12129","Jeneva","F",11,19,30
"12130","Jenevie","F",9,6,15
"12131","Jenevieve","F",69,72,141
"12132","Jeniah","F",17,15,32
"12133","Jenica","F",20,19,39
"12134","Jenicka","F",26,11,37
"12135","Jeniel","M",12,9,21
"12136","Jenifer","F",31,22,53
"12137","Jeniffer","F",7,8,15
"12138","Jenika","F",23,18,41
"12139","Jenine","F",8,9,17
"12140","Jenise","F",13,11,24
"12141","Jenisha","F",8,10,18
"12142","Jenisis","F",8,16,24
"12143","Jeniveve","F",5,5,10
"12144","Jeniya","F",15,8,23
"12145","Jeniyah","F",16,25,41
"12146","Jenkins","M",6,6,12
"12147","Jenna","F",1080,883,1963
"12148","Jennabelle","F",5,6,11
"12149","Jennah","F",87,76,163
"12150","Jennalee","F",12,11,23
"12151","Jennalyn","F",12,10,22
"12152","Jennalynn","F",9,5,14
"12153","Jennavecia","F",7,6,13
"12154","Jennavie","F",11,12,23
"12155","Jennavieve","F",22,23,45
"12156","Jennelle","F",13,6,19
"12157","Jennesis","F",8,8,16
"12158","Jennessa","F",14,19,33
"12159","Jennessy","F",7,9,16
"12160","Jenni","F",46,26,72
"12161","Jennica","F",22,21,43
"12162","Jennie","F",74,48,122
"12163","Jennifer","F",1281,1153,2434
"12164","Jennika","F",17,10,27
"12165","Jennings","F",19,14,33
"12166","Jennings","M",44,62,106
"12167","Jenny","F",279,234,513
"12168","Jennyfer","F",22,14,36
"12169","Jenova","F",11,11,22
"12170","Jens","M",17,24,41
"12171","Jensen","F",75,52,127
"12172","Jensen","M",788,899,1687
"12173","Jenson","M",133,158,291
"12174","Jensyn","F",23,46,69
"12175","Jensyn","M",10,20,30
"12176","Jentri","F",16,13,29
"12177","Jentrie","F",7,7,14
"12178","Jentry","F",41,51,92
"12179","Jentry","M",31,12,43
"12180","Jentzen","M",12,5,17
"12181","Jenziel","M",6,6,12
"12182","Jeorge","M",8,6,14
"12183","Jeorgia","F",11,6,17
"12184","Jeovani","M",10,11,21
"12185","Jeovanni","M",14,12,26
"12186","Jeovanny","M",9,7,16
"12187","Jeovany","M",10,9,19
"12188","Jep","M",9,13,22
"12189","Jephthah","M",6,6,12
"12190","Jepson","M",6,8,14
"12191","Jera","F",7,5,12
"12192","Jerad","M",8,5,13
"12193","Jerald","M",34,35,69
"12194","Jeraldine","F",11,6,17
"12195","Jerami","M",6,7,13
"12196","Jeramiah","M",86,87,173
"12197","Jeramie","M",17,13,30
"12198","Jeramy","M",21,9,30
"12199","Jeramyah","M",9,9,18
"12200","Jeran","M",5,5,10
"12201","Jerard","M",8,6,14
"12202","Jerardo","M",8,5,13
"12203","Jered","M",8,6,14
"12204","Jerek","M",11,6,17
"12205","Jerel","M",21,16,37
"12206","Jerell","M",16,20,36
"12207","Jerelyn","F",8,12,20
"12208","Jeremaih","M",13,8,21
"12209","Jereme","M",6,6,12
"12210","Jeremey","M",8,8,16
"12211","Jeremi","M",23,22,45
"12212","Jeremia","M",9,9,18
"12213","Jeremiah","F",9,5,14
"12214","Jeremiah","M",6760,6546,13306
"12215","Jeremias","M",169,204,373
"12216","Jeremie","M",20,27,47
"12217","Jeremih","M",123,121,244
"12218","Jeremiyah","M",10,15,25
"12219","Jeremy","M",2385,2119,4504
"12220","Jeremyah","M",45,23,68
"12221","Jerett","M",6,6,12
"12222","Jeri","F",9,9,18
"12223","Jeriah","F",13,18,31
"12224","Jeriah","M",57,61,118
"12225","Jerian","M",7,12,19
"12226","Jeric","M",7,10,17
"12227","Jerica","F",13,16,29
"12228","Jericho","M",200,226,426
"12229","Jerick","M",28,25,53
"12230","Jericka","F",8,5,13
"12231","Jerico","M",20,8,28
"12232","Jeriel","M",49,45,94
"12233","Jerik","M",8,7,15
"12234","Jerika","F",13,7,20
"12235","Jeriko","M",8,8,16
"12236","Jerilyn","F",21,8,29
"12237","Jerimiah","M",94,97,191
"12238","Jerimyah","M",11,13,24
"12239","Jeriyah","F",12,18,30
"12240","Jermain","M",17,13,30
"12241","Jermaine","M",312,267,579
"12242","Jerman","M",6,7,13
"12243","Jermani","F",30,42,72
"12244","Jermany","F",13,19,32
"12245","Jermari","M",14,11,25
"12246","Jermarion","M",9,7,16
"12247","Jermel","M",15,8,23
"12248","Jermia","F",7,7,14
"12249","Jermiah","F",5,5,10
"12250","Jermiah","M",67,44,111
"12251","Jermichael","M",6,5,11
"12252","Jermir","M",6,6,12
"12253","Jermiyah","F",7,15,22
"12254","Jernee","F",9,17,26
"12255","Jernei","F",5,5,10
"12256","Jerney","F",12,6,18
"12257","Jerni","F",7,7,14
"12258","Jernie","F",6,8,14
"12259","Jerod","M",10,7,17
"12260","Jerold","M",5,6,11
"12261","Jerome","M",268,268,536
"12262","Jeromy","M",18,9,27
"12263","Jeron","M",25,15,40
"12264","Jeronimo","M",64,70,134
"12265","Jerran","M",6,5,11
"12266","Jerrel","M",9,9,18
"12267","Jerrell","M",49,41,90
"12268","Jerren","M",7,12,19
"12269","Jerrett","M",13,9,22
"12270","Jerri","F",9,13,22
"12271","Jerriah","F",5,7,12
"12272","Jerric","M",7,7,14
"12273","Jerrica","F",25,27,52
"12274","Jerrick","M",55,38,93
"12275","Jerrik","M",6,10,16
"12276","Jerrin","M",5,6,11
"12277","Jerrion","M",13,8,21
"12278","Jerriyah","F",6,9,15
"12279","Jerrod","M",41,30,71
"12280","Jerron","M",21,22,43
"12281","Jerry","M",595,589,1184
"12282","Jersee","F",8,7,15
"12283","Jersei","F",5,7,12
"12284","Jersey","F",145,132,277
"12285","Jersey","M",9,10,19
"12286","Jersi","F",7,19,26
"12287","Jersiah","M",5,6,11
"12288","Jersie","F",17,21,38
"12289","Jerson","M",32,30,62
"12290","Jerusalem","F",10,15,25
"12291","Jerusalem","M",6,5,11
"12292","Jerusha","F",9,10,19
"12293","Jeryl","M",6,6,12
"12294","Jeryn","M",5,5,10
"12295","Jerzee","F",26,29,55
"12296","Jerzey","F",25,11,36
"12297","Jerzi","F",18,17,35
"12298","Jerzie","F",24,15,39
"12299","Jerzy","F",5,8,13
"12300","Jerzy","M",10,5,15
"12301","Jesaiah","M",11,15,26
"12302","Jesalyn","F",9,8,17
"12303","Jese","M",24,19,43
"12304","Jeselle","F",12,6,18
"12305","Jesenia","F",33,31,64
"12306","Jeshia","F",14,7,21
"12307","Jeshua","M",60,75,135
"12308","Jesiah","F",69,65,134
"12309","Jesiah","M",173,184,357
"12310","Jeslin","F",6,5,11
"12311","Jesly","F",9,5,14
"12312","Jeslyn","F",41,55,96
"12313","Jeslynn","F",14,15,29
"12314","Jesper","M",12,6,18
"12315","Jess","M",34,30,64
"12316","Jessa","F",569,429,998
"12317","Jessabella","F",6,5,11
"12318","Jessabelle","F",19,17,36
"12319","Jessah","F",8,13,21
"12320","Jessalyn","F",114,100,214
"12321","Jessalynn","F",40,46,86
"12322","Jessamine","F",14,11,25
"12323","Jesse","F",64,65,129
"12324","Jesse","M",2337,2281,4618
"12325","Jessee","M",8,7,15
"12326","Jessejames","M",11,16,27
"12327","Jesselle","F",13,10,23
"12328","Jessen","M",14,9,23
"12329","Jessenia","F",35,49,84
"12330","Jessi","F",61,68,129
"12331","Jessi","M",9,9,18
"12332","Jessia","F",36,22,58
"12333","Jessiah","F",27,27,54
"12334","Jessiah","M",115,97,212
"12335","Jessica","F",1582,1375,2957
"12336","Jessie","F",468,456,924
"12337","Jessie","M",233,243,476
"12338","Jessiel","M",5,6,11
"12339","Jessika","F",26,17,43
"12340","Jessilyn","F",10,9,19
"12341","Jessly","F",5,5,10
"12342","Jesslyn","F",72,92,164
"12343","Jesslynn","F",40,30,70
"12344","Jessup","M",12,8,20
"12345","Jessy","F",35,33,68
"12346","Jessy","M",34,27,61
"12347","Jestin","M",16,8,24
"12348","Jesus","F",10,8,18
"12349","Jesus","M",3173,3065,6238
"12350","Jet","F",7,7,14
"12351","Jet","M",148,147,295
"12352","Jeter","M",69,32,101
"12353","Jethro","M",112,134,246
"12354","Jetson","M",26,29,55
"12355","Jett","F",44,32,76
"12356","Jett","M",1044,1106,2150
"12357","Jetta","F",37,28,65
"12358","Jette","F",8,6,14
"12359","Jettie","F",10,6,16
"12360","Jettson","M",23,19,42
"12361","Jevaeh","F",5,5,10
"12362","Jevin","M",13,19,32
"12363","Jevon","M",42,34,76
"12364","Jewel","F",311,295,606
"12365","Jewel","M",10,14,24
"12366","Jewelia","F",9,6,15
"12367","Jeweliana","F",13,8,21
"12368","Jewell","F",39,37,76
"12369","Jewell","M",6,10,16
"12370","Jewels","F",57,39,96
"12371","Jewelz","F",28,32,60
"12372","Jex","M",10,7,17
"12373","Jexiel","M",7,6,13
"12374","Jeycob","M",6,8,14
"12375","Jeyda","F",6,5,11
"12376","Jeydan","M",10,10,20
"12377","Jeyden","M",41,35,76
"12378","Jeydon","M",8,8,16
"12379","Jeyla","F",5,6,11
"12380","Jeylah","F",5,6,11
"12381","Jeylin","F",23,17,40
"12382","Jeyren","M",13,10,23
"12383","Jeyson","M",20,26,46
"12384","Jezabel","F",19,24,43
"12385","Jezabelle","F",11,8,19
"12386","Jezebel","F",24,26,50
"12387","Jezel","F",6,5,11
"12388","Jezelle","F",18,12,30
"12389","Jeziah","M",24,29,53
"12390","Jeziel","M",20,9,29
"12391","Jezreel","M",22,18,40
"12392","Jhace","M",19,12,31
"12393","Jhael","M",5,7,12
"12394","Jhair","M",6,5,11
"12395","Jhalil","M",12,16,28
"12396","Jhamari","M",7,5,12
"12397","Jhamir","M",9,11,20
"12398","Jhanae","F",9,5,14
"12399","Jhanvi","F",9,9,18
"12400","Jhase","M",52,33,85
"12401","Jhayce","M",7,5,12
"12402","Jhayden","M",13,10,23
"12403","Jhene","F",85,65,150
"12404","Jhenesis","F",9,6,15
"12405","Jheremy","M",5,7,12
"12406","Jhett","M",93,80,173
"12407","Jhoan","M",15,17,32
"12408","Jhoana","F",7,10,17
"12409","Jhoel","M",5,7,12
"12410","Jhon","M",30,21,51
"12411","Jhonatan","M",22,15,37
"12412","Jhonathan","M",15,12,27
"12413","Jhonny","M",49,34,83
"12414","Jhony","M",8,12,20
"12415","Jhoselyn","F",8,9,17
"12416","Jhostin","M",10,6,16
"12417","Jhournee","F",5,9,14
"12418","Jhourni","F",6,6,12
"12419","Jhovany","M",11,8,19
"12420","Jia","F",84,90,174
"12421","Jiah","F",6,11,17
"12422","Jiair","M",6,5,11
"12423","Jian","M",18,23,41
"12424","Jiana","F",34,30,64
"12425","Jianna","F",118,118,236
"12426","Jianni","M",10,12,22
"12427","Jiaqi","F",7,12,19
"12428","Jiayi","F",8,12,20
"12429","Jiayi","M",6,5,11
"12430","Jibran","M",13,15,28
"12431","Jibreel","M",37,46,83
"12432","Jibril","M",45,61,106
"12433","Jidenna","M",11,36,47
"12434","Jihad","M",28,18,46
"12435","Jihan","F",5,11,16
"12436","Jihan","M",5,5,10
"12437","Jiho","M",6,7,13
"12438","Jiles","M",5,7,12
"12439","Jill","F",36,31,67
"12440","Jillian","F",721,597,1318
"12441","Jilliana","F",9,11,20
"12442","Jilliann","F",5,6,11
"12443","Jillianne","F",8,5,13
"12444","Jim","M",42,42,84
"12445","Jimena","F",693,827,1520
"12446","Jimenna","F",5,10,15
"12447","Jimi","M",19,11,30
"12448","Jimma","F",9,14,23
"12449","Jimmie","M",71,69,140
"12450","Jimmy","M",486,515,1001
"12451","Jin","M",43,31,74
"12452","Jina","F",12,9,21
"12453","Jinan","F",6,8,14
"12454","Jinger","F",8,7,15
"12455","Jinora","F",10,11,21
"12456","Jionna","F",5,6,11
"12457","Jionni","M",149,99,248
"12458","Jiovani","M",27,20,47
"12459","Jiovanna","F",8,8,16
"12460","Jiovanni","M",90,90,180
"12461","Jiovanny","M",18,21,39
"12462","Jiovonni","M",8,6,14
"12463","Jirah","F",6,6,12
"12464","Jiraiya","M",45,59,104
"12465","Jireh","F",30,46,76
"12466","Jireh","M",35,30,65
"12467","Jiro","M",12,5,17
"12468","Jisele","F",15,9,24
"12469","Jiselle","F",135,114,249
"12470","Jissel","F",14,10,24
"12471","Jisselle","F",11,16,27
"12472","Jiwoo","F",5,6,11
"12473","Jiya","F",95,115,210
"12474","Jiyaan","M",11,16,27
"12475","Jiyah","F",8,10,18
"12476","Jizelle","F",38,43,81
"12477","Jj","M",21,25,46
"12478","Jleigh","F",7,7,14
"12479","Jlynn","F",27,30,57
"12480","Jmari","M",12,12,24
"12481","Jmarie","F",9,5,14
"12482","Jmir","M",6,5,11
"12483","Jniyah","F",12,6,18
"12484","Jo","F",27,34,61
"12485","Joab","M",33,30,63
"12486","Joachim","M",28,20,48
"12487","Joah","M",58,48,106
"12488","Joakim","M",12,12,24
"12489","Joan","F",99,112,211
"12490","Joan","M",169,187,356
"12491","Joana","F",78,73,151
"12492","Joandri","M",7,17,24
"12493","Joandry","M",7,18,25
"12494","Joandy","M",5,6,11
"12495","Joangel","M",10,6,16
"12496","Joanie","F",24,17,41
"12497","Joann","F",86,70,156
"12498","Joanna","F",1059,1263,2322
"12499","Joannah","F",12,5,17
"12500","Joanne","F",96,94,190
"12501","Joanny","F",7,6,13
"12502","Joao","M",41,51,92
"12503","Joaopedro","M",7,5,12
"12504","Joaquim","M",19,19,38
"12505","Joaquin","M",1077,990,2067
"12506","Joas","M",8,10,18
"12507","Joash","M",16,19,35
"12508","Job","M",87,79,166
"12509","Jobany","M",6,5,11
"12510","Jobe","M",16,20,36
"12511","Jocabed","F",6,13,19
"12512","Jocee","F",9,9,18
"12513","Jocelin","F",24,26,50
"12514","Joceline","F",14,11,25
"12515","Jocelyn","F",2447,2088,4535
"12516","Jocelyne","F",44,40,84
"12517","Jocelynn","F",269,217,486
"12518","Jocelynne","F",24,14,38
"12519","Jochebed","F",10,10,20
"12520","Jocie","F",13,12,25
"12521","Jocilyn","F",8,10,18
"12522","Joclyn","F",9,7,16
"12523","Joclynn","F",8,5,13
"12524","Jocsan","M",7,6,13
"12525","Jodeci","M",9,13,22
"12526","Jodee","F",7,8,15
"12527","Joden","M",6,7,13
"12528","Jodi","F",43,38,81
"12529","Jodie","F",31,45,76
"12530","Jody","F",18,20,38
"12531","Jody","M",57,48,105
"12532","Joe","M",457,431,888
"12533","Joeangel","M",9,10,19
"12534","Joei","F",9,10,19
"12535","Joel","F",5,10,15
"12536","Joel","M",2593,2410,5003
"12537","Joelene","F",8,8,16
"12538","Joelie","F",5,12,17
"12539","Joeliz","F",6,8,14
"12540","Joell","M",41,53,94
"12541","Joella","F",58,76,134
"12542","Joelle","F",243,361,604
"12543","Joelle","M",17,22,39
"12544","Joellie","F",5,5,10
"12545","Joelly","F",9,8,17
"12546","Joely","F",37,30,67
"12547","Joelyn","F",8,6,14
"12548","Joelynn","F",6,8,14
"12549","Joen","M",8,9,17
"12550","Joeseph","M",9,11,20
"12551","Joesiah","M",31,33,64
"12552","Joesph","M",25,28,53
"12553","Joey","F",95,152,247
"12554","Joey","M",314,354,668
"12555","Joeziah","M",11,7,18
"12556","Johaan","M",7,7,14
"12557","Johan","M",514,655,1169
"12558","Johana","F",106,110,216
"12559","Johanan","M",6,13,19
"12560","Johann","M",137,166,303
"12561","Johanna","F",576,560,1136
"12562","Johannah","F",74,52,126
"12563","Johannes","M",54,52,106
"12564","Johanny","F",10,12,22
"12565","Johansel","M",5,6,11
"12566","Johari","F",8,20,28
"12567","Johari","M",6,5,11
"12568","Johileny","F",7,5,12
"12569","John","F",11,12,23
"12570","John","M",10360,9952,20312
"12571","Johnae","F",18,13,31
"12572","Johnanthony","M",14,11,25
"12573","Johnathan","M",1153,1017,2170
"12574","Johnathen","M",14,9,23
"12575","Johnathon","M",169,142,311
"12576","Johncarlos","M",18,8,26
"12577","Johndaniel","M",5,8,13
"12578","Johndavid","M",33,27,60
"12579","Johnell","M",6,8,14
"12580","Johngabriel","M",5,5,10
"12581","Johnhenry","M",27,20,47
"12582","Johnie","M",10,8,18
"12583","Johnjoseph","M",5,5,10
"12584","Johnluke","M",44,39,83
"12585","Johnmark","M",15,10,25
"12586","Johnmatthew","M",7,6,13
"12587","Johnmichael","M",42,27,69
"12588","Johnna","F",40,27,67
"12589","Johnni","F",8,7,15
"12590","Johnnie","F",31,38,69
"12591","Johnnie","M",107,92,199
"12592","Johnny","F",7,11,18
"12593","Johnny","M",1146,1028,2174
"12594","Johnpatrick","M",8,5,13
"12595","Johnpaul","M",136,122,258
"12596","Johnrobert","M",6,6,12
"12597","Johnryan","M",6,6,12
"12598","Johnson","M",74,72,146
"12599","Johnston","M",10,10,20
"12600","Johnthomas","M",10,7,17
"12601","Johnwilliam","M",13,6,19
"12602","Johny","M",29,24,53
"12603","Joi","F",87,70,157
"12604","Joia","F",6,7,13
"12605","Joie","F",51,51,102
"12606","Jolan","M",9,10,19
"12607","Jolani","F",7,5,12
"12608","Joleah","F",7,10,17
"12609","Jolee","F",105,137,242
"12610","Joleen","F",36,38,74
"12611","Joleigh","F",43,58,101
"12612","Jolena","F",21,20,41
"12613","Jolene","F",382,540,922
"12614","Jolette","F",8,14,22
"12615","Joley","F",7,7,14
"12616","Joli","F",16,20,36
"12617","Jolie","F",372,430,802
"12618","Joliene","F",5,5,10
"12619","Joliet","F",6,5,11
"12620","Jolin","F",12,15,27
"12621","Jolina","F",33,29,62
"12622","Joline","F",10,11,21
"12623","Jolisa","F",11,12,23
"12624","Jolissa","F",11,10,21
"12625","Jolyn","F",9,10,19
"12626","Jolynn","F",44,28,72
"12627","Jomar","M",41,55,96
"12628","Jomari","M",21,11,32
"12629","Jon","M",330,354,684
"12630","Jona","F",16,6,22
"12631","Jona","M",13,16,29
"12632","Jonae","F",19,16,35
"12633","Jonael","M",232,125,357
"12634","Jonah","F",24,25,49
"12635","Jonah","M",2901,2749,5650
"12636","Jonan","M",14,10,24
"12637","Jonas","M",713,816,1529
"12638","Jonatan","M",68,50,118
"12639","Jonathan","F",11,16,27
"12640","Jonathan","M",7610,6914,14524
"12641","Jonathen","M",9,14,23
"12642","Jonathon","M",252,202,454
"12643","Jonathyn","M",5,9,14
"12644","Joncarlo","M",6,6,12
"12645","Jonelle","F",13,16,29
"12646","Jones","F",7,5,12
"12647","Jones","M",106,111,217
"12648","Joni","F",47,61,108
"12649","Joni","M",13,15,28
"12650","Joniah","F",9,5,14
"12651","Joniel","M",30,41,71
"12652","Jonier","F",5,7,12
"12653","Joniyah","F",14,9,23
"12654","Jonluke","M",7,5,12
"12655","Jonmichael","M",9,11,20
"12656","Jonna","F",15,17,32
"12657","Jonnae","F",7,6,13
"12658","Jonnathan","M",12,13,25
"12659","Jonni","F",11,8,19
"12660","Jonnie","F",21,15,36
"12661","Jonny","M",43,39,82
"12662","Jonovan","M",5,6,11
"12663","Jonpaul","M",11,11,22
"12664","Jontae","M",8,8,16
"12665","Jonte","M",19,18,37
"12666","Jony","M",6,7,13
"12667","Jood","F",20,20,40
"12668","Jood","M",8,13,21
"12669","Joon","M",11,12,23
"12670","Joory","F",10,13,23
"12671","Joplin","F",18,25,43
"12672","Joplyn","F",5,5,10
"12673","Jorah","M",13,11,24
"12674","Joram","M",7,12,19
"12675","Jordan","F",1212,1113,2325
"12676","Jordan","M",6272,5589,11861
"12677","Jordana","F",70,67,137
"12678","Jordann","F",9,6,15
"12679","Jordanna","F",15,10,25
"12680","Jordany","M",24,20,44
"12681","Jorden","F",22,15,37
"12682","Jorden","M",155,145,300
"12683","Jordi","F",16,12,28
"12684","Jordi","M",158,120,278
"12685","Jordie","F",8,11,19
"12686","Jordin","F",122,86,208
"12687","Jordin","M",60,52,112
"12688","Jordon","F",6,6,12
"12689","Jordon","M",98,82,180
"12690","Jordy","F",15,16,31
"12691","Jordy","M",253,241,494
"12692","Jordyn","F",2368,2092,4460
"12693","Jordyn","M",213,200,413
"12694","Jordynn","F",309,244,553
"12695","Jorel","M",30,24,54
"12696","Jorell","M",13,5,18
"12697","Joren","M",12,11,23
"12698","Jorge","M",1706,1717,3423
"12699","Jorgia","F",16,12,28
"12700","Jori","F",32,31,63
"12701","Jorian","M",15,13,28
"12702","Jorie","F",20,28,48
"12703","Joriel","M",14,5,19
"12704","Jorja","F",53,41,94
"12705","Jory","F",20,21,41
"12706","Jory","M",34,43,77
"12707","Josafat","M",7,12,19
"12708","Josaiah","M",16,16,32
"12709","Josalyn","F",50,44,94
"12710","Josalynn","F",36,21,57
"12711","Josaphine","F",10,10,20
"12712","Joscelyn","F",30,32,62
"12713","Jose","F",11,11,22
"12714","Jose","M",5157,5089,10246
"12715","Josean","M",13,16,29
"12716","Joseangel","M",33,39,72
"12717","Joseantonio","M",11,10,21
"12718","Josecarlos","M",14,6,20
"12719","Josedavid","M",6,6,12
"12720","Josedejesus","M",9,12,21
"12721","Josee","F",7,12,19
"12722","Josef","M",91,89,180
"12723","Josefa","F",6,10,16
"12724","Josefina","F",94,83,177
"12725","Josefine","F",16,17,33
"12726","Josejulian","M",7,8,15
"12727","Joselin","F",67,88,155
"12728","Joseline","F",65,64,129
"12729","Joselle","F",5,6,11
"12730","Joseluis","M",71,61,132
"12731","Joselyn","F",414,385,799
"12732","Joselyne","F",21,18,39
"12733","Joselynn","F",43,53,96
"12734","Josemanuel","M",24,33,57
"12735","Josemaria","M",28,17,45
"12736","Josemiguel","M",12,19,31
"12737","Joseph","F",11,12,23
"12738","Joseph","M",11441,10823,22264
"12739","Josephina","F",88,114,202
"12740","Josephine","F",2495,2766,5261
"12741","Joseth","M",5,6,11
"12742","Josette","F",64,57,121
"12743","Josey","F",76,77,153
"12744","Josey","M",12,17,29
"12745","Josh","M",122,108,230
"12746","Joshawn","M",5,5,10
"12747","Joshlyn","F",29,18,47
"12748","Joshlynn","F",29,34,63
"12749","Joshua","F",17,18,35
"12750","Joshua","M",9767,9138,18905
"12751","Joshuah","M",28,19,47
"12752","Joshuan","M",10,12,22
"12753","Joshue","M",7,10,17
"12754","Josi","F",20,17,37
"12755","Josiah","F",15,13,28
"12756","Josiah","M",6637,6928,13565
"12757","Josian","M",12,11,23
"12758","Josias","M",147,135,282
"12759","Josie","F",1284,1352,2636
"12760","Josie","M",6,5,11
"12761","Josiel","M",30,25,55
"12762","Josilyn","F",28,36,64
"12763","Josiya","M",6,6,12
"12764","Josiyah","M",30,48,78
"12765","Joslin","F",31,28,59
"12766","Joslyn","F",321,279,600
"12767","Joslynn","F",118,98,216
"12768","Josmar","M",20,19,39
"12769","Joss","F",20,17,37
"12770","Joss","M",15,16,31
"12771","Jossalyn","F",9,15,24
"12772","Josselin","F",21,25,46
"12773","Josseline","F",17,17,34
"12774","Josselyn","F",100,103,203
"12775","Jossiah","M",11,28,39
"12776","Jossie","F",7,8,15
"12777","Josslyn","F",119,125,244
"12778","Josslynn","F",25,22,47
"12779","Jossue","M",9,10,19
"12780","Jostin","M",28,13,41
"12781","Josue","M",1345,1348,2693
"12782","Josuel","M",6,7,13
"12783","Josyah","M",27,24,51
"12784","Josyiah","M",5,9,14
"12785","Jotham","M",26,29,55
"12786","Joud","F",21,24,45
"12787","Joud","M",29,22,51
"12788","Joules","F",5,9,14
"12789","Jourdan","F",14,21,35
"12790","Jourdan","M",31,28,59
"12791","Jourdyn","F",33,33,66
"12792","Jouri","F",8,7,15
"12793","Journe","F",11,12,23
"12794","Journee","F",865,986,1851
"12795","Journee","M",14,6,20
"12796","Journei","F",110,118,228
"12797","Journey","F",1149,1193,2342
"12798","Journey","M",68,100,168
"12799","Journi","F",161,193,354
"12800","Journie","F",127,140,267
"12801","Journiee","F",9,8,17
"12802","Journii","F",31,34,65
"12803","Joury","F",13,16,29
"12804","Jovan","M",162,138,300
"12805","Jovana","F",20,17,37
"12806","Jovani","M",214,191,405
"12807","Jovann","M",6,5,11
"12808","Jovanna","F",31,42,73
"12809","Jovanni","M",189,187,376
"12810","Jovanny","M",98,77,175
"12811","Jovany","M",70,57,127
"12812","Jove","M",6,7,13
"12813","Jovee","F",8,15,23
"12814","Joven","M",7,12,19
"12815","Jovey","F",9,5,14
"12816","Jovi","F",73,85,158
"12817","Jovi","M",15,15,30
"12818","Jovian","M",30,31,61
"12819","Jovie","F",194,210,404
"12820","Jovin","M",9,9,18
"12821","Jovita","F",7,6,13
"12822","Jovon","M",20,34,54
"12823","Jovonni","M",13,12,25
"12824","Jowel","M",5,9,14
"12825","Jowell","M",36,35,71
"12826","Joy","F",727,941,1668
"12827","Joy","M",12,10,22
"12828","Joya","F",21,24,45
"12829","Joyanna","F",38,21,59
"12830","Joyce","F",332,385,717
"12831","Joyce","M",8,5,13
"12832","Joycelyn","F",16,25,41
"12833","Joycelynn","F",10,13,23
"12834","Joye","F",6,7,13
"12835","Joyelle","F",13,9,22
"12836","Joylyn","F",7,7,14
"12837","Joylynn","F",8,10,18
"12838","Jozee","F",9,5,14
"12839","Jozef","M",28,20,48
"12840","Jozelyn","F",14,10,24
"12841","Jozeph","M",5,8,13
"12842","Jozey","F",10,6,16
"12843","Joziah","M",318,359,677
"12844","Jozie","F",53,38,91
"12845","Joziyah","M",11,6,17
"12846","Jozlyn","F",40,22,62
"12847","Jozlynn","F",24,13,37
"12848","Jozy","F",6,5,11
"12849","Jozyah","M",5,5,10
"12850","Jquan","M",6,7,13
"12851","Jr","M",29,29,58
"12852","Jream","F",12,19,31
"12853","Jream","M",5,6,11
"12854","Jrue","F",8,11,19
"12855","Jrue","M",40,40,80
"12856","Jshaun","M",5,7,12
"12857","Jshawn","M",13,10,23
"12858","Jsiah","M",10,12,22
"12859","Jt","M",7,8,15
"12860","Juan","M",3518,3331,6849
"12861","Juana","F",105,119,224
"12862","Juancarlos","M",75,68,143
"12863","Juandavid","M",9,5,14
"12864","Juandiego","M",22,19,41
"12865","Juanita","F",95,75,170
"12866","Juanito","M",17,14,31
"12867","Juanjose","M",22,13,35
"12868","Juanluis","M",7,8,15
"12869","Juanmanuel","M",24,13,37
"12870","Juanpablo","M",74,58,132
"12871","Juaquin","M",27,23,50
"12872","Jubal","M",15,18,33
"12873","Jubilee","F",229,223,452
"12874","Juda","M",15,9,24
"12875","Judah","F",30,28,58
"12876","Judah","M",1634,1648,3282
"12877","Judas","M",19,23,42
"12878","Judd","M",110,91,201
"12879","Juddson","M",13,6,19
"12880","Jude","F",138,117,255
"12881","Jude","M",2660,2492,5152
"12882","Judea","F",19,10,29
"12883","Judea","M",6,12,18
"12884","Juden","M",6,6,12
"12885","Judge","M",27,30,57
"12886","Judi","F",11,14,25
"12887","Judie","F",5,5,10
"12888","Judith","F",293,313,606
"12889","Judson","M",247,221,468
"12890","Judy","F",159,145,304
"12891","Juel","F",10,6,16
"12892","Juel","M",39,19,58
"12893","Juelz","F",12,13,25
"12894","Juelz","M",207,197,404
"12895","Juhi","F",7,5,12
"12896","Juleah","F",10,5,15
"12897","Julee","F",15,11,26
"12898","Julen","M",11,21,32
"12899","Jules","F",66,105,171
"12900","Jules","M",93,83,176
"12901","Julez","M",18,12,30
"12902","Juli","F",10,9,19
"12903","Julia","F",3369,3310,6679
"12904","Juliah","F",12,19,31
"12905","Julian","F",26,45,71
"12906","Julian","M",8029,8333,16362
"12907","Juliana","F",1901,1944,3845
"12908","Juliani","F",12,5,17
"12909","Juliann","F",25,28,53
"12910","Juliann","M",6,7,13
"12911","Julianna","F",1706,1597,3303
"12912","Juliannah","F",7,9,16
"12913","Julianne","F",308,298,606
"12914","Julianny","F",15,16,31
"12915","Juliano","M",26,26,52
"12916","Juliany","F",7,13,20
"12917","Juliauna","F",9,6,15
"12918","Julie","F",692,644,1336
"12919","Julieana","F",10,13,23
"12920","Julieann","F",19,19,38
"12921","Julieanna","F",23,28,51
"12922","Julieanne","F",14,10,24
"12923","Julien","M",425,431,856
"12924","Julienne","F",29,25,54
"12925","Juliet","F",1353,1391,2744
"12926","Julieta","F",348,468,816
"12927","Julieth","F",70,68,138
"12928","Juliett","F",43,40,83
"12929","Julietta","F",126,130,256
"12930","Juliette","F",1449,1646,3095
"12931","Julina","F",16,18,34
"12932","Julio","M",662,619,1281
"12933","Juliocesar","M",7,8,15
"12934","Julion","M",14,12,26
"12935","Julionna","F",10,5,15
"12936","Julious","M",9,9,18
"12937","Julisa","F",58,40,98
"12938","Julissa","F",563,502,1065
"12939","Julius","M",1139,1014,2153
"12940","Juliyah","F",7,5,12
"12941","Juliyana","F",5,6,11
"12942","Juliza","F",7,8,15
"12943","Jullian","F",5,7,12
"12944","Jullian","M",50,59,109
"12945","Julliana","F",11,7,18
"12946","Jullien","M",13,15,28
"12947","Julliette","F",5,8,13
"12948","July","F",26,22,48
"12949","July","M",11,13,24
"12950","Julyan","M",11,12,23
"12951","Julyana","F",6,8,14
"12952","Julyssa","F",22,15,37
"12953","Juman","F",7,6,13
"12954","Jumana","F",28,26,54
"12955","Jumanah","F",9,5,14
"12956","Jun","F",5,8,13
"12957","Jun","M",19,32,51
"12958","Juna","F",32,27,59
"12959","Junaid","M",9,5,14
"12960","Junayd","M",5,5,10
"12961","June","F",1131,1180,2311
"12962","June","M",16,16,32
"12963","Juneau","F",9,10,19
"12964","Juni","F",7,10,17
"12965","Junia","F",35,28,63
"12966","Junie","F",12,18,30
"12967","Juniel","M",18,6,24
"12968","Junior","M",270,284,554
"12969","Juniper","F",740,939,1679
"12970","Juniper","M",13,6,19
"12971","Junius","M",9,7,16
"12972","Juno","F",86,99,185
"12973","Juno","M",16,6,22
"12974","Jupiter","F",42,78,120
"12975","Jupiter","M",25,41,66
"12976","Jurgen","M",24,17,41
"12977","Juri","F",15,7,22
"12978","Jurnee","F",229,256,485
"12979","Jurnei","F",6,10,16
"12980","Jurney","F",11,7,18
"12981","Jurni","F",23,15,38
"12982","Jurnie","F",8,14,22
"12983","Jusiah","M",25,21,46
"12984","Justen","M",22,13,35
"12985","Justice","F",698,662,1360
"12986","Justice","M",547,595,1142
"12987","Justin","F",5,6,11
"12988","Justin","M",3704,3542,7246
"12989","Justina","F",66,62,128
"12990","Justine","F",102,101,203
"12991","Justine","M",5,5,10
"12992","Justino","M",13,9,22
"12993","Justis","F",6,12,18
"12994","Justis","M",20,24,44
"12995","Justise","F",7,7,14
"12996","Justise","M",9,7,16
"12997","Justo","M",10,5,15
"12998","Juston","M",13,7,20
"12999","Justus","F",25,19,44
"13000","Justus","M",260,232,492
"13001","Justyce","F",116,110,226
"13002","Justyce","M",24,26,50
"13003","Justyn","M",49,38,87
"13004","Justyne","F",5,5,10
"13005","Juvenal","M",15,9,24
"13006","Juventino","M",9,5,14
"13007","Juvia","F",15,17,32
"13008","Juwairiyah","F",5,6,11
"13009","Juwan","M",22,28,50
"13010","Juwon","M",6,11,17
"13011","Jvion","M",9,11,20
"13012","Jwan","F",5,6,11
"13013","Jyaire","M",22,18,40
"13014","Jye","M",7,10,17
"13015","Jymir","M",7,8,15
"13016","Jynesis","F",13,10,23
"13017","Kaaliyah","F",13,11,24
"13018","Kaan","M",37,38,75
"13019","Kaashvi","F",5,8,13
"13020","Kaavya","F",24,30,54
"13021","Kabeer","M",9,8,17
"13022","Kabella","F",17,6,23
"13023","Kabir","M",163,178,341
"13024","Kable","M",9,7,16
"13025","Kace","M",101,160,261
"13026","Kacee","F",23,34,57
"13027","Kacelynn","F",7,9,16
"13028","Kacen","M",95,74,169
"13029","Kaceon","M",5,11,16
"13030","Kaceton","M",17,9,26
"13031","Kacey","F",179,176,355
"13032","Kacey","M",22,30,52
"13033","Kache","M",8,9,17
"13034","Kaci","F",139,165,304
"13035","Kaci","M",7,5,12
"13036","Kacie","F",141,110,251
"13037","Kacin","M",5,7,12
"13038","Kacper","M",30,44,74
"13039","Kacy","F",40,40,80
"13040","Kacyn","M",8,13,21
"13041","Kadan","M",13,12,25
"13042","Kadance","F",22,14,36
"13043","Kadarius","M",22,18,40
"13044","Kade","F",14,11,25
"13045","Kade","M",829,771,1600
"13046","Kadee","F",10,13,23
"13047","Kadeem","M",28,30,58
"13048","Kaden","F",22,13,35
"13049","Kaden","M",2333,2017,4350
"13050","Kadence","F",531,410,941
"13051","Kadence","M",78,61,139
"13052","Kadi","F",11,8,19
"13053","Kadia","F",6,5,11
"13054","Kadiatou","F",22,18,40
"13055","Kadie","F",31,22,53
"13056","Kadien","M",7,8,15
"13057","Kadience","F",10,6,16
"13058","Kadija","F",16,23,39
"13059","Kadin","M",67,49,116
"13060","Kadir","M",13,21,34
"13061","Kadon","M",14,19,33
"13062","Kadrian","M",31,14,45
"13063","Kady","F",29,39,68
"13064","Kadyn","F",40,40,80
"13065","Kadyn","M",115,90,205
"13066","Kadynce","F",36,39,75
"13067","Kaedan","M",11,13,24
"13068","Kaede","F",7,11,18
"13069","Kaeden","M",213,184,397
"13070","Kaedence","F",31,39,70
"13071","Kaedin","M",18,10,28
"13072","Kaedon","M",13,16,29
"13073","Kaedyn","F",24,28,52
"13074","Kaedyn","M",78,67,145
"13075","Kaedynce","F",7,6,13
"13076","Kaegan","F",6,12,18
"13077","Kaegan","M",10,13,23
"13078","Kael","M",130,118,248
"13079","Kaela","F",32,45,77
"13080","Kaelah","F",10,12,22
"13081","Kaelan","F",14,7,21
"13082","Kaelan","M",41,24,65
"13083","Kaelani","F",42,61,103
"13084","Kaeleb","M",22,26,48
"13085","Kaelee","F",22,17,39
"13086","Kaeleigh","F",28,29,57
"13087","Kaelen","F",5,9,14
"13088","Kaelen","M",18,20,38
"13089","Kaeley","F",9,8,17
"13090","Kaeli","F",30,31,61
"13091","Kaelie","F",10,15,25
"13092","Kaelin","F",36,35,71
"13093","Kaelin","M",8,10,18
"13094","Kaelon","M",9,6,15
"13095","Kaelum","M",9,5,14
"13096","Kaely","F",39,30,69
"13097","Kaelyn","F",601,390,991
"13098","Kaelynn","F",288,221,509
"13099","Kaelynne","F",8,6,14
"13100","Kaemon","M",13,8,21
"13101","Kaena","F",6,7,13
"13102","Kaenan","M",11,9,20
"13103","Kaeo","M",14,11,25
"13104","Kaesen","M",22,15,37
"13105","Kaeson","M",50,62,112
"13106","Kaesyn","M",27,19,46
"13107","Kaeya","F",7,8,15
"13108","Kagan","M",12,14,26
"13109","Kage","M",67,63,130
"13110","Kagen","M",9,10,19
"13111","Kahaan","M",11,15,26
"13112","Kahari","M",18,20,38
"13113","Kahealani","F",10,9,19
"13114","Kaheem","M",9,6,15
"13115","Kahiau","M",10,12,22
"13116","Kahlan","F",74,56,130
"13117","Kahlani","F",25,55,80
"13118","Kahlea","F",6,15,21
"13119","Kahleah","F",9,7,16
"13120","Kahlee","F",6,5,11
"13121","Kahleesi","F",8,5,13
"13122","Kahli","F",26,15,41
"13123","Kahli","M",5,6,11
"13124","Kahlia","F",42,45,87
"13125","Kahlil","M",63,79,142
"13126","Kahliya","F",5,6,11
"13127","Kahliyah","F",8,14,22
"13128","Kahlyn","F",7,6,13
"13129","Kahmari","M",14,14,28
"13130","Kahmila","F",5,5,10
"13131","Kahmya","F",8,7,15
"13132","Kahne","M",5,11,16
"13133","Kai","F",309,315,624
"13134","Kai","M",2838,2862,5700
"13135","Kaia","F",702,879,1581
"13136","Kaiah","F",38,40,78
"13137","Kaian","M",6,12,18
"13138","Kaicen","M",12,20,32
"13139","Kaicyn","M",5,7,12
"13140","Kaid","M",12,15,27
"13141","Kaida","F",16,31,47
"13142","Kaidan","M",60,54,114
"13143","Kaidance","F",24,10,34
"13144","Kaide","M",11,15,26
"13145","Kaiden","F",65,55,120
"13146","Kaiden","M",3013,2870,5883
"13147","Kaidence","F",264,193,457
"13148","Kaidence","M",37,43,80
"13149","Kaidenn","M",6,5,11
"13150","Kaidin","M",12,16,28
"13151","Kaidon","M",32,17,49
"13152","Kaidyn","F",61,47,108
"13153","Kaidyn","M",154,155,309
"13154","Kaidynce","F",19,26,45
"13155","Kaiel","M",17,11,28
"13156","Kaielle","F",6,5,11
"13157","Kaien","M",5,14,19
"13158","Kaige","M",30,24,54
"13159","Kaii","M",6,6,12
"13160","Kaija","F",17,33,50
"13161","Kaikea","M",9,5,14
"13162","Kaikoa","M",6,13,19
"13163","Kail","M",19,10,29
"13164","Kaila","F",140,161,301
"13165","Kailah","F",64,39,103
"13166","Kailan","F",17,10,27
"13167","Kailan","M",18,15,33
"13168","Kailana","F",18,12,30
"13169","Kailand","M",14,9,23
"13170","Kailani","F",316,374,690
"13171","Kailany","F",8,14,22
"13172","Kailash","M",19,17,36
"13173","Kailaya","F",5,10,15
"13174","Kaile","F",8,5,13
"13175","Kailea","F",32,17,49
"13176","Kaileah","F",21,20,41
"13177","Kaileb","M",30,31,61
"13178","Kailee","F",344,301,645
"13179","Kaileen","F",11,8,19
"13180","Kailei","F",14,20,34
"13181","Kaileia","F",5,13,18
"13182","Kaileigh","F",77,56,133
"13183","Kailen","F",13,13,26
"13184","Kailen","M",22,36,58
"13185","Kailena","F",6,7,13
"13186","Kailer","M",29,27,56
"13187","Kailey","F",586,504,1090
"13188","Kaili","F",49,47,96
"13189","Kailia","F",11,11,22
"13190","Kailiana","F",7,12,19
"13191","Kailie","F",22,9,31
"13192","Kailin","F",21,20,41
"13193","Kailin","M",5,5,10
"13194","Kailiyah","F",6,6,12
"13195","Kailon","M",9,8,17
"13196","Kailoni","F",14,6,20
"13197","Kaily","F",69,67,136
"13198","Kailyn","F",435,353,788
"13199","Kailynn","F",223,182,405
"13200","Kailynne","F",10,6,16
"13201","Kaimana","M",33,40,73
"13202","Kaimani","M",10,10,20
"13203","Kain","M",124,179,303
"13204","Kainalu","M",18,15,33
"13205","Kainan","M",32,38,70
"13206","Kaine","M",125,159,284
"13207","Kainen","M",58,68,126
"13208","Kainoa","M",91,101,192
"13209","Kainon","M",11,13,24
"13210","Kaio","M",9,15,24
"13211","Kaion","M",5,22,27
"13212","Kaipo","M",6,6,12
"13213","Kaique","M",6,6,12
"13214","Kaira","F",91,102,193
"13215","Kairah","F",11,14,25
"13216","Kairav","M",16,17,33
"13217","Kairee","F",6,16,22
"13218","Kairee","M",11,11,22
"13219","Kairen","M",10,8,18
"13220","Kairi","F",365,347,712
"13221","Kairi","M",17,15,32
"13222","Kairie","F",6,6,12
"13223","Kairo","F",5,6,11
"13224","Kairo","M",81,152,233
"13225","Kairon","M",10,7,17
"13226","Kairos","M",28,15,43
"13227","Kairy","F",8,6,14
"13228","Kairyn","M",8,7,15
"13229","Kais","M",14,40,54
"13230","Kaisa","F",14,12,26
"13231","Kaisan","M",7,7,14
"13232","Kaisei","M",7,6,13
"13233","Kaisen","M",98,151,249
"13234","Kaiser","M",140,202,342
"13235","Kaisey","F",5,6,11
"13236","Kaislee","F",19,27,46
"13237","Kaisleigh","F",6,8,14
"13238","Kaisley","F",121,150,271
"13239","Kaislyn","F",10,10,20
"13240","Kaison","M",332,390,722
"13241","Kaiston","M",7,5,12
"13242","Kaisy","F",6,9,15
"13243","Kaisyn","F",15,12,27
"13244","Kaisyn","M",29,40,69
"13245","Kaithlyn","F",11,8,19
"13246","Kaitlin","F",177,78,255
"13247","Kaitlyn","F",1656,994,2650
"13248","Kaitlynn","F",270,169,439
"13249","Kaitlynne","F",8,5,13
"13250","Kaito","M",46,37,83
"13251","Kaity","F",8,5,13
"13252","Kaiulani","F",12,10,22
"13253","Kaius","M",108,114,222
"13254","Kaiven","M",8,8,16
"13255","Kaivon","M",7,17,24
"13256","Kaiya","F",312,290,602
"13257","Kaiyah","F",69,69,138
"13258","Kaiyan","M",11,14,25
"13259","Kaiyden","M",13,15,28
"13260","Kaiyu","M",7,5,12
"13261","Kaizen","M",56,51,107
"13262","Kaizer","M",49,64,113
"13263","Kaizlee","F",15,20,35
"13264","Kaizleigh","F",5,5,10
"13265","Kaizley","F",19,32,51
"13266","Kaj","M",15,10,25
"13267","Kaja","F",17,17,34
"13268","Kajsa","F",5,10,15
"13269","Kajuan","M",9,6,15
"13270","Kal","M",55,51,106
"13271","Kala","F",30,28,58
"13272","Kaladin","M",17,23,40
"13273","Kalai","M",7,9,16
"13274","Kalan","M",25,24,49
"13275","Kalana","F",8,14,22
"13276","Kalani","F",331,431,762
"13277","Kalani","M",57,77,134
"13278","Kalanie","F",8,11,19
"13279","Kalany","F",10,7,17
"13280","Kalaya","F",51,57,108
"13281","Kalayah","F",47,55,102
"13282","Kalaysia","F",9,15,24
"13283","Kale","M",175,100,275
"13284","Kalea","F",149,162,311
"13285","Kaleab","M",19,10,29
"13286","Kaleah","F",215,190,405
"13287","Kaleb","M",2519,2245,4764
"13288","Kaled","M",15,5,20
"13289","Kalee","F",28,29,57
"13290","Kaleeah","F",12,6,18
"13291","Kaleel","M",7,8,15
"13292","Kaleem","M",6,21,27
"13293","Kaleena","F",53,41,94
"13294","Kaleesi","F",30,28,58
"13295","Kaleeya","F",7,5,12
"13296","Kaleeyah","F",10,6,16
"13297","Kalei","F",32,34,66
"13298","Kalei","M",6,11,17
"13299","Kaleia","F",43,31,74
"13300","Kaleiah","F",11,15,26
"13301","Kaleigh","F",249,180,429
"13302","Kaleigha","F",56,54,110
"13303","Kaleiyah","F",11,7,18
"13304","Kalel","M",242,246,488
"13305","Kalem","M",29,28,57
"13306","Kalen","F",15,9,24
"13307","Kalen","M",65,66,131
"13308","Kalena","F",83,77,160
"13309","Kalenna","F",16,10,26
"13310","Kaleo","M",59,74,133
"13311","Kalese","F",11,6,17
"13312","Kaleth","M",11,15,26
"13313","Kalev","M",13,14,27
"13314","Kaley","F",199,181,380
"13315","Kaleya","F",13,13,26
"13316","Kaleyah","F",22,25,47
"13317","Kali","F",1183,1078,2261
"13318","Kali","M",30,34,64
"13319","Kalia","F",208,149,357
"13320","Kaliah","F",106,105,211
"13321","Kaliana","F",41,33,74
"13322","Kaliann","F",7,9,16
"13323","Kalianna","F",23,23,46
"13324","Kalianne","F",8,5,13
"13325","Kalib","M",32,32,64
"13326","Kalicia","F",6,5,11
"13327","Kalid","M",8,5,13
"13328","Kalie","F",58,38,96
"13329","Kaliegh","F",6,11,17
"13330","Kalii","F",15,10,25
"13331","Kalijah","M",9,10,19
"13332","Kalil","M",22,30,52
"13333","Kalila","F",42,43,85
"13334","Kalilah","F",19,14,33
"13335","Kalin","F",19,12,31
"13336","Kalin","M",26,33,59
"13337","Kalina","F",113,137,250
"13338","Kalinda","F",6,6,12
"13339","Kalino","M",5,6,11
"13340","Kaliope","F",8,13,21
"13341","Kaliq","M",12,8,20
"13342","Kalirose","F",5,6,11
"13343","Kalis","F",9,11,20
"13344","Kalisa","F",7,11,18
"13345","Kalise","F",47,35,82
"13346","Kalisha","F",7,5,12
"13347","Kalisi","F",12,5,17
"13348","Kalissa","F",29,28,57
"13349","Kalista","F",59,50,109
"13350","Kalix","M",17,11,28
"13351","Kaliya","F",31,38,69
"13352","Kaliyah","F",574,497,1071
"13353","Kalkidan","F",13,12,25
"13354","Kalla","F",8,8,16
"13355","Kallan","F",6,7,13
"13356","Kallan","M",37,26,63
"13357","Kallee","F",26,23,49
"13358","Kalleigh","F",29,33,62
"13359","Kallen","F",11,7,18
"13360","Kallen","M",146,138,284
"13361","Kalley","F",9,8,17
"13362","Kalli","F",101,90,191
"13363","Kallie","F",407,331,738
"13364","Kallin","M",7,11,18
"13365","Kalliope","F",65,62,127
"13366","Kalliopi","F",6,9,15
"13367","Kallista","F",22,25,47
"13368","Kallum","M",19,15,34
"13369","Kally","F",20,15,35
"13370","Kallyn","F",8,7,15
"13371","Kalman","M",19,18,37
"13372","Kalob","M",13,18,31
"13373","Kalon","M",13,13,26
"13374","Kaloni","F",24,23,47
"13375","Kalub","M",9,6,15
"13376","Kalum","M",17,15,32
"13377","Kalvin","M",167,156,323
"13378","Kaly","F",10,8,18
"13379","Kalyan","M",9,8,17
"13380","Kalyani","F",13,11,24
"13381","Kalyn","F",77,47,124
"13382","Kalyna","F",11,12,23
"13383","Kalynn","F",84,50,134
"13384","Kalypso","F",6,6,12
"13385","Kalyse","F",9,7,16
"13386","Kalyssa","F",19,19,38
"13387","Kalysta","F",10,10,20
"13388","Kam","M",50,57,107
"13389","Kamaal","M",5,11,16
"13390","Kamaiya","F",8,12,20
"13391","Kamal","M",50,51,101
"13392","Kamala","F",9,10,19
"13393","Kamalani","F",12,6,18
"13394","Kamalei","F",8,5,13
"13395","Kamani","F",30,44,74
"13396","Kamani","M",21,26,47
"13397","Kamar","M",37,37,74
"13398","Kamara","F",40,43,83
"13399","Kamarah","F",12,7,19
"13400","Kamaree","F",5,13,18
"13401","Kamaree","M",7,9,16
"13402","Kamari","F",156,193,349
"13403","Kamari","M",366,396,762
"13404","Kamaria","F",67,67,134
"13405","Kamariah","F",11,11,22
"13406","Kamarian","M",6,6,12
"13407","Kamarie","F",15,10,25
"13408","Kamarie","M",8,8,16
"13409","Kamarii","F",7,12,19
"13410","Kamarii","M",7,9,16
"13411","Kamarion","M",87,93,180
"13412","Kamarius","M",5,7,12
"13413","Kamariya","F",5,7,12
"13414","Kamaron","M",5,6,11
"13415","Kamarri","M",14,9,23
"13416","Kamarrion","M",6,6,12
"13417","Kamau","M",13,5,18
"13418","Kamauri","F",14,7,21
"13419","Kamauri","M",24,27,51
"13420","Kamaya","F",51,79,130
"13421","Kamber","F",24,22,46
"13422","Kambree","F",84,74,158
"13423","Kambreigh","F",6,7,13
"13424","Kambrey","F",11,10,21
"13425","Kambri","F",55,56,111
"13426","Kambria","F",49,45,94
"13427","Kambrie","F",60,61,121
"13428","Kambry","F",32,17,49
"13429","Kambryn","F",15,6,21
"13430","Kambryn","M",6,6,12
"13431","Kamden","F",35,30,65
"13432","Kamden","M",864,741,1605
"13433","Kamdin","M",17,14,31
"13434","Kamdon","M",25,47,72
"13435","Kamdyn","F",108,118,226
"13436","Kamdyn","M",276,284,560
"13437","Kamdynn","F",6,8,14
"13438","Kamea","F",34,34,68
"13439","Kameelah","F",7,5,12
"13440","Kamel","M",9,14,23
"13441","Kamelia","F",14,25,39
"13442","Kamella","F",6,7,13
"13443","Kamen","M",13,14,27
"13444","Kameran","M",16,19,35
"13445","Kameren","M",30,28,58
"13446","Kameria","F",5,5,10
"13447","Kamerin","F",6,5,11
"13448","Kamerin","M",20,9,29
"13449","Kameron","F",54,59,113
"13450","Kameron","M",1500,1436,2936
"13451","Kameryn","F",66,58,124
"13452","Kameryn","M",36,34,70
"13453","Kami","F",61,51,112
"13454","Kamia","F",50,60,110
"13455","Kamiah","F",85,125,210
"13456","Kamil","F",19,16,35
"13457","Kamil","M",49,47,96
"13458","Kamila","F",994,974,1968
"13459","Kamilah","F",217,222,439
"13460","Kamile","F",12,13,25
"13461","Kamilia","F",8,12,20
"13462","Kamilla","F",143,152,295
"13463","Kamillah","F",12,12,24
"13464","Kamille","F",212,202,414
"13465","Kamilo","M",12,12,24
"13466","Kamilya","F",7,8,15
"13467","Kamir","M",15,22,37
"13468","Kamira","F",22,20,42
"13469","Kamirah","F",20,19,39
"13470","Kamiya","F",146,175,321
"13471","Kamiyah","F",190,255,445
"13472","Kamlyn","F",6,7,13
"13473","Kammie","F",10,9,19
"13474","Kamon","M",9,12,21
"13475","Kamoni","F",27,21,48
"13476","Kamoni","M",9,12,21
"13477","Kamora","F",141,132,273
"13478","Kamorah","F",22,21,43
"13479","Kamori","F",24,27,51
"13480","Kamori","M",9,6,15
"13481","Kamorie","F",6,8,14
"13482","Kamorra","F",5,5,10
"13483","Kampbell","F",7,5,12
"13484","Kamran","M",55,51,106
"13485","Kamree","F",19,11,30
"13486","Kamren","F",11,17,28
"13487","Kamren","M",216,179,395
"13488","Kamri","F",29,33,62
"13489","Kamrie","F",12,27,39
"13490","Kamrin","F",8,8,16
"13491","Kamrin","M",50,36,86
"13492","Kamron","M",212,196,408
"13493","Kamry","F",32,28,60
"13494","Kamryn","F",906,861,1767
"13495","Kamryn","M",261,279,540
"13496","Kamrynn","F",45,45,90
"13497","Kamsi","M",7,5,12
"13498","Kamsiyochi","F",6,5,11
"13499","Kamsiyochukwu","F",12,17,29
"13500","Kamsiyochukwu","M",18,21,39
"13501","Kamuela","M",7,6,13
"13502","Kamya","F",82,133,215
"13503","Kamyah","F",33,45,78
"13504","Kamyia","F",17,16,33
"13505","Kamyiah","F",15,19,34
"13506","Kamyla","F",36,43,79
"13507","Kamylah","F",15,11,26
"13508","Kamylle","F",5,9,14
"13509","Kamyra","F",19,29,48
"13510","Kamyrah","F",12,12,24
"13511","Kamyrn","F",8,7,15
"13512","Kana","F",11,19,30
"13513","Kanaan","M",52,74,126
"13514","Kanai","F",6,8,14
"13515","Kanai","M",18,13,31
"13516","Kanaloa","M",7,8,15
"13517","Kanan","M",39,67,106
"13518","Kanani","F",19,12,31
"13519","Kanav","M",12,13,25
"13520","Kanaya","F",9,6,15
"13521","Kandace","F",22,22,44
"13522","Kanden","M",14,8,22
"13523","Kandi","F",11,7,18
"13524","Kandice","F",24,31,55
"13525","Kandis","F",10,9,19
"13526","Kandon","M",12,10,22
"13527","Kandy","F",5,6,11
"13528","Kandyce","F",8,10,18
"13529","Kane","M",713,790,1503
"13530","Kanen","M",33,42,75
"13531","Kani","F",9,6,15
"13532","Kani","M",17,14,31
"13533","Kaniah","F",7,13,20
"13534","Kanijah","F",6,5,11
"13535","Kanin","M",13,16,29
"13536","Kanisha","F",8,8,16
"13537","Kanishk","M",5,11,16
"13538","Kaniya","F",57,41,98
"13539","Kaniyah","F",84,88,172
"13540","Kanna","F",8,11,19
"13541","Kannan","M",15,20,35
"13542","Kannen","M",14,21,35
"13543","Kannin","M",7,9,16
"13544","Kannon","F",10,6,16
"13545","Kannon","M",262,297,559
"13546","Kano","M",14,13,27
"13547","Kanoa","M",20,29,49
"13548","Kanon","M",126,124,250
"13549","Kansas","F",28,32,60
"13550","Kanta","M",6,5,11
"13551","Kanton","M",13,12,25
"13552","Kanya","F",5,6,11
"13553","Kanye","M",26,17,43
"13554","Kanyla","F",14,21,35
"13555","Kanyon","M",36,44,80
"13556","Kao","M",9,5,14
"13557","Kaoir","F",5,9,14
"13558","Kaori","F",26,38,64
"13559","Kap","M",13,6,19
"13560","Kapone","M",9,5,14
"13561","Kapono","M",7,5,12
"13562","Kapri","F",34,44,78
"13563","Kaptain","M",5,6,11
"13564","Kara","F",619,622,1241
"13565","Karah","F",44,45,89
"13566","Karai","F",11,12,23
"13567","Karalee","F",8,12,20
"13568","Karalina","F",8,8,16
"13569","Karaline","F",33,26,59
"13570","Karalyn","F",28,26,54
"13571","Karalynn","F",29,17,46
"13572","Karam","M",78,71,149
"13573","Karan","M",23,17,40
"13574","Karanvir","M",8,5,13
"13575","Karas","M",71,66,137
"13576","Karcyn","F",15,10,25
"13577","Karcyn","M",8,7,15
"13578","Kardell","M",9,5,14
"13579","Karder","M",30,22,52
"13580","Karee","F",6,5,11
"13581","Kareem","M",334,344,678
"13582","Kareena","F",48,25,73
"13583","Karel","M",7,8,15
"13584","Kareli","F",12,8,20
"13585","Karelly","F",9,7,16
"13586","Karely","F",71,78,149
"13587","Karelyn","F",10,5,15
"13588","Karelys","F",7,5,12
"13589","Karen","F",625,614,1239
"13590","Karena","F",21,26,47
"13591","Karenna","F",5,6,11
"13592","Kari","F",114,97,211
"13593","Kari","M",10,12,22
"13594","Kariah","F",18,18,36
"13595","Kariana","F",16,11,27
"13596","Karianna","F",26,18,44
"13597","Karianne","F",6,5,11
"13598","Karie","F",5,8,13
"13599","Karielle","F",9,9,18
"13600","Karielys","F",5,6,11
"13601","Karigan","F",11,9,20
"13602","Karilyn","F",8,7,15
"13603","Karim","M",179,235,414
"13604","Karima","F",11,14,25
"13605","Karimah","F",5,6,11
"13606","Karime","F",46,56,102
"13607","Karin","F",29,26,55
"13608","Karina","F",687,626,1313
"13609","Karinna","F",9,9,18
"13610","Karis","F",194,223,417
"13611","Karisa","F",14,18,32
"13612","Karishma","F",15,17,32
"13613","Karisma","F",48,45,93
"13614","Karissa","F",194,162,356
"13615","Kariya","F",5,5,10
"13616","Kariyah","F",17,20,37
"13617","Karizma","F",27,25,52
"13618","Karl","M",184,167,351
"13619","Karla","F",612,551,1163
"13620","Karlea","F",7,6,13
"13621","Karlee","F",406,367,773
"13622","Karleen","F",6,6,12
"13623","Karlei","F",24,14,38
"13624","Karleigh","F",235,235,470
"13625","Karlena","F",5,5,10
"13626","Karley","F",178,133,311
"13627","Karli","F",186,148,334
"13628","Karliah","F",20,17,37
"13629","Karlie","F",341,325,666
"13630","Karlin","F",6,12,18
"13631","Karlin","M",8,9,17
"13632","Karlina","F",11,9,20
"13633","Karlito","M",6,9,15
"13634","Karliyah","F",5,8,13
"13635","Karlo","M",15,31,46
"13636","Karlos","M",34,37,71
"13637","Karlton","M",12,8,20
"13638","Karly","F",176,176,352
"13639","Karlyn","F",23,32,55
"13640","Karlynn","F",9,11,20
"13641","Karma","F",214,202,416
"13642","Karma","M",10,13,23
"13643","Karmah","F",17,10,27
"13644","Karman","F",14,10,24
"13645","Karmann","F",6,6,12
"13646","Karmela","F",12,9,21
"13647","Karmella","F",23,16,39
"13648","Karmello","M",27,37,64
"13649","Karmelo","M",46,42,88
"13650","Karmen","F",185,215,400
"13651","Karmin","F",35,38,73
"13652","Karmyn","F",121,93,214
"13653","Karnell","M",7,6,13
"13654","Karol","F",66,42,108
"13655","Karol","M",18,19,37
"13656","Karolina","F",125,115,240
"13657","Karoline","F",133,124,257
"13658","Karolyn","F",20,24,44
"13659","Karolyna","F",9,6,15
"13660","Karolyne","F",10,15,25
"13661","Karolynn","F",9,5,14
"13662","Karon","M",58,66,124
"13663","Karra","F",12,18,30
"13664","Karrah","F",6,11,17
"13665","Karri","F",8,6,14
"13666","Karrie","F",9,15,24
"13667","Karrigan","F",14,12,26
"13668","Karrington","F",60,45,105
"13669","Karrington","M",7,5,12
"13670","Karsen","F",50,48,98
"13671","Karsen","M",184,175,359
"13672","Karsin","M",15,18,33
"13673","Karson","F",63,83,146
"13674","Karson","M",1220,1097,2317
"13675","Karsten","M",70,76,146
"13676","Karston","M",38,24,62
"13677","Karsyn","F",452,453,905
"13678","Karsyn","M",156,134,290
"13679","Karsynn","F",33,25,58
"13680","Kartel","M",6,8,14
"13681","Karter","F",410,404,814
"13682","Karter","M",2281,2114,4395
"13683","Karthik","M",56,57,113
"13684","Karthika","F",7,8,15
"13685","Karthikeya","M",24,39,63
"13686","Kartier","F",7,8,15
"13687","Kartier","M",19,29,48
"13688","Kartik","M",11,5,16
"13689","Kartikeya","M",6,9,15
"13690","Karuna","F",9,11,20
"13691","Karver","M",36,28,64
"13692","Kary","F",11,9,20
"13693","Karyme","F",31,37,68
"13694","Karyn","F",10,19,29
"13695","Karyna","F",6,8,14
"13696","Karys","F",19,7,26
"13697","Karyssa","F",6,12,18
"13698","Kas","M",6,10,16
"13699","Kasai","M",14,18,32
"13700","Kasandra","F",39,40,79
"13701","Kasch","M",13,11,24
"13702","Kase","M",274,315,589
"13703","Kaseem","M",10,11,21
"13704","Kaselyn","F",11,6,17
"13705","Kaselynn","F",6,5,11
"13706","Kasen","F",6,5,11
"13707","Kasen","M",630,626,1256
"13708","Kaseton","M",5,5,10
"13709","Kasey","F",237,205,442
"13710","Kasey","M",101,99,200
"13711","Kash","F",12,19,31
"13712","Kash","M",839,898,1737
"13713","Kashaun","M",5,10,15
"13714","Kashawn","M",18,18,36
"13715","Kashden","M",13,17,30
"13716","Kashdyn","M",5,12,17
"13717","Kashe","M",7,6,13
"13718","Kashif","M",9,7,16
"13719","Kashis","M",14,13,27
"13720","Kashius","M",24,25,49
"13721","Kashlyn","F",21,32,53
"13722","Kashlynn","F",20,18,38
"13723","Kashmere","F",18,13,31
"13724","Kashmere","M",29,24,53
"13725","Kashmir","F",23,19,42
"13726","Kashmir","M",37,56,93
"13727","Kashon","M",9,5,14
"13728","Kashten","M",10,8,18
"13729","Kashton","M",221,221,442
"13730","Kashtyn","M",22,19,41
"13731","Kashus","M",14,12,26
"13732","Kashvi","F",18,19,37
"13733","Kasi","F",8,5,13
"13734","Kasia","F",27,16,43
"13735","Kasidee","F",7,17,24
"13736","Kasidy","F",14,12,26
"13737","Kasie","F",17,19,36
"13738","Kasim","M",12,22,34
"13739","Kasima","F",5,6,11
"13740","Kasin","M",22,19,41
"13741","Kasir","M",8,6,14
"13742","Kasiya","F",5,6,11
"13743","Kasiyah","F",8,10,18
"13744","Kason","M",814,873,1687
"13745","Kaspar","M",10,6,16
"13746","Kasper","M",53,50,103
"13747","Kaspian","M",14,13,27
"13748","Kasra","M",13,15,28
"13749","Kassadi","F",9,6,15
"13750","Kassady","F",8,8,16
"13751","Kassandra","F",372,353,725
"13752","Kassey","F",9,6,15
"13753","Kassi","F",7,15,22
"13754","Kassia","F",26,16,42
"13755","Kassiani","F",12,12,24
"13756","Kassidee","F",24,22,46
"13757","Kassidi","F",31,44,75
"13758","Kassidie","F",6,9,15
"13759","Kassidy","F",682,617,1299
"13760","Kassidy","M",14,14,28
"13761","Kassie","F",74,65,139
"13762","Kassim","M",11,13,24
"13763","Kassius","M",44,54,98
"13764","Kassy","F",6,7,13
"13765","Kastiel","M",16,22,38
"13766","Kastin","M",12,8,20
"13767","Kastle","M",7,6,13
"13768","Kaston","M",17,21,38
"13769","Kastyn","M",5,6,11
"13770","Kasyn","F",19,16,35
"13771","Kasyn","M",70,85,155
"13772","Katai","M",24,15,39
"13773","Katalaya","F",38,23,61
"13774","Katalea","F",9,15,24
"13775","Kataleah","F",11,17,28
"13776","Kataleia","F",10,8,18
"13777","Katalena","F",11,11,22
"13778","Kataleya","F",218,206,424
"13779","Kataleyah","F",7,7,14
"13780","Katalia","F",17,17,34
"13781","Katalina","F",357,347,704
"13782","Kataliyah","F",5,5,10
"13783","Katalyna","F",28,41,69
"13784","Katana","F",65,54,119
"13785","Katara","F",26,28,54
"13786","Katarina","F",175,167,342
"13787","Kataryna","F",8,5,13
"13788","Katarzyna","F",7,7,14
"13789","Kate","F",1474,1382,2856
"13790","Katelin","F",31,13,44
"13791","Katelyn","F",1380,864,2244
"13792","Katelynn","F",439,245,684
"13793","Katelynne","F",11,9,20
"13794","Kateri","F",47,52,99
"13795","Katerin","F",18,18,36
"13796","Katerina","F",217,194,411
"13797","Katerine","F",14,13,27
"13798","Kateryna","F",9,8,17
"13799","Katey","F",6,15,21
"13800","Kathaleya","F",12,6,18
"13801","Kathalia","F",7,5,12
"13802","Kathalina","F",20,12,32
"13803","Kathan","M",8,13,21
"13804","Katharina","F",30,20,50
"13805","Katharine","F",89,61,150
"13806","Katherin","F",49,54,103
"13807","Katherina","F",20,18,38
"13808","Katherine","F",3442,3259,6701
"13809","Katherinne","F",7,5,12
"13810","Katheryn","F",87,85,172
"13811","Katheryne","F",23,16,39
"13812","Kathia","F",33,20,53
"13813","Kathleen","F",337,338,675
"13814","Kathlyn","F",22,13,35
"13815","Kathrine","F",26,25,51
"13816","Kathryn","F",1012,829,1841
"13817","Kathryne","F",11,15,26
"13818","Kathrynn","F",11,13,24
"13819","Kathy","F",126,159,285
"13820","Kathya","F",12,23,35
"13821","Kati","F",10,8,18
"13822","Katia","F",109,116,225
"13823","Katiana","F",24,13,37
"13824","Katie","F",1049,885,1934
"13825","Katielynn","F",5,5,10
"13826","Katina","F",14,9,23
"13827","Katja","F",16,14,30
"13828","Katlyn","F",49,30,79
"13829","Katlynn","F",22,13,35
"13830","Katniss","F",30,32,62
"13831","Kato","M",47,30,77
"13832","Katriel","F",13,15,28
"13833","Katrin","F",8,7,15
"13834","Katrina","F",218,190,408
"13835","Kattaleya","F",17,18,35
"13836","Kattie","F",9,11,20
"13837","Kattleya","F",22,17,39
"13838","Katty","F",20,25,45
"13839","Katy","F",142,132,274
"13840","Katya","F",48,68,116
"13841","Kauan","M",16,13,29
"13842","Kauri","F",10,7,17
"13843","Kavan","M",20,12,32
"13844","Kavari","M",11,7,18
"13845","Kaveah","F",7,6,13
"13846","Kaveh","M",6,6,12
"13847","Kaven","M",23,27,50
"13848","Kaveon","M",17,11,28
"13849","Kaveri","F",7,8,15
"13850","Kavi","M",28,20,48
"13851","Kavian","M",7,9,16
"13852","Kavik","M",7,7,14
"13853","Kavin","M",73,74,147
"13854","Kavion","M",50,49,99
"13855","Kavir","M",23,10,33
"13856","Kavish","M",20,25,45
"13857","Kavon","M",36,39,75
"13858","Kavonte","M",6,6,12
"13859","Kavya","F",97,97,194
"13860","Kawai","M",7,8,15
"13861","Kawena","F",7,5,12
"13862","Kawhi","M",12,42,54
"13863","Kawika","M",24,15,39
"13864","Kawliga","M",6,5,11
"13865","Kawsar","F",6,9,15
"13866","Kawthar","F",9,15,24
"13867","Kay","F",43,46,89
"13868","Kay","M",8,5,13
"13869","Kaya","F",324,280,604
"13870","Kaya","M",14,10,24
"13871","Kayaan","M",8,8,16
"13872","Kayah","F",30,23,53
"13873","Kayal","F",10,12,22
"13874","Kayan","M",19,25,44
"13875","Kayana","F",26,18,44
"13876","Kayani","F",9,10,19
"13877","Kayanna","F",33,33,66
"13878","Kaybree","F",23,15,38
"13879","Kayce","F",28,23,51
"13880","Kayce","M",21,18,39
"13881","Kaycee","F",193,201,394
"13882","Kaycee","M",14,14,28
"13883","Kaycen","F",6,7,13
"13884","Kaycen","M",57,71,128
"13885","Kayceon","M",26,24,50
"13886","Kayci","F",30,33,63
"13887","Kaycie","F",49,54,103
"13888","Kayd","M",13,5,18
"13889","Kayda","F",20,24,44
"13890","Kaydan","M",43,40,83
"13891","Kaydance","F",81,55,136
"13892","Kayde","M",30,25,55
"13893","Kaydee","F",82,51,133
"13894","Kayden","F",314,252,566
"13895","Kayden","M",4229,3987,8216
"13896","Kaydence","F",945,845,1790
"13897","Kaydence","M",46,44,90
"13898","Kaydenn","M",18,15,33
"13899","Kaydi","F",13,9,22
"13900","Kaydin","F",17,17,34
"13901","Kaydin","M",65,51,116
"13902","Kaydince","F",11,7,18
"13903","Kaydn","M",6,5,11
"13904","Kaydon","M",69,63,132
"13905","Kaydyn","F",8,16,24
"13906","Kaydyn","M",24,18,42
"13907","Kaydynce","F",6,8,14
"13908","Kaye","F",16,8,24
"13909","Kayelee","F",10,10,20
"13910","Kayelyn","F",5,8,13
"13911","Kayelynn","F",13,15,28
"13912","Kayin","M",8,23,31
"13913","Kayla","F",2730,2456,5186
"13914","Kaylah","F",127,95,222
"13915","Kaylan","F",46,35,81
"13916","Kaylan","M",19,20,39
"13917","Kaylana","F",26,17,43
"13918","Kaylanee","F",7,5,12
"13919","Kaylani","F",249,374,623
"13920","Kaylanie","F",25,25,50
"13921","Kaylanni","F",9,12,21
"13922","Kayle","F",45,40,85
"13923","Kaylea","F",34,31,65
"13924","Kayleah","F",15,21,36
"13925","Kayleana","F",10,10,20
"13926","Kayleb","M",120,77,197
"13927","Kaylee","F",4362,3814,8176
"13928","Kayleeann","F",11,11,22
"13929","Kayleen","F",177,158,335
"13930","Kaylei","F",62,46,108
"13931","Kayleigh","F",1000,951,1951
"13932","Kaylen","F",209,160,369
"13933","Kaylen","M",44,35,79
"13934","Kaylena","F",15,14,29
"13935","Kaylene","F",79,62,141
"13936","Kaylenn","F",5,6,11
"13937","Kayler","M",11,8,19
"13938","Kayley","F",132,125,257
"13939","Kayli","F",116,83,199
"13940","Kaylia","F",10,14,24
"13941","Kayliah","F",15,13,28
"13942","Kayliana","F",50,62,112
"13943","Kayliani","F",5,6,11
"13944","Kaylianna","F",26,25,51
"13945","Kaylie","F",559,496,1055
"13946","Kayliegh","F",7,10,17
"13947","Kaylin","F",464,353,817
"13948","Kaylin","M",14,5,19
"13949","Kaylina","F",10,7,17
"13950","Kayline","F",7,7,14
"13951","Kaylinn","F",26,19,45
"13952","Kaylise","F",9,7,16
"13953","Kaylnn","F",9,5,14
"13954","Kaylob","M",9,10,19
"13955","Kaylon","F",9,6,15
"13956","Kaylon","M",27,14,41
"13957","Kayloni","F",29,32,61
"13958","Kaylonie","F",6,5,11
"13959","Kaylonni","F",5,8,13
"13960","Kaylor","F",14,21,35
"13961","Kaylor","M",26,11,37
"13962","Kaylum","M",7,7,14
"13963","Kaylyn","F",191,163,354
"13964","Kaylynn","F",377,308,685
"13965","Kaylynne","F",8,15,23
"13966","Kayman","M",5,7,12
"13967","Kaymarie","F",12,10,22
"13968","Kaymen","M",12,11,23
"13969","Kayn","M",8,12,20
"13970","Kayna","F",7,8,15
"13971","Kaynan","M",9,16,25
"13972","Kayne","M",71,69,140
"13973","Kaynen","M",21,38,59
"13974","Kaynon","M",5,13,18
"13975","Kayo","M",11,8,19
"13976","Kayode","M",6,8,14
"13977","Kayon","M",10,16,26
"13978","Kayonna","F",8,20,28
"13979","Kayra","F",26,25,51
"13980","Kaysan","M",8,23,31
"13981","Kayse","F",6,8,14
"13982","Kayse","M",6,6,12
"13983","Kaysee","F",6,8,14
"13984","Kaysen","F",33,21,54
"13985","Kaysen","M",347,339,686
"13986","Kaysha","F",11,9,20
"13987","Kayshawn","M",11,11,22
"13988","Kaysi","F",7,15,22
"13989","Kaysie","F",29,16,45
"13990","Kaysin","M",20,21,41
"13991","Kayslee","F",10,14,24
"13992","Kaysn","M",5,5,10
"13993","Kayson","F",13,12,25
"13994","Kayson","M",700,843,1543
"13995","Kayston","M",12,6,18
"13996","Kaytie","F",10,5,15
"13997","Kaytlin","F",29,16,45
"13998","Kaytlyn","F",15,13,28
"13999","Kaytlynn","F",11,8,19
"14000","Kayton","M",8,13,21
"14001","Kayven","M",13,7,20
"14002","Kayveon","M",12,9,21
"14003","Kayvion","M",19,16,35
"14004","Kayvon","M",40,36,76
"14005","Kayzen","M",8,11,19
"14006","Kayzlee","F",27,23,50
"14007","Kayzlie","F",6,5,11
"14008","Kaz","M",22,22,44
"14009","Kazden","M",8,7,15
"14010","Kazen","M",7,13,20
"14011","Kazi","F",6,8,14
"14012","Kazi","M",20,14,34
"14013","Kaziah","F",17,18,35
"14014","Kazim","M",7,8,15
"14015","Kazimir","M",8,9,17
"14016","Kaziyah","F",9,7,16
"14017","Kazlyn","F",6,10,16
"14018","Kazuki","M",7,10,17
"14019","Kazuma","M",9,6,15
"14020","Kc","F",15,7,22
"14021","Kc","M",28,28,56
"14022","Kden","M",14,19,33
"14023","Keaden","M",7,7,14
"14024","Keagan","F",70,58,128
"14025","Keagan","M",292,253,545
"14026","Keagen","M",36,24,60
"14027","Keaghan","M",13,17,30
"14028","Keahi","M",15,16,31
"14029","Keair","M",5,5,10
"14030","Keaira","F",11,10,21
"14031","Keala","F",6,11,17
"14032","Kealan","M",9,12,21
"14033","Kealani","F",10,26,36
"14034","Kealia","F",6,6,12
"14035","Kean","M",24,23,47
"14036","Keana","F",24,20,44
"14037","Keanan","M",10,14,24
"14038","Keandre","M",59,47,106
"14039","Keane","M",36,27,63
"14040","Keani","F",14,15,29
"14041","Keanna","F",30,35,65
"14042","Keanu","M",197,210,407
"14043","Keara","F",31,24,55
"14044","Keari","F",6,10,16
"14045","Keasia","F",28,22,50
"14046","Keaston","M",13,10,23
"14047","Keaten","M",10,9,19
"14048","Keaton","F",39,42,81
"14049","Keaton","M",621,543,1164
"14050","Keats","M",7,7,14
"14051","Keatyn","F",12,10,22
"14052","Keatyn","M",7,6,13
"14053","Kedar","M",14,7,21
"14054","Kedric","M",11,8,19
"14055","Kedrick","M",20,23,43
"14056","Kee","M",7,6,13
"14057","Keean","M",18,20,38
"14058","Keedan","M",7,5,12
"14059","Keegan","F",129,114,243
"14060","Keegan","M",1343,1282,2625
"14061","Keegen","M",7,8,15
"14062","Keeghan","M",10,10,20
"14063","Keela","F",15,11,26
"14064","Keelan","F",9,7,16
"14065","Keelan","M",133,105,238
"14066","Keelee","F",13,10,23
"14067","Keeleigh","F",12,17,29
"14068","Keeley","F",104,83,187
"14069","Keeli","F",14,14,28
"14070","Keelie","F",29,28,57
"14071","Keelin","F",16,15,31
"14072","Keelin","M",7,9,16
"14073","Keely","F",98,86,184
"14074","Keelyn","F",23,32,55
"14075","Keelyn","M",11,9,20
"14076","Keelynn","F",8,5,13
"14077","Keen","M",12,10,22
"14078","Keena","F",8,10,18
"14079","Keenan","M",227,269,496
"14080","Keene","M",14,6,20
"14081","Keenen","M",8,11,19
"14082","Keenon","M",5,8,13
"14083","Keera","F",20,16,36
"14084","Keerat","F",9,8,17
"14085","Keerthana","F",13,24,37
"14086","Keerthi","F",10,8,18
"14087","Keeton","M",27,19,46
"14088","Keeva","F",37,34,71
"14089","Keeyan","M",7,6,13
"14090","Kefren","M",6,9,15
"14091","Kegan","M",55,49,104
"14092","Kehaulani","F",7,5,12
"14093","Kehlani","F",48,320,368
"14094","Kei","M",33,30,63
"14095","Keian","M",15,14,29
"14096","Keiana","F",7,17,24
"14097","Keianna","F",8,12,20
"14098","Keiara","F",8,7,15
"14099","Keiasia","F",5,5,10
"14100","Keiden","M",21,23,44
"14101","Keidy","F",16,18,34
"14102","Keifer","M",6,9,15
"14103","Keigan","M",38,31,69
"14104","Keigen","M",10,5,15
"14105","Keighan","M",14,16,30
"14106","Keighley","F",7,7,14
"14107","Keigo","M",5,5,10
"14108","Keiji","M",8,7,15
"14109","Keiko","F",13,15,28
"14110","Keila","F",169,182,351
"14111","Keilah","F",26,25,51
"14112","Keilan","M",49,48,97
"14113","Keilana","F",16,10,26
"14114","Keiland","M",6,5,11
"14115","Keilani","F",143,168,311
"14116","Keilany","F",14,29,43
"14117","Keilee","F",11,5,16
"14118","Keilen","M",8,5,13
"14119","Keiler","M",7,7,14
"14120","Keiley","F",12,6,18
"14121","Keili","F",10,6,16
"14122","Keilianys","F",7,6,13
"14123","Keilly","F",23,20,43
"14124","Keilon","M",9,8,17
"14125","Keily","F",228,240,468
"14126","Keilyn","F",45,49,94
"14127","Keilyn","M",8,8,16
"14128","Keilynn","F",6,5,11
"14129","Keimani","F",7,5,12
"14130","Keinan","M",9,5,14
"14131","Keion","M",50,47,97
"14132","Keiona","F",6,8,14
"14133","Keionna","F",7,7,14
"14134","Keir","M",21,5,26
"14135","Keira","F",1310,1030,2340
"14136","Keirah","F",15,20,35
"14137","Keiran","M",43,54,97
"14138","Keiron","M",7,7,14
"14139","Keirra","F",24,24,48
"14140","Keirsten","F",7,10,17
"14141","Keirstin","F",6,6,12
"14142","Keiry","F",82,72,154
"14143","Keisha","F",59,27,86
"14144","Keishaun","M",8,6,14
"14145","Keishawn","M",15,10,25
"14146","Keisi","F",37,23,60
"14147","Keison","M",8,10,18
"14148","Keiston","M",5,10,15
"14149","Keisy","F",49,48,97
"14150","Keita","M",16,8,24
"14151","Keith","M",723,630,1353
"14152","Keithan","M",17,15,32
"14153","Keithen","M",9,6,15
"14154","Keiton","M",8,10,18
"14155","Keivon","M",11,7,18
"14156","Keizer","M",7,5,12
"14157","Kejuan","M",21,24,45
"14158","Kekeli","F",5,6,11
"14159","Kekoa","M",70,66,136
"14160","Kel","M",5,7,12
"14161","Kelaiah","F",16,11,27
"14162","Kelan","M",45,32,77
"14163","Keland","M",6,6,12
"14164","Kelani","F",38,56,94
"14165","Kelani","M",7,7,14
"14166","Kelbi","F",10,11,21
"14167","Kelbie","F",9,12,21
"14168","Kelby","F",23,19,42
"14169","Kelby","M",41,31,72
"14170","Kelcee","F",12,9,21
"14171","Kelcey","F",12,9,21
"14172","Kelci","F",22,14,36
"14173","Kelcie","F",40,30,70
"14174","Kelcy","F",7,6,13
"14175","Keldan","M",7,9,16
"14176","Kelden","M",10,12,22
"14177","Keldon","M",13,15,28
"14178","Kelechi","M",8,18,26
"14179","Keleigh","F",15,9,24
"14180","Kelena","F",6,5,11
"14181","Keli","F",6,12,18
"14182","Kelia","F",25,16,41
"14183","Keliana","F",8,11,19
"14184","Kelilah","F",8,12,20
"14185","Kelina","F",10,5,15
"14186","Kelis","F",93,73,166
"14187","Kelise","F",19,29,48
"14188","Keliyah","F",9,11,20
"14189","Kella","F",15,18,33
"14190","Kellan","F",12,9,21
"14191","Kellan","M",774,597,1371
"14192","Kellen","F",25,16,41
"14193","Kellen","M",568,439,1007
"14194","Keller","F",18,21,39
"14195","Keller","M",159,140,299
"14196","Kelley","F",28,22,50
"14197","Kelley","M",15,18,33
"14198","Kelli","F",41,37,78
"14199","Kellie","F",44,49,93
"14200","Kellin","M",76,90,166
"14201","Kelly","F",673,601,1274
"14202","Kelly","M",103,116,219
"14203","Kellyn","F",40,32,72
"14204","Kellyn","M",9,9,18
"14205","Kelsa","F",7,6,13
"14206","Kelsea","F",47,80,127
"14207","Kelsee","F",14,25,39
"14208","Kelsei","F",13,6,19
"14209","Kelsey","F",949,853,1802
"14210","Kelsey","M",18,10,28
"14211","Kelsi","F",79,86,165
"14212","Kelsie","F",221,227,448
"14213","Kelso","M",10,7,17
"14214","Kelson","M",37,30,67
"14215","Kelsy","F",24,33,57
"14216","Kelton","M",119,119,238
"14217","Kelty","F",7,7,14
"14218","Kelvin","M",398,335,733
"14219","Kelyn","M",14,10,24
"14220","Kemal","M",9,8,17
"14221","Kemani","F",21,24,45
"14222","Kemani","M",11,19,30
"14223","Kemar","M",13,19,32
"14224","Kemari","F",17,21,38
"14225","Kemari","M",51,49,100
"14226","Kemaria","F",5,6,11
"14227","Kemarion","M",30,27,57
"14228","Kemauri","M",6,10,16
"14229","Kemaya","F",9,6,15
"14230","Kember","F",6,6,12
"14231","Kemet","M",13,19,32
"14232","Kemi","F",10,7,17
"14233","Kemiya","F",10,8,18
"14234","Kemiyah","F",19,24,43
"14235","Kemon","M",9,14,23
"14236","Kemoni","F",18,19,37
"14237","Kemoni","M",7,12,19
"14238","Kemonie","F",5,5,10
"14239","Kemonte","M",6,6,12
"14240","Kemora","F",25,25,50
"14241","Kemp","M",14,12,26
"14242","Kemper","F",11,13,24
"14243","Kemper","M",54,39,93
"14244","Kemuel","M",20,17,37
"14245","Kemya","F",18,16,34
"14246","Ken","M",87,90,177
"14247","Kena","F",9,10,19
"14248","Kenadee","F",74,60,134
"14249","Kenadi","F",63,67,130
"14250","Kenadie","F",64,50,114
"14251","Kenady","F",15,13,28
"14252","Kenai","M",68,80,148
"14253","Kenan","M",94,106,200
"14254","Kenard","M",5,5,10
"14255","Kenasia","F",5,5,10
"14256","Kenda","F",14,20,34
"14257","Kendahl","F",10,8,18
"14258","Kendal","F",193,141,334
"14259","Kendal","M",49,39,88
"14260","Kendale","M",14,11,25
"14261","Kendall","F",2191,1694,3885
"14262","Kendall","M",300,229,529
"14263","Kendallyn","F",13,7,20
"14264","Kendalyn","F",46,36,82
"14265","Kendalynn","F",24,29,53
"14266","Kendan","M",12,6,18
"14267","Kendarius","M",10,9,19
"14268","Kendel","F",12,6,18
"14269","Kendel","M",11,11,22
"14270","Kendell","F",27,24,51
"14271","Kendell","M",53,52,105
"14272","Kendelle","F",7,5,12
"14273","Kenden","M",21,13,34
"14274","Kender","M",5,5,10
"14275","Kendi","F",12,7,19
"14276","Kendon","M",37,34,71
"14277","Kendra","F",960,954,1914
"14278","Kendrah","F",10,7,17
"14279","Kendrell","M",15,12,27
"14280","Kendria","F",6,6,12
"14281","Kendric","M",63,51,114
"14282","Kendrick","F",7,7,14
"14283","Kendrick","M",875,821,1696
"14284","Kendriel","M",8,10,18
"14285","Kendrik","M",18,17,35
"14286","Kendrix","M",42,32,74
"14287","Kendry","F",7,9,16
"14288","Kendry","M",19,22,41
"14289","Kendryck","M",9,7,16
"14290","Kendryk","M",9,5,14
"14291","Kendyl","F",181,156,337
"14292","Kendyl","M",6,5,11
"14293","Kendyll","F",59,42,101
"14294","Kendyn","M",10,22,32
"14295","Kenechukwu","M",17,17,34
"14296","Kenedee","F",6,7,13
"14297","Kenedi","F",40,32,72
"14298","Kenedy","F",11,17,28
"14299","Keneth","M",8,7,15
"14300","Keng","M",14,10,24
"14301","Kenia","F",361,450,811
"14302","Keniah","F",5,6,11
"14303","Kenidee","F",17,8,25
"14304","Kenidi","F",9,6,15
"14305","Keniel","M",24,33,57
"14306","Kenisha","F",12,21,33
"14307","Keniya","F",13,16,29
"14308","Keniyah","F",25,23,48
"14309","Kenji","M",122,124,246
"14310","Kenlea","F",8,6,14
"14311","Kenlee","F",153,133,286
"14312","Kenlee","M",6,5,11
"14313","Kenlei","F",12,16,28
"14314","Kenleigh","F",166,152,318
"14315","Kenley","F",431,368,799
"14316","Kenley","M",17,22,39
"14317","Kenli","F",28,25,53
"14318","Kenlie","F",33,25,58
"14319","Kenly","F",36,18,54
"14320","Kenlyn","F",7,10,17
"14321","Kenlynn","F",12,14,26
"14322","Kenna","F",421,439,860
"14323","Kenna","M",7,11,18
"14324","Kennadee","F",33,18,51
"14325","Kennadi","F",102,112,214
"14326","Kennadie","F",26,24,50
"14327","Kennady","F",73,65,138
"14328","Kennah","F",12,11,23
"14329","Kennan","M",17,17,34
"14330","Kennard","M",6,10,16
"14331","Kenndra","F",8,7,15
"14332","Kennedee","F",19,11,30
"14333","Kennedi","F",846,794,1640
"14334","Kennedie","F",35,35,70
"14335","Kennedii","F",6,6,12
"14336","Kennedy","F",4512,4313,8825
"14337","Kennedy","M",163,170,333
"14338","Kennen","M",12,7,19
"14339","Kenner","M",31,22,53
"14340","Kenneth","M",2017,1901,3918
"14341","Kennett","M",5,5,10
"14342","Kenney","M",7,6,13
"14343","Kenni","F",5,9,14
"14344","Kennia","F",17,23,40
"14345","Kennidee","F",9,7,16
"14346","Kennidi","F",14,17,31
"14347","Kennidy","F",24,13,37
"14348","Kenniel","M",17,7,24
"14349","Kennith","M",5,9,14
"14350","Kenniyah","F",7,9,16
"14351","Kennley","F",10,14,24
"14352","Kennon","M",21,20,41
"14353","Kenny","M",247,241,488
"14354","Kennya","F",20,24,44
"14355","Keno","M",9,5,14
"14356","Kenrick","M",16,20,36
"14357","Kensey","F",19,23,42
"14358","Kenshin","M",11,18,29
"14359","Kensi","F",61,55,116
"14360","Kensie","F",67,48,115
"14361","Kensington","F",278,261,539
"14362","Kensington","M",14,12,26
"14363","Kenslee","F",77,98,175
"14364","Kenslei","F",12,19,31
"14365","Kensleigh","F",63,60,123
"14366","Kensley","F",445,591,1036
"14367","Kensley","M",8,12,20
"14368","Kensli","F",21,17,38
"14369","Kenslie","F",37,37,74
"14370","Kensly","F",15,10,25
"14371","Kenson","M",26,20,46
"14372","Kenston","M",16,10,26
"14373","Kent","M",156,164,320
"14374","Kenta","M",11,5,16
"14375","Kentaro","M",7,5,12
"14376","Kentavious","M",8,13,21
"14377","Kentlee","F",7,7,14
"14378","Kentley","F",15,9,24
"14379","Kentley","M",12,11,23
"14380","Kento","M",19,22,41
"14381","Kenton","M",182,159,341
"14382","Kentrel","M",5,6,11
"14383","Kentrell","M",62,51,113
"14384","Kentyn","M",6,6,12
"14385","Kenya","F",309,324,633
"14386","Kenya","M",7,7,14
"14387","Kenyah","F",10,16,26
"14388","Kenyan","M",20,23,43
"14389","Kenyatta","F",10,12,22
"14390","Kenyatta","M",10,13,23
"14391","Kenyen","M",5,6,11
"14392","Kenyon","M",93,53,146
"14393","Kenza","F",39,28,67
"14394","Kenzee","F",20,18,38
"14395","Kenzi","F",152,163,315
"14396","Kenzie","F",1139,984,2123
"14397","Kenzie","M",9,6,15
"14398","Kenzington","F",75,52,127
"14399","Kenzlee","F",123,127,250
"14400","Kenzlei","F",13,9,22
"14401","Kenzleigh","F",82,71,153
"14402","Kenzley","F",116,117,233
"14403","Kenzli","F",14,20,34
"14404","Kenzlie","F",48,46,94
"14405","Kenzly","F",16,12,28
"14406","Kenzo","M",88,103,191
"14407","Kenzy","F",57,27,84
"14408","Keo","M",8,9,17
"14409","Keoki","M",5,6,11
"14410","Keola","M",10,7,17
"14411","Keon","M",135,146,281
"14412","Keona","F",34,34,68
"14413","Keondre","M",29,22,51
"14414","Keone","M",12,8,20
"14415","Keoni","F",9,7,16
"14416","Keoni","M",80,82,162
"14417","Keonna","F",15,17,32
"14418","Keontae","M",21,13,34
"14419","Keontay","M",10,6,16
"14420","Keonte","M",22,15,37
"14421","Kepler","M",25,41,66
"14422","Kera","F",23,26,49
"14423","Keraun","M",7,9,16
"14424","Kerem","M",30,39,69
"14425","Keren","F",121,133,254
"14426","Keri","F",40,39,79
"14427","Keria","F",6,5,11
"14428","Keriana","F",6,6,12
"14429","Kerigan","F",8,6,14
"14430","Kerim","M",11,38,49
"14431","Kerolos","M",9,7,16
"14432","Keron","M",9,9,18
"14433","Kerri","F",21,31,52
"14434","Kerrick","M",9,10,19
"14435","Kerrigan","F",98,79,177
"14436","Kerrigan","M",5,6,11
"14437","Kerrington","F",44,35,79
"14438","Kerrion","M",6,5,11
"14439","Kerry","F",26,30,56
"14440","Kerry","M",62,53,115
"14441","Kershaw","M",9,7,16
"14442","Kerstin","F",14,6,20
"14443","Kervens","M",7,13,20
"14444","Kervin","M",15,13,28
"14445","Kerwin","M",10,8,18
"14446","Kesean","M",16,12,28
"14447","Kesha","F",7,9,16
"14448","Keshaun","M",29,20,49
"14449","Keshav","M",51,55,106
"14450","Keshawn","M",83,78,161
"14451","Keshon","M",19,9,28
"14452","Keshun","M",9,8,17
"14453","Keslee","F",6,7,13
"14454","Kesler","M",15,15,30
"14455","Kesley","F",13,16,29
"14456","Kessa","F",11,7,18
"14457","Kessler","M",23,22,45
"14458","Kessley","F",5,8,13
"14459","Kester","M",6,6,12
"14460","Keston","M",25,23,48
"14461","Kestrel","F",11,8,19
"14462","Ketch","M",6,8,14
"14463","Ketsia","F",10,7,17
"14464","Keturah","F",44,48,92
"14465","Ketzaly","F",14,12,26
"14466","Ketzia","F",8,7,15
"14467","Keva","F",14,14,28
"14468","Kevan","M",6,16,22
"14469","Kevaughn","M",6,6,12
"14470","Keven","M",50,61,111
"14471","Kevia","F",7,7,14
"14472","Kevin","F",14,5,19
"14473","Kevin","M",5164,4526,9690
"14474","Kevion","M",21,17,38
"14475","Kevon","M",65,57,122
"14476","Kevontae","M",10,7,17
"14477","Kevonte","M",6,11,17
"14478","Kevyn","M",27,37,64
"14479","Keya","F",40,32,72
"14480","Keyaan","M",12,10,22
"14481","Keyan","M",47,39,86
"14482","Keyana","F",26,33,59
"14483","Keyani","F",16,11,27
"14484","Keyanna","F",28,29,57
"14485","Keyara","F",20,20,40
"14486","Keyarra","F",6,6,12
"14487","Keyasia","F",14,8,22
"14488","Keyden","M",35,35,70
"14489","Keyera","F",7,5,12
"14490","Keygan","M",18,15,33
"14491","Keyla","F",348,425,773
"14492","Keylah","F",5,8,13
"14493","Keylan","M",32,28,60
"14494","Keylani","F",9,16,25
"14495","Keylee","F",31,27,58
"14496","Keyleen","F",9,5,14
"14497","Keyleigh","F",9,8,17
"14498","Keylen","F",5,7,12
"14499","Keylen","M",13,13,26
"14500","Keyler","M",20,18,38
"14501","Keyli","F",67,60,127
"14502","Keylianis","F",6,7,13
"14503","Keylie","F",12,10,22
"14504","Keylin","F",48,59,107
"14505","Keylin","M",13,5,18
"14506","Keylon","M",10,10,20
"14507","Keylor","M",29,68,97
"14508","Keymari","M",9,7,16
"14509","Keymarion","M",6,5,11
"14510","Keymoni","F",5,8,13
"14511","Keynan","M",8,6,14
"14512","Keyner","M",5,7,12
"14513","Keyon","M",111,104,215
"14514","Keyona","F",15,11,26
"14515","Keyondre","M",9,5,14
"14516","Keyoni","F",5,6,11
"14517","Keyonna","F",37,30,67
"14518","Keyonni","F",6,9,15
"14519","Keyontae","M",8,6,14
"14520","Keyra","F",24,32,56
"14521","Keyri","F",25,18,43
"14522","Keyrin","F",6,6,12
"14523","Keyron","M",6,5,11
"14524","Keysha","F",24,20,44
"14525","Keyshaun","M",7,5,12
"14526","Keyshawn","M",41,42,83
"14527","Keysi","F",25,18,43
"14528","Keyson","M",5,5,10
"14529","Keyton","M",21,30,51
"14530","Keyvon","M",11,19,30
"14531","Kezia","F",69,52,121
"14532","Keziah","F",163,172,335
"14533","Keziyah","F",7,7,14
"14534","Khade","M",5,7,12
"14535","Khadeeja","F",9,10,19
"14536","Khadeejah","F",10,10,20
"14537","Khaden","M",18,18,36
"14538","Khadija","F",177,177,354
"14539","Khadijah","F",107,136,243
"14540","Khadim","M",8,6,14
"14541","Khadir","M",8,6,14
"14542","Khadra","F",9,5,14
"14543","Khady","F",5,9,14
"14544","Khael","M",9,8,17
"14545","Khai","F",26,16,42
"14546","Khai","M",111,124,235
"14547","Khaiden","M",25,22,47
"14548","Khaidyn","M",8,5,13
"14549","Khaila","F",8,8,16
"14550","Khailee","F",5,13,18
"14551","Khailey","F",9,6,15
"14552","Khair","M",15,5,20
"14553","Khaira","F",6,5,11
"14554","Khairi","M",18,20,38
"14555","Khairo","M",5,6,11
"14556","Khalani","F",45,87,132
"14557","Khale","M",11,5,16
"14558","Khalea","F",10,9,19
"14559","Khaleah","F",15,16,31
"14560","Khaleb","M",47,47,94
"14561","Khaled","M",99,113,212
"14562","Khalee","F",9,6,15
"14563","Khaleed","M",6,5,11
"14564","Khaleel","M",26,28,54
"14565","Khaleesi","F",341,370,711
"14566","Khaleesia","F",6,9,15
"14567","Khalel","M",11,17,28
"14568","Khalen","M",8,6,14
"14569","Khalessi","F",25,22,47
"14570","Khali","F",96,92,188
"14571","Khali","M",27,14,41
"14572","Khalia","F",125,119,244
"14573","Khaliah","F",37,36,73
"14574","Khalib","M",6,12,18
"14575","Khalid","M",197,234,431
"14576","Khalie","F",15,8,23
"14577","Khalif","M",38,37,75
"14578","Khalifa","M",18,18,36
"14579","Khalil","F",6,5,11
"14580","Khalil","M",623,689,1312
"14581","Khalila","F",12,9,21
"14582","Khalilah","F",14,13,27
"14583","Khalina","F",8,9,17
"14584","Khaliq","M",21,22,43
"14585","Khalis","F",5,8,13
"14586","Khalise","F",11,9,20
"14587","Khaliya","F",35,23,58
"14588","Khaliyah","F",67,74,141
"14589","Khalon","M",5,9,14
"14590","Khalynn","F",6,5,11
"14591","Kham","M",5,6,11
"14592","Khamani","F",6,9,15
"14593","Khamari","F",21,17,38
"14594","Khamari","M",72,69,141
"14595","Khameron","M",7,10,17
"14596","Khamil","F",5,5,10
"14597","Khamila","F",13,19,32
"14598","Khamille","F",10,5,15
"14599","Khamiyah","F",13,13,26
"14600","Khamora","F",6,9,15
"14601","Khamren","M",5,6,11
"14602","Khamron","M",7,5,12
"14603","Khamryn","F",6,10,16
"14604","Khamya","F",15,15,30
"14605","Khan","M",10,15,25
"14606","Khang","M",29,39,68
"14607","Khanh","M",8,7,15
"14608","Khara","F",8,9,17
"14609","Khareem","M",7,5,12
"14610","Khari","F",40,81,121
"14611","Khari","M",107,169,276
"14612","Kharis","F",11,14,25
"14613","Kharisma","F",8,15,23
"14614","Kharli","F",6,9,15
"14615","Kharma","F",16,16,32
"14616","Kharon","M",7,6,13
"14617","Kharson","M",10,7,17
"14618","Kharter","F",11,13,24
"14619","Kharter","M",74,36,110
"14620","Khary","M",6,6,12
"14621","Khasir","M",5,7,12
"14622","Khassidy","F",5,9,14
"14623","Khaya","F",7,9,16
"14624","Khayden","M",45,35,80
"14625","Khayla","F",9,6,15
"14626","Khaylee","F",10,13,23
"14627","Khayri","M",7,9,16
"14628","Khaza","M",34,77,111
"14629","Khelan","M",5,6,11
"14630","Kherington","F",17,17,34
"14631","Khi","F",9,5,14
"14632","Khi","M",28,17,45
"14633","Khia","F",11,13,24
"14634","Khian","M",8,6,14
"14635","Khiana","F",6,13,19
"14636","Khianna","F",6,5,11
"14637","Khiara","F",18,17,35
"14638","Khilan","M",6,5,11
"14639","Khilee","F",15,8,23
"14640","Khilynn","F",8,7,15
"14641","Khing","M",8,14,22
"14642","Khingston","M",6,8,14
"14643","Khiree","M",5,8,13
"14644","Khiry","M",30,24,54
"14645","Khiya","F",10,11,21
"14646","Khiyan","M",7,12,19
"14647","Khizar","M",11,11,22
"14648","Khizer","M",7,7,14
"14649","Khloe","F",2993,2520,5513
"14650","Khloee","F",109,97,206
"14651","Khloei","F",7,5,12
"14652","Khloey","F",61,30,91
"14653","Khloi","F",11,6,17
"14654","Khloie","F",40,49,89
"14655","Khoa","M",13,9,22
"14656","Khodi","F",5,6,11
"14657","Khoen","M",9,9,18
"14658","Khoi","M",23,21,44
"14659","Khol","M",6,9,15
"14660","Khole","F",61,43,104
"14661","Kholton","M",10,8,18
"14662","Khora","F",7,6,13
"14663","Khori","F",31,50,81
"14664","Khoury","M",6,7,13
"14665","Khristian","F",12,14,26
"14666","Khristian","M",85,82,167
"14667","Khristopher","M",28,33,61
"14668","Khrystian","M",11,7,18
"14669","Khup","M",11,9,20
"14670","Khush","M",6,6,12
"14671","Khushi","F",33,43,76
"14672","Khy","M",8,12,20
"14673","Khya","F",7,13,20
"14674","Khyan","M",8,7,15
"14675","Khyden","M",10,8,18
"14676","Khye","M",10,7,17
"14677","Khyla","F",29,39,68
"14678","Khylah","F",7,8,15
"14679","Khylan","M",24,41,65
"14680","Khylar","M",8,6,14
"14681","Khyle","M",10,5,15
"14682","Khylee","F",74,65,139
"14683","Khylei","F",7,13,20
"14684","Khyleigh","F",12,10,22
"14685","Khylen","M",24,23,47
"14686","Khyler","F",8,9,17
"14687","Khyler","M",35,31,66
"14688","Khyli","F",12,9,21
"14689","Khylie","F",45,43,88
"14690","Khylin","F",5,6,11
"14691","Khylin","M",15,20,35
"14692","Khylon","M",11,7,18
"14693","Khyra","F",7,16,23
"14694","Khyre","M",6,5,11
"14695","Khyree","M",85,79,164
"14696","Khyren","M",14,20,34
"14697","Khyri","M",17,21,38
"14698","Khyrie","F",7,6,13
"14699","Khyrie","M",36,43,79
"14700","Khyrin","M",12,10,22
"14701","Khyron","M",5,10,15
"14702","Khysen","M",7,9,16
"14703","Khyson","M",11,21,32
"14704","Ki","M",5,10,15
"14705","Kia","F",15,21,36
"14706","Kiaan","M",87,168,255
"14707","Kiah","F",62,52,114
"14708","Kiah","M",13,5,18
"14709","Kiahna","F",9,6,15
"14710","Kiam","M",6,6,12
"14711","Kian","M",601,605,1206
"14712","Kiana","F",279,325,604
"14713","Kianah","F",9,8,17
"14714","Kiandra","F",14,8,22
"14715","Kiani","F",18,17,35
"14716","Kianna","F",110,106,216
"14717","Kianni","F",12,11,23
"14718","Kiante","M",9,5,14
"14719","Kiara","F",813,850,1663
"14720","Kiarah","F",33,25,58
"14721","Kiari","F",11,17,28
"14722","Kiarra","F",32,33,65
"14723","Kiaya","F",15,9,24
"14724","Kidus","M",44,55,99
"14725","Kiedis","M",5,6,11
"14726","Kiefer","M",26,21,47
"14727","Kiel","M",6,8,14
"14728","Kiele","F",6,11,17
"14729","Kiely","F",14,8,22
"14730","Kielyn","F",7,5,12
"14731","Kien","M",18,21,39
"14732","Kieon","M",5,6,11
"14733","Kier","M",7,7,14
"14734","Kiera","F",444,391,835
"14735","Kierah","F",12,12,24
"14736","Kieran","F",29,22,51
"14737","Kieran","M",558,534,1092
"14738","Kieren","M",14,13,27
"14739","Kiernan","F",11,13,24
"14740","Kiernan","M",40,32,72
"14741","Kieron","M",13,15,28
"14742","Kierra","F",138,95,233
"14743","Kierre","M",8,6,14
"14744","Kiersten","F",167,112,279
"14745","Kierstin","F",15,22,37
"14746","Kierstyn","F",41,34,75
"14747","Kiet","M",5,8,13
"14748","Kihara","F",6,7,13
"14749","Kiing","M",11,12,23
"14750","Kiki","F",6,14,20
"14751","Kiko","M",8,6,14
"14752","Kila","F",5,6,11
"14753","Kilah","F",12,6,18
"14754","Kilan","M",6,6,12
"14755","Kilani","F",12,10,22
"14756","Kile","M",5,9,14
"14757","Kilee","F",30,17,47
"14758","Kileigh","F",14,9,23
"14759","Kiley","F",305,212,517
"14760","Kilian","M",132,160,292
"14761","Killian","F",25,19,44
"14762","Killian","M",972,1376,2348
"14763","Killion","M",5,8,13
"14764","Kilynn","F",28,32,60
"14765","Kim","F",72,52,124
"14766","Kim","M",11,7,18
"14767","Kimani","F",46,46,92
"14768","Kimani","M",20,31,51
"14769","Kimari","F",15,15,30
"14770","Kimari","M",8,9,17
"14771","Kimaya","F",38,31,69
"14772","Kimball","M",12,16,28
"14773","Kimbella","F",21,17,38
"14774","Kimber","F",450,514,964
"14775","Kimber","M",11,8,19
"14776","Kimberlee","F",62,35,97
"14777","Kimberleigh","F",5,6,11
"14778","Kimberley","F",44,42,86
"14779","Kimberli","F",11,6,17
"14780","Kimberlie","F",11,8,19
"14781","Kimberlin","F",16,10,26
"14782","Kimberly","F",2836,2321,5157
"14783","Kimberlyn","F",87,67,154
"14784","Kimberlynn","F",48,48,96
"14785","Kimbree","F",7,8,15
"14786","Kimi","F",13,17,30
"14787","Kimi","M",38,35,73
"14788","Kimia","F",14,12,26
"14789","Kimiko","F",15,20,35
"14790","Kimimila","F",6,10,16
"14791","Kimiya","F",11,7,18
"14792","Kimiyah","F",7,9,16
"14793","Kimmie","F",9,7,16
"14794","Kimmy","F",11,15,26
"14795","Kimo","M",13,11,24
"14796","Kimoni","F",10,7,17
"14797","Kimoni","M",15,13,28
"14798","Kimora","F",282,247,529
"14799","Kimorah","F",16,15,31
"14800","Kimya","F",11,12,23
"14801","Kimyah","F",5,5,10
"14802","Kina","F",20,6,26
"14803","Kinan","M",22,22,44
"14804","Kincaid","M",13,9,22
"14805","Kinda","F",8,14,22
"14806","Kindal","F",6,5,11
"14807","Kindall","F",9,11,20
"14808","Kindle","F",20,19,39
"14809","Kindra","F",7,6,13
"14810","Kindred","F",5,10,15
"14811","Kindyl","F",6,7,13
"14812","King","M",2552,2642,5194
"14813","Kingcharles","M",5,7,12
"14814","Kingdavid","M",26,23,49
"14815","Kingdom","M",16,28,44
"14816","Kingg","M",5,5,10
"14817","Kingisaiah","M",5,7,12
"14818","Kingjames","M",17,12,29
"14819","Kingjosiah","M",6,14,20
"14820","Kingmessiah","M",6,5,11
"14821","Kingslee","F",7,15,22
"14822","Kingslee","M",13,27,40
"14823","Kingsleigh","F",8,12,20
"14824","Kingsley","F",118,125,243
"14825","Kingsley","M",322,468,790
"14826","Kingsly","M",11,6,17
"14827","Kingson","M",10,9,19
"14828","Kingstan","M",6,8,14
"14829","Kingsten","M",49,56,105
"14830","Kingstin","M",23,24,47
"14831","Kingston","F",10,15,25
"14832","Kingston","M",2942,3109,6051
"14833","Kingstyn","M",31,37,68
"14834","Kinlee","F",207,157,364
"14835","Kinleigh","F",183,183,366
"14836","Kinley","F",1405,1243,2648
"14837","Kinley","M",9,10,19
"14838","Kinlie","F",5,5,10
"14839","Kinly","F",5,5,10
"14840","Kinnick","M",33,36,69
"14841","Kinnley","F",35,20,55
"14842","Kino","M",5,8,13
"14843","Kinser","M",8,6,14
"14844","Kinsey","F",173,170,343
"14845","Kinslea","F",10,11,21
"14846","Kinslee","F",375,383,758
"14847","Kinslei","F",13,10,23
"14848","Kinsleigh","F",137,143,280
"14849","Kinsler","M",24,23,47
"14850","Kinsley","F",2771,3353,6124
"14851","Kinslie","F",31,31,62
"14852","Kinsly","F",9,11,20
"14853","Kinston","M",8,6,14
"14854","Kinza","F",15,25,40
"14855","Kinze","F",20,12,32
"14856","Kinzee","F",15,13,28
"14857","Kinzer","M",5,5,10
"14858","Kinzey","F",17,17,34
"14859","Kinzi","F",8,10,18
"14860","Kinzie","F",83,57,140
"14861","Kinzlee","F",116,136,252
"14862","Kinzleigh","F",36,27,63
"14863","Kinzley","F",205,207,412
"14864","Kinzli","F",5,5,10
"14865","Kinzlie","F",11,13,24
"14866","Kinzly","F",12,7,19
"14867","Kinzy","F",15,7,22
"14868","Kion","M",23,121,144
"14869","Kiona","F",18,14,32
"14870","Kioni","F",5,6,11
"14871","Kionna","F",11,8,19
"14872","Kiora","F",7,13,20
"14873","Kiowa","F",5,5,10
"14874","Kip","M",46,74,120
"14875","Kipling","M",5,16,21
"14876","Kipp","M",21,26,47
"14877","Kipton","M",81,93,174
"14878","Kiptyn","M",42,32,74
"14879","Kira","F",905,876,1781
"14880","Kirah","F",34,20,54
"14881","Kiralynn","F",6,8,14
"14882","Kiran","F",32,33,65
"14883","Kiran","M",124,104,228
"14884","Kirby","F",28,31,59
"14885","Kirby","M",55,44,99
"14886","Kire","M",5,12,17
"14887","Kiree","M",10,7,17
"14888","Kiren","M",8,9,17
"14889","Kiri","F",19,12,31
"14890","Kiril","M",7,6,13
"14891","Kirill","M",30,25,55
"14892","Kirin","F",11,10,21
"14893","Kirin","M",27,26,53
"14894","Kirk","M",92,79,171
"14895","Kirkland","M",14,13,27
"14896","Kirklyn","F",5,7,12
"14897","Kiro","M",5,6,11
"14898","Kiron","M",9,10,19
"14899","Kirra","F",73,55,128
"14900","Kirsten","F",120,150,270
"14901","Kirstin","F",7,11,18
"14902","Kirstyn","F",18,8,26
"14903","Kirtan","M",5,11,16
"14904","Kirubel","M",14,11,25
"14905","Kishan","M",17,7,24
"14906","Kishawn","M",13,7,20
"14907","Kit","F",28,31,59
"14908","Kit","M",40,58,98
"14909","Kitai","M",32,16,48
"14910","Kitana","F",62,51,113
"14911","Kitt","M",10,6,16
"14912","Kitty","F",10,7,17
"14913","Kitzia","F",11,12,23
"14914","Kiva","F",12,8,20
"14915","Kiya","F",88,87,175
"14916","Kiyaan","M",14,20,34
"14917","Kiyah","F",101,96,197
"14918","Kiyan","M",126,102,228
"14919","Kiyana","F",22,23,45
"14920","Kiyani","F",10,6,16
"14921","Kiyanna","F",17,16,33
"14922","Kiyara","F",7,17,24
"14923","Kiyla","F",9,8,17
"14924","Kiylee","F",7,12,19
"14925","Kiyoko","F",11,12,23
"14926","Kiyomi","F",54,31,85
"14927","Kiyon","M",20,42,62
"14928","Kiyoshi","M",5,5,10
"14929","Kizer","M",13,22,35
"14930","Kizzy","F",8,6,14
"14931","Kj","M",8,10,18
"14932","Kjerstin","F",5,9,14
"14933","Klair","F",7,10,17
"14934","Klaira","F",19,16,35
"14935","Klaire","F",74,98,172
"14936","Klani","F",16,9,25
"14937","Klara","F",113,127,240
"14938","Klare","F",6,6,12
"14939","Klarisa","F",6,6,12
"14940","Klarissa","F",59,58,117
"14941","Klark","M",11,6,17
"14942","Klarke","F",6,7,13
"14943","Klaryssa","F",5,7,12
"14944","Klaudia","F",16,21,37
"14945","Klaus","M",39,26,65
"14946","Klay","M",64,97,161
"14947","Klayten","M",11,7,18
"14948","Klayton","M",101,108,209
"14949","Klea","F",18,7,25
"14950","Klee","F",10,8,18
"14951","Klein","M",17,12,29
"14952","Kleo","F",9,9,18
"14953","Klint","M",5,5,10
"14954","Klinton","M",5,7,12
"14955","Kloe","F",118,90,208
"14956","Kloee","F",25,15,40
"14957","Kloey","F",31,42,73
"14958","Klohe","F",10,5,15
"14959","Kloie","F",35,21,56
"14960","Klover","F",18,12,30
"14961","Klyde","M",18,18,36
"14962","Klynn","F",28,35,63
"14963","Kmari","F",7,12,19
"14964","Kmari","M",12,11,23
"14965","Kmarie","F",7,7,14
"14966","Kmarion","M",5,5,10
"14967","Kmiyah","F",8,5,13
"14968","Kmya","F",9,6,15
"14969","Knight","M",57,50,107
"14970","Knightly","M",7,5,12
"14971","Knighton","M",7,6,13
"14972","Knixon","M",5,5,10
"14973","Knoah","M",16,14,30
"14974","Knolan","M",6,7,13
"14975","Knowledge","M",76,112,188
"14976","Knox","F",14,16,30
"14977","Knox","M",1399,1527,2926
"14978","Knoxx","M",24,37,61
"14979","Knyla","F",6,5,11
"14980","Ko","M",5,8,13
"14981","Koa","F",11,8,19
"14982","Koa","M",162,150,312
"14983","Koah","M",23,38,61
"14984","Koal","M",12,5,17
"14985","Kobe","F",7,20,27
"14986","Kobe","M",465,582,1047
"14987","Kobee","M",5,7,12
"14988","Koben","M",7,5,12
"14989","Kobi","F",24,33,57
"14990","Kobi","M",42,44,86
"14991","Kobie","F",8,19,27
"14992","Kobie","M",26,20,46
"14993","Koby","M",109,98,207
"14994","Kobyn","M",5,5,10
"14995","Koda","F",17,21,38
"14996","Koda","M",194,227,421
"14997","Kodah","M",22,29,51
"14998","Kodee","F",14,11,25
"14999","Koden","M",9,6,15
"15000","Kodey","M",7,11,18
"15001","Kodi","F",88,103,191
"15002","Kodi","M",54,57,111
"15003","Kodiak","M",16,25,41
"15004","Kodie","F",34,35,69
"15005","Kodie","M",19,13,32
"15006","Kody","F",14,15,29
"15007","Kody","M",307,271,578
"15008","Koehn","M",8,11,19
"15009","Koen","M",199,178,377
"15010","Kofi","M",28,22,50
"15011","Kohan","M",7,14,21
"15012","Kohana","F",6,7,13
"15013","Kohen","F",5,6,11
"15014","Kohen","M",297,380,677
"15015","Kohl","M",33,27,60
"15016","Kohlton","M",11,14,25
"15017","Koi","F",18,19,37
"15018","Koi","M",22,26,48
"15019","Koji","M",17,28,45
"15020","Koki","M",5,10,15
"15021","Kol","M",25,16,41
"15022","Kolbe","M",69,51,120
"15023","Kolbee","F",5,6,11
"15024","Kolbi","F",33,19,52
"15025","Kolbi","M",7,8,15
"15026","Kolbie","F",71,54,125
"15027","Kolbie","M",16,15,31
"15028","Kolby","F",35,38,73
"15029","Kolby","M",270,216,486
"15030","Kolden","M",15,21,36
"15031","Kole","F",6,6,12
"15032","Kole","M",311,290,601
"15033","Koleman","M",5,13,18
"15034","Koleson","M",17,14,31
"15035","Koleton","M",13,13,26
"15036","Kolette","F",18,14,32
"15037","Kolin","M",58,40,98
"15038","Kollin","M",76,55,131
"15039","Kollins","F",29,35,64
"15040","Kollyn","M",10,7,17
"15041","Kollyns","F",22,14,36
"15042","Kolsen","M",28,17,45
"15043","Kolson","M",32,36,68
"15044","Kolsten","M",5,8,13
"15045","Kolston","M",18,22,40
"15046","Kolt","M",117,122,239
"15047","Koltan","M",9,9,18
"15048","Kolten","M",307,271,578
"15049","Kolter","M",43,32,75
"15050","Koltin","M",40,30,70
"15051","Kolton","M",748,612,1360
"15052","Koltyn","M",66,58,124
"15053","Kona","F",10,6,16
"15054","Kona","M",20,19,39
"15055","Konner","F",10,11,21
"15056","Konner","M",183,210,393
"15057","Konnor","M",263,229,492
"15058","Konrad","M",75,87,162
"15059","Konstance","F",12,8,20
"15060","Konstantin","M",44,36,80
"15061","Konstantina","F",11,13,24
"15062","Konstantine","M",15,13,28
"15063","Konstantinos","M",31,35,66
"15064","Kooper","F",19,14,33
"15065","Kooper","M",200,182,382
"15066","Kopelyn","F",5,5,10
"15067","Kora","F",461,433,894
"15068","Korah","F",44,38,82
"15069","Koral","F",31,29,60
"15070","Koralee","F",12,11,23
"15071","Koralie","F",8,6,14
"15072","Koraline","F",33,42,75
"15073","Koralyn","F",22,13,35
"15074","Koralynn","F",14,20,34
"15075","Koran","M",15,5,20
"15076","Koray","M",7,9,16
"15077","Korban","M",23,36,59
"15078","Korben","M",110,118,228
"15079","Korbin","F",5,6,11
"15080","Korbin","M",463,439,902
"15081","Korbyn","F",56,52,108
"15082","Korbyn","M",170,178,348
"15083","Kord","M",19,13,32
"15084","Kordae","M",10,9,19
"15085","Kordell","M",40,35,75
"15086","Korea","F",12,7,19
"15087","Korede","M",6,8,14
"15088","Koree","F",10,19,29
"15089","Koree","M",6,8,14
"15090","Koren","M",10,5,15
"15091","Korey","F",19,19,38
"15092","Korey","M",98,103,201
"15093","Kori","F",441,473,914
"15094","Kori","M",26,28,54
"15095","Korianna","F",5,6,11
"15096","Korie","F",103,81,184
"15097","Korilynn","F",5,5,10
"15098","Korin","F",7,7,14
"15099","Korina","F",29,21,50
"15100","Korinna","F",7,6,13
"15101","Korinne","F",22,27,49
"15102","Kornelia","F",11,6,17
"15103","Korra","F",143,105,248
"15104","Korrah","F",7,8,15
"15105","Korri","F",6,11,17
"15106","Korrie","F",14,15,29
"15107","Korrin","F",5,5,10
"15108","Korrine","F",8,5,13
"15109","Korryn","F",7,18,25
"15110","Kort","M",15,14,29
"15111","Kortez","M",16,23,39
"15112","Kortland","M",7,8,15
"15113","Kortlyn","F",14,7,21
"15114","Kortlynn","F",11,9,20
"15115","Kortney","F",19,15,34
"15116","Kortni","F",8,7,15
"15117","Korver","M",9,9,18
"15118","Korvin","M",12,17,29
"15119","Kory","F",17,22,39
"15120","Kory","M",81,71,152
"15121","Koryn","F",18,22,40
"15122","Korynn","F",17,11,28
"15123","Kosisochukwu","F",9,9,18
"15124","Kosisochukwu","M",12,9,21
"15125","Kosta","M",20,15,35
"15126","Kostas","M",5,5,10
"15127","Koston","M",12,18,30
"15128","Kota","F",5,13,18
"15129","Kota","M",36,44,80
"15130","Kotaro","M",10,8,18
"15131","Kouper","M",5,11,16
"15132","Kourosh","M",8,5,13
"15133","Kourtland","M",7,9,16
"15134","Kourtlyn","F",21,22,43
"15135","Kourtlynn","F",12,14,26
"15136","Kourtnee","F",6,10,16
"15137","Kourtney","F",233,160,393
"15138","Kourtney","M",7,9,16
"15139","Kourtni","F",8,10,18
"15140","Kove","M",6,11,17
"15141","Koven","M",10,12,22
"15142","Kowen","M",21,15,36
"15143","Koy","M",28,33,61
"15144","Kratos","M",8,10,18
"15145","Krayton","M",6,9,15
"15146","Kree","F",37,32,69
"15147","Kree","M",35,33,68
"15148","Kreed","M",28,55,83
"15149","Kreighton","M",6,7,13
"15150","Krew","M",113,110,223
"15151","Krimson","F",14,16,30
"15152","Krimson","M",7,5,12
"15153","Kripa","F",11,9,20
"15154","Kris","F",24,16,40
"15155","Kris","M",58,57,115
"15156","Krish","M",190,206,396
"15157","Krisha","F",85,87,172
"15158","Krishan","M",6,12,18
"15159","Krishang","M",9,8,17
"15160","Krishav","M",22,23,45
"15161","Krishawn","M",6,8,14
"15162","Krishika","F",5,14,19
"15163","Krishiv","M",38,40,78
"15164","Krishna","F",26,24,50
"15165","Krishna","M",68,73,141
"15166","Krisley","F",6,5,11
"15167","Krislyn","F",40,29,69
"15168","Krislynn","F",38,29,67
"15169","Krissa","F",7,9,16
"15170","Krissia","F",5,7,12
"15171","Krissy","F",12,13,25
"15172","Krista","F",125,96,221
"15173","Kristabella","F",6,5,11
"15174","Kristal","F",27,38,65
"15175","Kristan","F",8,8,16
"15176","Kristan","M",9,11,20
"15177","Kristel","F",36,41,77
"15178","Kristell","F",11,25,36
"15179","Kristelle","F",8,8,16
"15180","Kristen","F",309,251,560
"15181","Kristen","M",10,12,22
"15182","Kristi","F",24,24,48
"15183","Kristian","F",26,45,71
"15184","Kristian","M",374,352,726
"15185","Kristiana","F",67,50,117
"15186","Kristianna","F",19,26,45
"15187","Kristiano","M",6,9,15
"15188","Kristie","F",26,22,48
"15189","Kristijan","M",6,5,11
"15190","Kristin","F",111,75,186
"15191","Kristina","F",378,313,691
"15192","Kristine","F",77,79,156
"15193","Kristof","M",11,9,20
"15194","Kristofer","M",50,52,102
"15195","Kristoff","M",41,27,68
"15196","Kristoffer","M",19,21,40
"15197","Kristopher","M",455,343,798
"15198","Kristy","F",50,60,110
"15199","Kristyana","F",9,7,16
"15200","Kristyn","F",29,21,50
"15201","Krithi","F",25,25,50
"15202","Krithik","M",22,29,51
"15203","Krithika","F",14,11,25
"15204","Kriti","F",36,38,74
"15205","Kritika","F",10,10,20
"15206","Kriya","F",9,9,18
"15207","Kriyansh","M",7,5,12
"15208","Krosby","M",16,9,25
"15209","Kross","M",18,26,44
"15210","Kroy","M",51,49,100
"15211","Krrish","M",7,5,12
"15212","Kru","M",17,12,29
"15213","Krue","M",44,43,87
"15214","Krupa","F",6,5,11
"15215","Kruz","M",144,121,265
"15216","Kruze","M",42,42,84
"15217","Krysta","F",18,18,36
"15218","Krystal","F",225,218,443
"15219","Krystel","F",16,27,43
"15220","Krystelle","F",7,6,13
"15221","Krysten","F",16,14,30
"15222","Krystian","M",31,40,71
"15223","Krystiana","F",22,8,30
"15224","Krystin","F",7,6,13
"15225","Krystina","F",29,18,47
"15226","Krystle","F",6,5,11
"15227","Krystopher","M",13,9,22
"15228","Ksenia","F",19,34,53
"15229","Kseniya","F",8,5,13
"15230","Kshawn","M",9,6,15
"15231","Kullen","M",36,39,75
"15232","Kunal","M",10,6,16
"15233","Kurt","M",121,122,243
"15234","Kurtis","M",78,84,162
"15235","Kush","M",35,22,57
"15236","Kushal","M",21,15,36
"15237","Kushi","F",9,5,14
"15238","Kutler","M",11,12,23
"15239","Kutter","M",20,28,48
"15240","Kuzey","M",11,15,26
"15241","Kwabena","M",12,16,28
"15242","Kwadwo","M",5,8,13
"15243","Kwaku","M",6,12,18
"15244","Kwame","M",35,51,86
"15245","Kwasi","M",10,9,19
"15246","Kween","F",6,7,13
"15247","Kweli","M",10,12,22
"15248","Kwesi","M",10,7,17
"15249","Kwynn","F",10,14,24
"15250","Ky","F",5,6,11
"15251","Ky","M",24,23,47
"15252","Kya","F",159,203,362
"15253","Kyah","F",105,129,234
"15254","Kyair","M",20,18,38
"15255","Kyaire","M",25,42,67
"15256","Kyan","M",153,155,308
"15257","Kyana","F",25,22,47
"15258","Kyani","F",9,9,18
"15259","Kyann","F",9,9,18
"15260","Kyanna","F",16,25,41
"15261","Kyara","F",72,62,134
"15262","Kyasia","F",19,10,29
"15263","Kyce","M",17,10,27
"15264","Kycen","M",10,11,21
"15265","Kydan","M",6,7,13
"15266","Kyden","M",87,87,174
"15267","Kye","F",10,13,23
"15268","Kye","M",209,348,557
"15269","Kyel","M",9,9,18
"15270","Kyelle","F",12,8,20
"15271","Kyen","M",8,13,21
"15272","Kyera","F",8,5,13
"15273","Kyeson","M",9,15,24
"15274","Kyi","M",12,10,22
"15275","Kyia","F",26,17,43
"15276","Kyiah","F",27,27,54
"15277","Kyian","M",18,12,30
"15278","Kyilee","F",8,14,22
"15279","Kyion","M",9,28,37
"15280","Kyla","F",915,882,1797
"15281","Kylah","F",227,245,472
"15282","Kylan","F",41,41,82
"15283","Kylan","M",385,435,820
"15284","Kyland","M",36,33,69
"15285","Kylani","F",13,14,27
"15286","Kylar","F",59,76,135
"15287","Kylar","M",102,111,213
"15288","Kyle","F",60,43,103
"15289","Kyle","M",2385,2018,4403
"15290","Kylea","F",29,15,44
"15291","Kyleah","F",33,37,70
"15292","Kylee","F",1388,1073,2461
"15293","Kylee","M",11,8,19
"15294","Kyleen","F",11,10,21
"15295","Kylei","F",48,39,87
"15296","Kyleigh","F",855,641,1496
"15297","Kyleigha","F",11,10,21
"15298","Kylen","F",19,30,49
"15299","Kylen","M",209,189,398
"15300","Kylene","F",11,13,24
"15301","Kyler","F",94,80,174
"15302","Kyler","M",1286,1176,2462
"15303","Kyley","F",18,18,36
"15304","Kyli","F",53,35,88
"15305","Kylia","F",14,18,32
"15306","Kyliah","F",22,21,43
"15307","Kylian","M",12,27,39
"15308","Kyliana","F",12,7,19
"15309","Kylie","F",4149,3396,7545
"15310","Kylie","M",5,5,10
"15311","Kylieann","F",13,7,20
"15312","Kyliee","F",58,46,104
"15313","Kyliegh","F",20,22,42
"15314","Kylin","F",68,56,124
"15315","Kylin","M",78,78,156
"15316","Kylina","F",6,5,11
"15317","Kylinn","F",16,19,35
"15318","Kyliyah","F",14,7,21
"15319","Kyllian","M",18,26,44
"15320","Kylo","M",35,238,273
"15321","Kylon","M",34,54,88
"15322","Kylor","M",12,19,31
"15323","Kylyn","F",10,19,29
"15324","Kylynn","F",76,56,132
"15325","Kymani","F",43,41,84
"15326","Kymani","M",227,211,438
"15327","Kymari","F",6,5,11
"15328","Kymari","M",16,22,38
"15329","Kymber","F",67,59,126
"15330","Kymberly","F",11,10,21
"15331","Kymberlynn","F",7,6,13
"15332","Kymere","M",12,7,19
"15333","Kymia","F",7,8,15
"15334","Kymiah","F",6,11,17
"15335","Kymier","M",5,5,10
"15336","Kymir","M",12,13,25
"15337","Kymoni","F",8,5,13
"15338","Kymoni","M",11,17,28
"15339","Kymora","F",11,22,33
"15340","Kyna","F",13,17,30
"15341","Kynadee","F",25,15,40
"15342","Kynadi","F",12,6,18
"15343","Kynadie","F",7,7,14
"15344","Kynan","M",9,6,15
"15345","Kyndal","F",176,139,315
"15346","Kyndall","F",288,247,535
"15347","Kyndel","F",20,11,31
"15348","Kyndell","F",39,20,59
"15349","Kyndle","F",21,16,37
"15350","Kyndra","F",14,14,28
"15351","Kynedi","F",23,16,39
"15352","Kyng","M",100,183,283
"15353","Kyngston","M",39,53,92
"15354","Kynlea","F",6,8,14
"15355","Kynlee","F",436,364,800
"15356","Kynlei","F",14,13,27
"15357","Kynleigh","F",154,143,297
"15358","Kynley","F",46,39,85
"15359","Kynli","F",21,19,40
"15360","Kynlie","F",39,41,80
"15361","Kynnadi","F",15,13,28
"15362","Kynnedi","F",69,60,129
"15363","Kynnedy","F",19,24,43
"15364","Kynnlee","F",6,8,14
"15365","Kynslee","F",153,179,332
"15366","Kynslei","F",8,8,16
"15367","Kynsleigh","F",37,36,73
"15368","Kynsley","F",65,77,142
"15369","Kynsli","F",11,6,17
"15370","Kynslie","F",28,30,58
"15371","Kynzee","F",9,8,17
"15372","Kynzi","F",14,10,24
"15373","Kynzie","F",43,40,83
"15374","Kynzlee","F",91,85,176
"15375","Kynzleigh","F",35,43,78
"15376","Kynzley","F",17,13,30
"15377","Kynzli","F",7,8,15
"15378","Kynzlie","F",18,15,33
"15379","Kyo","M",8,5,13
"15380","Kyomi","F",6,6,12
"15381","Kyon","M",16,51,67
"15382","Kyonna","F",8,6,14
"15383","Kypton","M",15,10,25
"15384","Kyra","F",648,568,1216
"15385","Kyrah","F",71,70,141
"15386","Kyran","M",108,127,235
"15387","Kyre","M",19,20,39
"15388","Kyree","F",39,42,81
"15389","Kyree","M",361,403,764
"15390","Kyreese","M",6,10,16
"15391","Kyrell","M",29,25,54
"15392","Kyren","F",6,6,12
"15393","Kyren","M",154,181,335
"15394","Kyrese","M",19,11,30
"15395","Kyri","F",20,25,45
"15396","Kyri","M",19,14,33
"15397","Kyria","F",21,13,34
"15398","Kyrian","M",32,27,59
"15399","Kyriana","F",8,6,14
"15400","Kyrianna","F",7,8,15
"15401","Kyrie","F",178,195,373
"15402","Kyrie","M",1031,1256,2287
"15403","Kyriee","M",6,13,19
"15404","Kyriel","F",6,5,11
"15405","Kyrielle","F",19,16,35
"15406","Kyrillos","M",12,14,26
"15407","Kyrin","F",7,7,14
"15408","Kyrin","M",106,98,204
"15409","Kyro","M",24,44,68
"15410","Kyron","M",151,131,282
"15411","Kyros","M",11,12,23
"15412","Kyrsten","F",17,10,27
"15413","Kyrus","M",7,9,16
"15414","Kysa","F",7,9,16
"15415","Kysen","M",79,98,177
"15416","Kyser","M",21,31,52
"15417","Kyshaun","M",9,7,16
"15418","Kyshawn","M",11,5,16
"15419","Kyson","M",532,557,1089
"15420","Kyston","M",8,10,18
"15421","Kytzia","F",6,7,13
"15422","Kyus","M",7,8,15
"15423","Kyven","M",5,7,12
"15424","Kyzen","M",12,9,21
"15425","Kyzer","M",100,108,208
"15426","Laakea","M",10,6,16
"15427","Laasya","F",20,10,30
"15428","Labella","F",9,15,24
"15429","Labria","F",6,7,13
"15430","Lacee","F",37,23,60
"15431","Lacey","F",671,634,1305
"15432","Lachelle","F",9,8,17
"15433","Lachlan","F",16,15,31
"15434","Lachlan","M",310,351,661
"15435","Lachlyn","F",20,14,34
"15436","Laci","F",131,90,221
"15437","Lacie","F",139,120,259
"15438","Lacy","F",156,117,273
"15439","Lada","F",6,9,15
"15440","Ladarion","M",5,5,10
"15441","Ladarius","M",47,44,91
"15442","Ladarrius","M",12,11,23
"15443","Ladd","M",17,16,33
"15444","Ladell","M",10,6,16
"15445","Laden","M",6,5,11
"15446","Ladon","M",12,15,27
"15447","Ladonna","F",11,11,22
"15448","Lady","F",10,48,58
"15449","Laekyn","F",15,20,35
"15450","Lael","F",77,59,136
"15451","Lael","M",33,33,66
"15452","Laela","F",46,60,106
"15453","Laelah","F",32,35,67
"15454","Laelani","F",11,6,17
"15455","Laelia","F",11,17,28
"15456","Laelle","F",10,16,26
"15457","Laelyn","F",6,17,23
"15458","Laelynn","F",22,13,35
"15459","Lafayette","M",10,14,24
"15460","Lahari","F",5,8,13
"15461","Lahela","F",7,5,12
"15462","Lahna","F",25,30,55
"15463","Laia","F",45,55,100
"15464","Laiah","F",24,19,43
"15465","Laiana","F",13,10,23
"15466","Laianna","F",9,9,18
"15467","Laiba","F",27,25,52
"15468","Laiden","M",23,18,41
"15469","Laiken","F",59,88,147
"15470","Laiken","M",22,31,53
"15471","Laiklyn","F",29,20,49
"15472","Laiklynn","F",8,7,15
"15473","Laikyn","F",101,124,225
"15474","Laikynn","F",23,26,49
"15475","Laila","F",1884,1937,3821
"15476","Lailah","F",405,396,801
"15477","Lailana","F",5,6,11
"15478","Lailani","F",95,107,202
"15479","Lailanie","F",9,8,17
"15480","Lailany","F",12,7,19
"15481","Lailoni","F",10,10,20
"15482","Lailyn","F",10,13,23
"15483","Lailynn","F",13,15,28
"15484","Lain","M",17,12,29
"15485","Laina","F",102,95,197
"15486","Laine","F",85,92,177
"15487","Laine","M",33,30,63
"15488","Lainee","F",30,39,69
"15489","Lainey","F",527,571,1098
"15490","Laini","F",9,9,18
"15491","Lainie","F",27,29,56
"15492","Lainy","F",9,6,15
"15493","Laionna","F",5,7,12
"15494","Laird","M",9,12,21
"15495","Laisha","F",20,14,34
"15496","Laith","M",127,125,252
"15497","Laithan","M",13,8,21
"15498","Laityn","F",19,20,39
"15499","Laiya","F",25,30,55
"15500","Laiyah","F",112,81,193
"15501","Laiyla","F",14,16,30
"15502","Laiylah","F",5,7,12
"15503","Lajuan","M",8,7,15
"15504","Lakai","F",8,6,14
"15505","Lakai","M",32,23,55
"15506","Lakayla","F",28,16,44
"15507","Lake","F",48,43,91
"15508","Lake","M",64,62,126
"15509","Lakeisha","F",6,6,12
"15510","Lakeland","M",11,7,18
"15511","Lakely","F",17,24,41
"15512","Lakelyn","F",99,100,199
"15513","Lakelynn","F",44,55,99
"15514","Laken","F",133,169,302
"15515","Laken","M",108,90,198
"15516","Lakendrick","M",9,12,21
"15517","Lakenya","F",7,6,13
"15518","Lakenzie","F",5,7,12
"15519","Lakeyn","F",9,14,23
"15520","Lakia","F",5,6,11
"15521","Lakin","F",32,24,56
"15522","Lakin","M",25,18,43
"15523","Lakiya","F",8,5,13
"15524","Laklyn","F",7,6,13
"15525","Lakoda","M",13,9,22
"15526","Lakota","F",47,38,85
"15527","Lakota","M",44,41,85
"15528","Laksh","M",30,15,45
"15529","Lakshana","F",5,6,11
"15530","Lakshmi","F",30,29,59
"15531","Lakshya","M",7,5,12
"15532","Lakyn","F",151,143,294
"15533","Lakyn","M",8,8,16
"15534","Lakynn","F",59,39,98
"15535","Lala","F",9,9,18
"15536","Lalah","F",14,14,28
"15537","Lalani","F",13,13,26
"15538","Lalia","F",10,6,16
"15539","Lam","M",8,17,25
"15540","Lama","F",11,15,26
"15541","Lamar","F",60,59,119
"15542","Lamar","M",275,228,503
"15543","Lamarcus","M",45,32,77
"15544","Lamari","F",8,6,14
"15545","Lamari","M",20,22,42
"15546","Lamaria","F",8,7,15
"15547","Lamarion","M",33,33,66
"15548","Lamarr","M",21,21,42
"15549","Lamaya","F",19,21,40
"15550","Lambert","M",15,12,27
"15551","Lamees","F",16,23,39
"15552","Lamel","M",6,5,11
"15553","Lamia","F",35,35,70
"15554","Lamiah","F",17,16,33
"15555","Lamichael","M",8,8,16
"15556","Lamin","M",7,14,21
"15557","Lamine","M",12,12,24
"15558","Lamir","M",22,25,47
"15559","Lamis","F",5,9,14
"15560","Lamiya","F",34,21,55
"15561","Lamiyah","F",50,49,99
"15562","Lamon","M",5,7,12
"15563","Lamond","M",5,7,12
"15564","Lamont","M",120,115,235
"15565","Lamonte","M",24,33,57
"15566","Lamya","F",64,49,113
"15567","Lamyah","F",21,11,32
"15568","Lamyia","F",14,11,25
"15569","Lamyiah","F",5,5,10
"15570","Lan","F",5,6,11
"15571","Lana","F",920,841,1761
"15572","Lanae","F",41,43,84
"15573","Lanah","F",29,27,56
"15574","Lanai","F",16,12,28
"15575","Lanaiya","F",8,5,13
"15576","Lanasia","F",9,10,19
"15577","Lanay","F",13,15,28
"15578","Lanaya","F",32,39,71
"15579","Lanayah","F",12,12,24
"15580","Lance","M",452,433,885
"15581","Lancelot","M",11,9,20
"15582","Landan","M",75,65,140
"15583","Landen","F",9,10,19
"15584","Landen","M",1005,812,1817
"15585","Lander","M",29,17,46
"15586","Landin","M",66,61,127
"15587","Landis","M",20,34,54
"15588","Lando","M",14,20,34
"15589","Landon","F",32,53,85
"15590","Landon","M",7918,6987,14905
"15591","Landree","F",42,59,101
"15592","Landrey","F",19,21,40
"15593","Landri","F",50,52,102
"15594","Landrie","F",62,79,141
"15595","Landry","F",297,327,624
"15596","Landry","M",261,285,546
"15597","Landy","F",7,5,12
"15598","Landyn","F",76,76,152
"15599","Landyn","M",673,559,1232
"15600","Landynn","M",16,9,25
"15601","Lane","F",98,85,183
"15602","Lane","M",1206,1224,2430
"15603","Lanea","F",16,7,23
"15604","Lanee","F",9,10,19
"15605","Lanessa","F",7,9,16
"15606","Lanette","F",5,6,11
"15607","Laney","F",442,366,808
"15608","Langdon","M",19,15,34
"15609","Langley","F",38,34,72
"15610","Langley","M",7,6,13
"15611","Langston","F",19,20,39
"15612","Langston","M",364,400,764
"15613","Lani","F",66,78,144
"15614","Lania","F",19,13,32
"15615","Laniah","F",31,26,57
"15616","Lanie","F",101,84,185
"15617","Laniece","F",7,8,15
"15618","Lanier","F",9,9,18
"15619","Lanier","M",5,5,10
"15620","Lanita","F",11,6,17
"15621","Laniya","F",116,95,211
"15622","Laniyah","F",189,144,333
"15623","Lanna","F",29,38,67
"15624","Lannah","F",10,8,18
"15625","Lannie","F",7,5,12
"15626","Lanora","F",13,15,28
"15627","Lanson","M",6,8,14
"15628","Lanya","F",23,19,42
"15629","Lanyah","F",15,7,22
"15630","Lanyia","F",7,8,15
"15631","Lanyiah","F",13,10,23
"15632","Lanyla","F",13,8,21
"15633","Laquan","M",28,32,60
"15634","Lara","F",342,377,719
"15635","Larae","F",9,15,24
"15636","Larah","F",6,7,13
"15637","Laramie","F",21,35,56
"15638","Laramie","M",25,28,53
"15639","Laraya","F",7,11,18
"15640","Larayah","F",10,10,20
"15641","Lareen","F",34,33,67
"15642","Lareina","F",14,20,34
"15643","Larell","M",8,7,15
"15644","Larenz","M",17,12,29
"15645","Larenzo","M",20,21,41
"15646","Lariah","F",57,48,105
"15647","Larimar","F",7,6,13
"15648","Larisa","F",14,21,35
"15649","Larissa","F",216,178,394
"15650","Lariya","F",18,9,27
"15651","Lariyah","F",47,48,95
"15652","Lark","F",38,40,78
"15653","Larken","M",5,5,10
"15654","Larkin","F",81,93,174
"15655","Larkin","M",42,53,95
"15656","Larkyn","F",22,29,51
"15657","Laron","M",50,53,103
"15658","Larose","F",10,9,19
"15659","Laroy","M",5,7,12
"15660","Larry","M",513,442,955
"15661","Lars","M",91,109,200
"15662","Larsen","M",21,12,33
"15663","Larson","F",10,7,17
"15664","Larson","M",37,46,83
"15665","Larsyn","F",6,5,11
"15666","Larue","F",7,8,15
"15667","Larue","M",7,6,13
"15668","Laryah","F",11,10,21
"15669","Laryiah","F",9,7,16
"15670","Laryn","F",6,9,15
"15671","Laryssa","F",15,9,24
"15672","Lasean","M",10,5,15
"15673","Lashae","F",14,12,26
"15674","Lashaun","M",17,13,30
"15675","Lashawn","F",6,6,12
"15676","Lashawn","M",34,38,72
"15677","Lashawna","F",8,7,15
"15678","Lashay","F",19,19,38
"15679","Lashea","F",5,5,10
"15680","Lashon","M",8,6,14
"15681","Lashonda","F",9,5,14
"15682","Lason","M",5,6,11
"15683","Lasya","F",22,20,42
"15684","Laszlo","M",23,28,51
"15685","Latasha","F",11,11,22
"15686","Latavia","F",14,8,22
"15687","Lateen","F",5,7,12
"15688","Latham","M",29,16,45
"15689","Lathan","M",164,170,334
"15690","Lathen","M",10,9,19
"15691","Lathyn","M",6,6,12
"15692","Latifa","F",9,10,19
"15693","Latisha","F",12,5,17
"15694","Latonya","F",5,5,10
"15695","Latoya","F",21,13,34
"15696","Latrell","M",38,42,80
"15697","Latrice","F",10,10,20
"15698","Latroy","M",9,8,17
"15699","Laughlin","M",5,6,11
"15700","Launa","F",21,27,48
"15701","Laura","F",1005,958,1963
"15702","Lauralee","F",11,9,20
"15703","Lauralye","F",11,6,17
"15704","Lauralynn","F",6,7,13
"15705","Lauran","F",6,5,11
"15706","Laureen","F",7,15,22
"15707","Laurel","F",368,456,824
"15708","Laurelai","F",8,13,21
"15709","Laurelei","F",9,8,17
"15710","Laureli","F",9,5,14
"15711","Laurelin","F",5,7,12
"15712","Lauren","F",2686,2311,4997
"15713","Lauren","M",7,8,15
"15714","Laurence","M",59,55,114
"15715","Laurent","M",12,11,23
"15716","Lauretta","F",7,12,19
"15717","Lauriana","F",6,9,15
"15718","Laurie","F",70,46,116
"15719","Lauriel","F",11,14,25
"15720","Lauro","M",19,13,32
"15721","Lauryn","F",620,585,1205
"15722","Laurynn","F",27,34,61
"15723","Lavada","F",8,7,15
"15724","Lavaeh","F",8,11,19
"15725","Lavanya","F",10,7,17
"15726","Lavar","M",11,15,26
"15727","Lavaya","F",7,10,17
"15728","Lavayah","F",16,7,23
"15729","Laveah","F",28,17,45
"15730","Lavell","M",36,25,61
"15731","Lavelle","M",22,23,45
"15732","Lavender","F",61,82,143
"15733","Laveon","M",5,6,11
"15734","Lavern","M",20,20,40
"15735","Laverne","M",10,6,16
"15736","Lavi","M",10,17,27
"15737","Lavin","M",7,11,18
"15738","Lavina","F",38,27,65
"15739","Lavinia","F",63,75,138
"15740","Lavon","M",57,49,106
"15741","Lavonna","F",6,13,19
"15742","Lavontae","M",8,9,17
"15743","Lavonte","M",22,17,39
"15744","Law","M",6,11,17
"15745","Lawaia","M",5,5,10
"15746","Lawren","F",17,17,34
"15747","Lawrence","M",582,612,1194
"15748","Lawsen","M",18,14,32
"15749","Lawson","F",29,27,56
"15750","Lawson","M",698,705,1403
"15751","Lawsyn","F",7,7,14
"15752","Lawsyn","M",8,14,22
"15753","Lawton","M",37,32,69
"15754","Laxmi","F",7,5,12
"15755","Laya","F",98,99,197
"15756","Layaan","F",5,12,17
"15757","Layah","F",74,91,165
"15758","Layal","F",34,37,71
"15759","Layali","F",7,13,20
"15760","Layan","F",159,174,333
"15761","Layana","F",28,35,63
"15762","Layani","F",13,17,30
"15763","Layann","F",6,11,17
"15764","Layanna","F",20,24,44
"15765","Laycee","F",26,31,57
"15766","Laycie","F",18,20,38
"15767","Layden","F",6,5,11
"15768","Layden","M",73,49,122
"15769","Laydon","M",5,7,12
"15770","Layia","F",5,7,12
"15771","Layiah","F",6,5,11
"15772","Layken","F",56,65,121
"15773","Layken","M",19,22,41
"15774","Laykin","F",25,34,59
"15775","Laykyn","F",6,6,12
"15776","Layla","F",6314,6234,12548
"15777","Laylaa","F",6,9,15
"15778","Laylah","F",403,429,832
"15779","Laylana","F",5,6,11
"15780","Laylani","F",109,136,245
"15781","Laylanie","F",20,26,46
"15782","Laylee","F",15,15,30
"15783","Layleigh","F",8,6,14
"15784","Layliana","F",13,11,24
"15785","Laylianna","F",8,7,15
"15786","Layloni","F",13,15,28
"15787","Laylonie","F",10,5,15
"15788","Laylonnie","F",9,9,18
"15789","Laylynn","F",6,7,13
"15790","Layn","M",5,6,11
"15791","Layna","F",108,118,226
"15792","Layne","F",90,73,163
"15793","Layne","M",350,337,687
"15794","Laynee","F",65,59,124
"15795","Layney","F",6,7,13
"15796","Layni","F",21,13,34
"15797","Laynie","F",78,65,143
"15798","Layonna","F",18,16,34
"15799","Laysha","F",16,12,28
"15800","Layson","M",18,19,37
"15801","Layten","M",32,10,42
"15802","Layth","M",37,38,75
"15803","Laythan","M",11,15,26
"15804","Laytin","M",9,5,14
"15805","Layton","F",56,42,98
"15806","Layton","M",522,417,939
"15807","Lazar","M",23,11,34
"15808","Lazaria","F",21,10,31
"15809","Lazariah","F",9,9,18
"15810","Lazaro","M",87,94,181
"15811","Lazarus","M",117,133,250
"15812","Lazer","M",29,41,70
"15813","Laziyah","F",5,7,12
"15814","Lazlo","M",6,11,17
"15815","Lea","F",380,419,799
"15816","Leaf","M",6,11,17
"15817","Leah","F",5606,5380,10986
"15818","Leahmarie","F",10,8,18
"15819","Leahna","F",13,9,22
"15820","Leala","F",10,8,18
"15821","Leam","M",19,22,41
"15822","Leamarie","F",5,5,10
"15823","Leamsi","F",5,5,10
"15824","Lean","F",7,7,14
"15825","Lean","M",14,8,22
"15826","Leana","F",71,65,136
"15827","Leanah","F",6,6,12
"15828","Leander","M",73,83,156
"15829","Leandra","F",50,58,108
"15830","Leandre","M",35,27,62
"15831","Leandrew","M",6,6,12
"15832","Leandro","M",298,357,655
"15833","Leani","F",11,8,19
"15834","Leann","F",81,68,149
"15835","Leanna","F",368,354,722
"15836","Leannah","F",15,13,28
"15837","Leanne","F",116,128,244
"15838","Leannie","F",8,5,13
"15839","Leanora","F",14,19,33
"15840","Leara","F",5,12,17
"15841","Leart","M",7,6,13
"15842","Leasia","F",35,26,61
"15843","Leba","F",5,10,15
"15844","Lebron","M",35,29,64
"15845","Leda","F",27,24,51
"15846","Leddy","F",7,11,18
"15847","Ledger","M",159,161,320
"15848","Lee","F",24,31,55
"15849","Lee","M",372,382,754
"15850","Leea","F",13,5,18
"15851","Leeah","F",51,49,100
"15852","Leeam","M",27,27,54
"15853","Leeana","F",29,25,54
"15854","Leeani","F",12,8,20
"15855","Leeann","F",61,69,130
"15856","Leeanna","F",49,46,95
"15857","Leeanne","F",15,13,28
"15858","Leeba","F",20,18,38
"15859","Leela","F",204,231,435
"15860","Leelah","F",23,27,50
"15861","Leelan","M",44,31,75
"15862","Leeland","M",132,143,275
"15863","Leeloo","F",6,11,17
"15864","Leelyn","F",5,5,10
"15865","Leelyn","M",8,9,17
"15866","Leelynd","M",8,7,15
"15867","Leelynn","M",12,12,24
"15868","Leen","F",99,109,208
"15869","Leena","F",196,188,384
"15870","Leenah","F",8,12,20
"15871","Leeroy","M",30,25,55
"15872","Leevi","M",39,36,75
"15873","Leeya","F",18,19,37
"15874","Leeyah","F",23,25,48
"15875","Legacee","F",5,14,19
"15876","Legaci","F",23,26,49
"15877","Legacie","F",13,18,31
"15878","Legacy","F",163,250,413
"15879","Legacy","M",59,77,136
"15880","Legend","F",52,70,122
"15881","Legend","M",810,1130,1940
"15882","Legion","M",21,19,40
"15883","Legna","F",11,6,17
"15884","Lehi","M",13,10,23
"15885","Lehua","F",5,5,10
"15886","Leia","F",762,1005,1767
"15887","Leiah","F",50,63,113
"15888","Leialoha","F",7,7,14
"15889","Leiam","M",13,11,24
"15890","Leiana","F",47,43,90
"15891","Leianah","F",5,6,11
"15892","Leiani","F",19,25,44
"15893","Leiann","F",6,6,12
"15894","Leianna","F",28,28,56
"15895","Leib","M",12,11,23
"15896","Leibish","M",9,10,19
"15897","Leiby","M",7,5,12
"15898","Leidy","F",28,45,73
"15899","Leif","M",187,211,398
"15900","Leigh","F",47,62,109
"15901","Leigh","M",7,5,12
"15902","Leigha","F",162,136,298
"15903","Leighana","F",15,14,29
"15904","Leighann","F",28,25,53
"15905","Leighanna","F",30,40,70
"15906","Leighla","F",39,48,87
"15907","Leighlani","F",10,6,16
"15908","Leighton","F",678,754,1432
"15909","Leighton","M",261,261,522
"15910","Leightyn","F",18,15,33
"15911","Leila","F",1303,1383,2686
"15912","Leilah","F",196,176,372
"15913","Leilana","F",34,25,59
"15914","Leiland","M",30,29,59
"15915","Leilanee","F",8,8,16
"15916","Leilani","F",1794,1959,3753
"15917","Leilanie","F",45,46,91
"15918","Leilanii","F",6,6,12
"15919","Leilanni","F",18,27,45
"15920","Leilanny","F",10,11,21
"15921","Leilany","F",175,189,364
"15922","Leiliana","F",17,12,29
"15923","Leiloni","F",13,18,31
"15924","Leina","F",27,25,52
"15925","Leira","F",13,17,30
"15926","Leire","F",14,7,21
"15927","Leisel","F",11,6,17
"15928","Leith","M",10,12,22
"15929","Leiya","F",11,18,29
"15930","Leiyah","F",18,16,34
"15931","Lejend","M",5,15,20
"15932","Lejla","F",25,24,49
"15933","Lela","F",146,148,294
"15934","Lelah","F",20,19,39
"15935","Lelan","M",19,28,47
"15936","Leland","F",11,13,24
"15937","Leland","M",849,753,1602
"15938","Lelani","F",23,14,37
"15939","Lelia","F",39,34,73
"15940","Leliana","F",32,34,66
"15941","Lemar","M",9,19,28
"15942","Lemon","F",8,26,34
"15943","Lemuel","M",72,48,120
"15944","Len","M",12,10,22
"15945","Lena","F",1160,1134,2294
"15946","Lenae","F",7,8,15
"15947","Lenah","F",10,12,22
"15948","Lenard","M",17,13,30
"15949","Lenayah","F",8,5,13
"15950","Lendon","M",6,11,17
"15951","Leni","F",40,51,91
"15952","Leniel","M",6,8,14
"15953","Lenin","M",66,59,125
"15954","Lenise","F",7,9,16
"15955","Lenix","F",9,12,21
"15956","Lenix","M",11,8,19
"15957","Leniyah","F",12,9,21
"15958","Lenna","F",44,45,89
"15959","Lennan","F",12,24,36
"15960","Lennard","M",10,6,16
"15961","Lennex","F",11,7,18
"15962","Lennex","M",5,7,12
"15963","Lenni","F",8,15,23
"15964","Lennie","F",9,8,17
"15965","Lennie","M",5,5,10
"15966","Lennin","M",10,14,24
"15967","Lennix","F",29,40,69
"15968","Lennix","M",23,24,47
"15969","Lennon","F",605,649,1254
"15970","Lennon","M",440,446,886
"15971","Lennox","F",379,394,773
"15972","Lennox","M",598,692,1290
"15973","Lenny","F",13,12,25
"15974","Lenny","M",164,122,286
"15975","Lennyn","F",23,45,68
"15976","Lennyx","F",12,18,30
"15977","Lenora","F",131,173,304
"15978","Lenorah","F",6,9,15
"15979","Lenore","F",67,65,132
"15980","Lenox","F",54,37,91
"15981","Lenox","M",86,90,176
"15982","Lenoxx","M",6,10,16
"15983","Lenya","F",7,12,19
"15984","Lenyx","F",24,23,47
"15985","Lenyx","M",5,6,11
"15986","Leo","F",11,13,24
"15987","Leo","M",4582,5260,9842
"15988","Leobardo","M",38,48,86
"15989","Leodan","M",6,11,17
"15990","Leola","F",16,15,31
"15991","Leon","M",1133,1303,2436
"15992","Leona","F",417,501,918
"15993","Leonard","M",396,446,842
"15994","Leonardo","M",3814,4310,8124
"15995","Leondre","M",17,15,32
"15996","Leone","F",8,5,13
"15997","Leone","M",23,12,35
"15998","Leonel","M",819,886,1705
"15999","Leonela","F",12,8,20
"16000","Leonell","M",10,8,18
"16001","Leonella","F",5,5,10
"16002","Leoni","F",14,10,24
"16003","Leonid","M",17,27,44
"16004","Leonidas","M",553,591,1144
"16005","Leonides","M",17,14,31
"16006","Leonidus","M",13,12,25
"16007","Leonie","F",39,63,102
"16008","Leonitus","M",8,6,14
"16009","Leonna","F",31,42,73
"16010","Leonor","F",40,43,83
"16011","Leonora","F",47,51,98
"16012","Leonore","F",7,5,12
"16013","Leopold","M",92,91,183
"16014","Leopoldo","M",45,41,86
"16015","Leor","M",8,5,13
"16016","Leora","F",86,94,180
"16017","Leovanni","M",12,8,20
"16018","Lera","F",13,12,25
"16019","Leron","M",11,17,28
"16020","Leroy","M",206,227,433
"16021","Les","M",10,14,24
"16022","Lesean","M",9,7,16
"16023","Leshawn","M",15,9,24
"16024","Leslee","F",14,7,21
"16025","Lesleigh","F",5,6,11
"16026","Lesley","F",96,76,172
"16027","Lesley","M",6,8,14
"16028","Lesli","F",25,10,35
"16029","Leslie","F",878,801,1679
"16030","Leslie","M",54,45,99
"16031","Lesly","F",230,194,424
"16032","Leslye","F",7,11,18
"16033","Lessly","F",8,9,17
"16034","Lestat","M",13,22,35
"16035","Lester","M",101,102,203
"16036","Leta","F",9,14,23
"16037","Letha","F",8,9,17
"16038","Leticia","F",154,148,302
"16039","Letizia","F",14,10,24
"16040","Leto","M",6,8,14
"16041","Letti","F",31,57,88
"16042","Lettie","F",104,106,210
"16043","Letty","F",128,158,286
"16044","Leul","M",11,18,29
"16045","Lev","M",137,153,290
"16046","Levan","M",6,10,16
"16047","Levar","M",10,11,21
"16048","Leveah","F",5,5,10
"16049","Leven","M",13,7,20
"16050","Levent","M",13,8,21
"16051","Leveon","M",21,35,56
"16052","Levi","F",59,63,122
"16053","Levi","M",8280,8009,16289
"16054","Levian","M",7,7,14
"16055","Leviathan","M",44,27,71
"16056","Levii","M",17,19,36
"16057","Levin","M",32,51,83
"16058","Levina","F",8,7,15
"16059","Leviticus","M",53,51,104
"16060","Levon","M",109,114,223
"16061","Levy","F",8,15,23
"16062","Levy","M",47,56,103
"16063","Lewi","M",8,10,18
"16064","Lewin","M",8,9,17
"16065","Lewis","M",490,582,1072
"16066","Lex","M",67,76,143
"16067","Lexa","F",42,58,100
"16068","Lexander","M",6,6,12
"16069","Lexani","F",24,19,43
"16070","Lexee","F",9,10,19
"16071","Lexi","F",1050,1019,2069
"16072","Lexia","F",18,15,33
"16073","Lexiana","F",5,8,13
"16074","Lexianna","F",7,7,14
"16075","Lexie","F",399,381,780
"16076","Lexii","F",11,11,22
"16077","Lexine","F",8,5,13
"16078","Lexington","F",81,77,158
"16079","Lexington","M",36,46,82
"16080","Lexis","F",35,23,58
"16081","Lexon","M",9,7,16
"16082","Lexton","M",19,19,38
"16083","Lexus","F",70,38,108
"16084","Lexxi","F",9,6,15
"16085","Lexy","F",72,76,148
"16086","Leya","F",56,63,119
"16087","Leyah","F",60,52,112
"16088","Leyan","F",10,7,17
"16089","Leyana","F",17,18,35
"16090","Leyani","F",6,11,17
"16091","Leyanna","F",16,19,35
"16092","Leyda","F",5,8,13
"16093","Leydi","F",11,25,36
"16094","Leyla","F",360,399,759
"16095","Leylah","F",55,62,117
"16096","Leyland","M",21,19,40
"16097","Leylani","F",82,103,185
"16098","Leylanie","F",25,18,43
"16099","Leylany","F",11,9,20
"16100","Leyna","F",72,73,145
"16101","Leyonna","F",6,7,13
"16102","Leyton","F",19,19,38
"16103","Leyton","M",117,117,234
"16104","Lezlie","F",7,7,14
"16105","Lia","F",991,980,1971
"16106","Liah","F",119,137,256
"16107","Liahm","M",9,10,19
"16108","Liahna","F",13,12,25
"16109","Liahona","F",5,6,11
"16110","Liam","F",21,19,40
"16111","Liam","M",18330,18138,36468
"16112","Liamjames","M",5,7,12
"16113","Lian","F",39,45,84
"16114","Lian","M",165,195,360
"16115","Liana","F",594,680,1274
"16116","Lianah","F",10,9,19
"16117","Liandro","M",12,9,21
"16118","Liane","F",10,7,17
"16119","Liani","F",28,26,54
"16120","Lianna","F",204,180,384
"16121","Liannah","F",14,6,20
"16122","Lianne","F",15,25,40
"16123","Lianni","F",7,5,12
"16124","Lianny","F",12,12,24
"16125","Liany","F",12,16,28
"16126","Liara","F",50,53,103
"16127","Liat","F",21,15,36
"16128","Liav","M",5,5,10
"16129","Liba","F",50,33,83
"16130","Liban","M",11,21,32
"16131","Libbie","F",19,12,31
"16132","Libby","F",269,250,519
"16133","Liberti","F",5,8,13
"16134","Liberty","F",560,571,1131
"16135","Libi","F",8,11,19
"16136","Libni","F",12,8,20
"16137","Libny","F",6,6,12
"16138","Librado","M",6,9,15
"16139","Lida","F",14,10,24
"16140","Lidia","F",154,150,304
"16141","Lidya","F",18,9,27
"16142","Liel","F",17,18,35
"16143","Liela","F",8,8,16
"16144","Lielle","F",23,14,37
"16145","Liem","M",41,44,85
"16146","Liesel","F",63,51,114
"16147","Liesl","F",50,36,86
"16148","Liev","M",44,58,102
"16149","Liezel","F",5,5,10
"16150","Light","M",7,5,12
"16151","Lijah","M",8,11,19
"16152","Lila","F",1650,1549,3199
"16153","Lilac","F",13,17,30
"16154","Lilah","F",1027,1082,2109
"16155","Lilas","F",5,5,10
"16156","Lilee","F",37,37,74
"16157","Lileigh","F",18,11,29
"16158","Lili","F",59,60,119
"16159","Lilia","F",282,266,548
"16160","Liliah","F",17,9,26
"16161","Liliahna","F",9,10,19
"16162","Lilian","F",637,549,1186
"16163","Liliana","F",2556,2624,5180
"16164","Lilianah","F",10,12,22
"16165","Liliane","F",33,33,66
"16166","Liliani","F",9,10,19
"16167","Liliann","F",28,23,51
"16168","Lilianna","F",396,415,811
"16169","Liliannah","F",7,7,14
"16170","Lilianne","F",36,29,65
"16171","Liliauna","F",5,6,11
"16172","Lilibeth","F",20,30,50
"16173","Lilie","F",11,18,29
"16174","Lilienne","F",8,7,15
"16175","Lilikoi","F",5,8,13
"16176","Lilinoe","F",12,10,22
"16177","Lilit","F",8,8,16
"16178","Lilith","F",512,580,1092
"16179","Liliya","F",17,31,48
"16180","Lilja","F",14,11,25
"16181","Lilla","F",40,26,66
"16182","Lillah","F",10,9,19
"16183","Lillee","F",64,53,117
"16184","Lilleigh","F",16,6,22
"16185","Lilley","F",15,15,30
"16186","Lilli","F",70,72,142
"16187","Lillia","F",62,61,123
"16188","Lilliah","F",8,9,17
"16189","Lilliahna","F",7,7,14
"16190","Lillian","F",6597,6333,12930
"16191","Lilliana","F",1169,1126,2295
"16192","Lilliani","F",5,8,13
"16193","Lilliann","F",44,62,106
"16194","Lillianna","F",353,316,669
"16195","Lilliannah","F",5,11,16
"16196","Lillianne","F",49,48,97
"16197","Lillie","F",526,490,1016
"16198","Lillieann","F",12,11,23
"16199","Lillieanna","F",8,7,15
"16200","Lilliemae","F",5,5,10
"16201","Lillien","F",11,14,25
"16202","Lillienne","F",7,5,12
"16203","Lilliona","F",9,9,18
"16204","Lillionna","F",5,9,14
"16205","Lillith","F",84,109,193
"16206","Lilly","F",2297,2132,4429
"16207","Lillyan","F",80,64,144
"16208","Lillyana","F",208,196,404
"16209","Lillyanah","F",7,5,12
"16210","Lillyann","F",133,144,277
"16211","Lillyanna","F",212,181,393
"16212","Lillyanne","F",53,60,113
"16213","Lillymae","F",11,8,19
"16214","Lillyona","F",10,9,19
"16215","Lillyonna","F",21,12,33
"16216","Lillyrose","F",11,10,21
"16217","Lillyth","F",10,9,19
"16218","Lilo","F",17,28,45
"16219","Lilou","F",22,41,63
"16220","Lilu","F",14,6,20
"16221","Lily","F",6644,6558,13202
"16222","Lilya","F",22,25,47
"16223","Lilyahna","F",11,11,22
"16224","Lilyan","F",88,81,169
"16225","Lilyana","F",532,440,972
"16226","Lilyanah","F",10,14,24
"16227","Lilyann","F",179,174,353
"16228","Lilyanna","F",279,264,543
"16229","Lilyannah","F",9,11,20
"16230","Lilyanne","F",75,94,169
"16231","Lilyauna","F",6,7,13
"16232","Lilybelle","F",11,11,22
"16233","Lilybeth","F",16,13,29
"16234","Lilygrace","F",15,8,23
"16235","Lilymae","F",13,12,25
"16236","Lilyona","F",10,7,17
"16237","Lilyonna","F",13,15,28
"16238","Lilyrose","F",36,31,67
"16239","Lilyth","F",21,26,47
"16240","Lima","F",6,5,11
"16241","Lin","F",6,9,15
"16242","Lin","M",6,5,11
"16243","Lina","F",327,332,659
"16244","Linah","F",7,5,12
"16245","Lincoln","F",158,163,321
"16246","Lincoln","M",5982,7076,13058
"16247","Lincy","F",15,14,29
"16248","Linda","F",425,434,859
"16249","Lindee","F",7,5,12
"16250","Linden","F",78,65,143
"16251","Linden","M",87,99,186
"16252","Lindi","F",7,15,22
"16253","Lindley","F",29,30,59
"16254","Lindon","M",11,22,33
"16255","Lindsay","F",328,257,585
"16256","Lindsey","F",473,363,836
"16257","Lindsey","M",11,13,24
"16258","Lindsy","F",8,11,19
"16259","Lindy","F",61,56,117
"16260","Lindyn","F",7,18,25
"16261","Lineth","F",9,5,14
"16262","Linette","F",10,15,25
"16263","Linh","F",12,16,28
"16264","Link","M",134,145,279
"16265","Linken","M",32,18,50
"16266","Linkin","M",91,113,204
"16267","Linkoln","M",54,49,103
"16268","Linkon","M",19,22,41
"16269","Linkyn","F",11,12,23
"16270","Linkyn","M",10,24,34
"16271","Linlee","F",7,8,15
"16272","Linleigh","F",11,6,17
"16273","Linley","F",83,74,157
"16274","Linna","F",7,10,17
"16275","Linnea","F",177,155,332
"16276","Lino","M",40,47,87
"16277","Linsey","F",20,15,35
"16278","Linsy","F",8,10,18
"16279","Linton","M",6,6,12
"16280","Linus","M",162,128,290
"16281","Linux","M",6,8,14
"16282","Linwood","M",13,8,21
"16283","Linzy","F",16,8,24
"16284","Lio","M",16,11,27
"16285","Lion","M",24,18,42
"16286","Liona","F",8,7,15
"16287","Lionardo","M",5,7,12
"16288","Lionel","M",405,474,879
"16289","Lionell","M",8,9,17
"16290","Lior","M",26,27,53
"16291","Liora","F",56,58,114
"16292","Lipa","M",42,39,81
"16293","Lira","F",11,30,41
"16294","Lisa","F",373,342,715
"16295","Lisamarie","F",13,15,28
"16296","Lisandra","F",25,15,40
"16297","Lisandro","M",53,53,106
"16298","Lisanna","F",9,11,20
"16299","Lisbeth","F",49,55,104
"16300","Liseth","F",10,8,18
"16301","Lisette","F",55,41,96
"16302","Lisha","F",7,6,13
"16303","Lissa","F",11,9,20
"16304","Lissandra","F",13,17,30
"16305","Lissandro","M",12,11,23
"16306","Lisset","F",13,12,25
"16307","Lisseth","F",12,17,29
"16308","Lissette","F",36,25,61
"16309","Liston","M",8,6,14
"16310","Lita","F",14,17,31
"16311","Litzy","F",161,226,387
"16312","Liv","F",395,413,808
"16313","Livana","F",5,10,15
"16314","Lively","F",16,26,42
"16315","Livi","F",40,36,76
"16316","Livia","F",390,399,789
"16317","Livian","F",19,20,39
"16318","Liviana","F",45,29,74
"16319","Livianna","F",16,15,31
"16320","Livie","F",40,34,74
"16321","Livingston","F",9,11,20
"16322","Livingston","M",11,7,18
"16323","Livinia","F",6,7,13
"16324","Liviya","F",10,13,23
"16325","Livvy","F",31,30,61
"16326","Livy","F",40,37,77
"16327","Liya","F",89,103,192
"16328","Liyah","F",96,67,163
"16329","Liyana","F",75,78,153
"16330","Liyanna","F",7,7,14
"16331","Liyat","F",10,8,18
"16332","Liyla","F",10,12,22
"16333","Liylah","F",10,8,18
"16334","Liyu","F",10,12,22
"16335","Liz","F",67,84,151
"16336","Liza","F",125,115,240
"16337","Lizabeth","F",13,31,44
"16338","Lizandra","F",7,11,18
"16339","Lizandro","M",20,18,38
"16340","Lizbeth","F",335,296,631
"16341","Lizet","F",14,13,27
"16342","Lizeth","F",139,157,296
"16343","Lizett","F",7,5,12
"16344","Lizette","F",59,57,116
"16345","Lizmarie","F",13,11,24
"16346","Lizzet","F",9,8,17
"16347","Lizzeth","F",9,5,14
"16348","Lizzette","F",7,5,12
"16349","Lizzie","F",61,62,123
"16350","Lizzy","F",28,19,47
"16351","Lj","M",8,11,19
"16352","Llewellyn","M",8,6,14
"16353","Llewyn","M",34,43,77
"16354","Lleyton","M",32,33,65
"16355","Lliam","M",23,18,41
"16356","Lloyd","M",108,110,218
"16357","Lluvia","F",102,88,190
"16358","Loa","F",7,7,14
"16359","Loany","F",10,8,18
"16360","Lochlan","F",7,8,15
"16361","Lochlan","M",267,311,578
"16362","Lochlann","M",20,28,48
"16363","Lochlin","M",5,7,12
"16364","Lochlyn","F",24,20,44
"16365","Lochlyn","M",7,8,15
"16366","Locke","M",46,73,119
"16367","Locklan","M",10,10,20
"16368","Locklin","M",5,7,12
"16369","Locklyn","F",31,30,61
"16370","Lofton","M",12,12,24
"16371","Logan","F",833,852,1685
"16372","Logan","M",12897,11200,24097
"16373","Logann","F",31,40,71
"16374","Logen","M",35,16,51
"16375","Loghan","F",31,27,58
"16376","Loghan","M",23,22,45
"16377","Logic","M",5,5,10
"16378","Logyn","F",20,18,38
"16379","Logyn","M",9,7,16
"16380","Lohgan","F",6,6,12
"16381","Loic","M",25,30,55
"16382","Loida","F",5,6,11
"16383","Lois","F",109,118,227
"16384","Lojain","F",5,6,11
"16385","Loki","M",114,92,206
"16386","Lola","F",1450,1372,2822
"16387","Lolah","F",13,18,31
"16388","Lolita","F",19,12,31
"16389","Lolly","F",7,7,14
"16390","Lon","M",8,10,18
"16391","Lona","F",17,16,33
"16392","Londan","F",15,6,21
"16393","Londen","F",21,17,38
"16394","Londen","M",19,9,28
"16395","London","F",2909,2339,5248
"16396","London","M",448,345,793
"16397","Londyn","F",2018,1811,3829
"16398","Londyn","M",40,26,66
"16399","Londynn","F",246,209,455
"16400","Long","M",12,13,25
"16401","Loni","F",9,9,18
"16402","Lonna","F",8,10,18
"16403","Lonnell","M",7,10,17
"16404","Lonnie","F",12,12,24
"16405","Lonnie","M",122,112,234
"16406","Lonzo","M",9,5,14
"16407","Lora","F",61,63,124
"16408","Loraine","F",15,22,37
"16409","Loralai","F",20,21,41
"16410","Loralee","F",7,13,20
"16411","Loralei","F",83,65,148
"16412","Lorali","F",26,13,39
"16413","Loralie","F",30,21,51
"16414","Loralye","F",12,18,30
"16415","Lorcan","M",7,12,19
"16416","Lord","M",20,19,39
"16417","Loreal","F",27,21,48
"16418","Lorel","F",11,5,16
"16419","Lorelai","F",437,474,911
"16420","Lorelei","F",703,711,1414
"16421","Loreley","F",9,6,15
"16422","Loreli","F",12,10,22
"16423","Lorelie","F",11,5,16
"16424","Lorelle","F",13,12,25
"16425","Loren","F",108,112,220
"16426","Loren","M",71,73,144
"16427","Lorena","F",192,198,390
"16428","Lorene","F",15,22,37
"16429","Lorenz","M",11,16,27
"16430","Lorenza","F",20,19,39
"16431","Lorenzo","M",1838,1860,3698
"16432","Loretta","F",217,239,456
"16433","Lori","F",133,141,274
"16434","Loriana","F",15,17,32
"16435","Loriann","F",13,9,22
"16436","Lorianna","F",14,7,21
"16437","Lorianne","F",10,14,24
"16438","Lorie","F",9,17,26
"16439","Loriel","F",5,13,18
"16440","Lorielle","F",16,13,29
"16441","Lorien","F",10,11,21
"16442","Lorik","M",13,18,31
"16443","Lorin","F",17,16,33
"16444","Lorin","M",6,13,19
"16445","Lorinda","F",5,6,11
"16446","Lorissa","F",8,7,15
"16447","Lorna","F",36,27,63
"16448","Lorne","M",17,6,23
"16449","Lorraina","F",14,9,23
"16450","Lorraine","F",122,143,265
"16451","Lorrie","F",6,6,12
"16452","Loryn","F",32,28,60
"16453","Lorynn","F",8,7,15
"16454","Lottie","F",78,100,178
"16455","Lotus","F",81,88,169
"16456","Lou","F",29,35,64
"16457","Lou","M",37,45,82
"16458","Louann","F",5,7,12
"16459","Louay","M",13,10,23
"16460","Loucas","M",5,5,10
"16461","Louden","M",20,22,42
"16462","Louella","F",41,52,93
"16463","Louie","F",5,7,12
"16464","Louie","M",214,233,447
"16465","Louis","M",1205,1239,2444
"16466","Louisa","F",302,345,647
"16467","Louise","F",242,309,551
"16468","Loukas","M",37,34,71
"16469","Loukya","F",9,7,16
"16470","Loula","F",9,8,17
"16471","Louna","F",7,35,42
"16472","Lourdes","F",90,99,189
"16473","Love","F",110,100,210
"16474","Love","M",10,5,15
"16475","Loveah","F",21,19,40
"16476","Lovell","M",14,16,30
"16477","Lovella","F",16,12,28
"16478","Lovely","F",69,61,130
"16479","Lovelyn","F",18,13,31
"16480","Lovelynn","F",8,12,20
"16481","Lovette","F",7,6,13
"16482","Lovie","F",17,19,36
"16483","Lovina","F",28,36,64
"16484","Lovisa","F",5,5,10
"16485","Lowell","M",46,42,88
"16486","Lowen","F",9,14,23
"16487","Lowen","M",18,32,50
"16488","Loxley","F",20,29,49
"16489","Loyal","F",27,28,55
"16490","Loyal","M",71,56,127
"16491","Loyaltee","F",5,5,10
"16492","Loyalti","F",7,6,13
"16493","Loyalty","F",99,137,236
"16494","Loyalty","M",17,19,36
"16495","Loyd","M",6,5,11
"16496","Loza","F",9,9,18
"16497","Lua","F",24,21,45
"16498","Luan","M",20,33,53
"16499","Luana","F",48,47,95
"16500","Luann","F",7,11,18
"16501","Luanna","F",16,20,36
"16502","Luay","M",9,14,23
"16503","Lubna","F",10,6,16
"16504","Luc","M",80,95,175
"16505","Luca","F",68,80,148
"16506","Luca","M",2606,2728,5334
"16507","Lucah","M",19,31,50
"16508","Lucan","M",19,15,34
"16509","Lucas","F",16,8,24
"16510","Lucas","M",12285,12838,25123
"16511","Lucca","F",48,46,94
"16512","Lucca","M",319,361,680
"16513","Luccas","M",14,16,30
"16514","Lucciana","F",19,20,39
"16515","Lucciano","M",19,24,43
"16516","Lucee","F",8,6,14
"16517","Lucelia","F",7,8,15
"16518","Lucero","F",115,132,247
"16519","Lucette","F",9,9,18
"16520","Luci","F",63,67,130
"16521","Lucia","F",1449,1511,2960
"16522","Lucian","M",419,425,844
"16523","Luciana","F",683,736,1419
"16524","Lucianna","F",78,89,167
"16525","Lucianne","F",5,7,12
"16526","Luciano","M",528,581,1109
"16527","Lucie","F",158,155,313
"16528","Luciella","F",5,7,12
"16529","Lucielle","F",8,11,19
"16530","Lucien","M",161,175,336
"16531","Lucienne","F",26,38,64
"16532","Lucifer","M",7,13,20
"16533","Lucila","F",19,9,28
"16534","Lucile","F",38,33,71
"16535","Lucilia","F",6,11,17
"16536","Lucilla","F",14,12,26
"16537","Lucille","F",1115,1122,2237
"16538","Lucillia","F",7,8,15
"16539","Lucina","F",28,39,67
"16540","Lucinda","F",143,187,330
"16541","Lucine","F",7,17,24
"16542","Lucio","M",90,83,173
"16543","Lucious","M",37,51,88
"16544","Lucius","M",136,158,294
"16545","Lucky","M",43,56,99
"16546","Lucrezia","F",14,8,22
"16547","Lucus","M",27,25,52
"16548","Lucy","F",4538,4568,9106
"16549","Lucyann","F",7,7,14
"16550","Lucyanna","F",7,10,17
"16551","Ludmila","F",5,9,14
"16552","Ludwig","M",13,8,21
"16553","Luella","F",176,205,381
"16554","Lui","M",12,9,21
"16555","Luian","M",14,16,30
"16556","Luigi","M",41,38,79
"16557","Luis","M",3727,3543,7270
"16558","Luisa","F",224,208,432
"16559","Luisana","F",10,13,23
"16560","Luisangel","M",36,16,52
"16561","Luiz","M",41,37,78
"16562","Luiza","F",40,42,82
"16563","Lujain","F",30,40,70
"16564","Lujane","F",6,5,11
"16565","Luka","F",33,28,61
"16566","Luka","M",550,646,1196
"16567","Lukah","M",40,34,74
"16568","Lukas","M",1427,1744,3171
"16569","Lukasz","M",21,18,39
"16570","Luke","F",8,11,19
"16571","Luke","M",10255,9930,20185
"16572","Luken","M",18,19,37
"16573","Lukka","M",11,6,17
"16574","Lukus","M",22,24,46
"16575","Lula","F",99,116,215
"16576","Lulani","F",5,5,10
"16577","Lulu","F",59,49,108
"16578","Luma","F",10,7,17
"16579","Lumen","F",43,36,79
"16580","Lumi","F",12,13,25
"16581","Lumina","F",14,8,22
"16582","Lun","F",10,13,23
"16583","Luna","F",2796,3645,6441
"16584","Luna","M",5,6,11
"16585","Lunabelle","F",5,17,22
"16586","Lunah","F",6,13,19
"16587","Lunarae","F",6,5,11
"16588","Lunden","F",5,8,13
"16589","Lundyn","F",44,37,81
"16590","Lunna","F",15,9,24
"16591","Lupe","F",8,8,16
"16592","Lupita","F",86,81,167
"16593","Luqman","M",42,40,82
"16594","Lura","F",8,8,16
"16595","Luther","M",99,99,198
"16596","Luthien","F",6,9,15
"16597","Luvina","F",6,5,11
"16598","Lux","F",100,99,199
"16599","Lux","M",32,33,65
"16600","Luxe","F",8,10,18
"16601","Luz","F",283,263,546
"16602","Luzelena","F",16,15,31
"16603","Luziana","F",5,5,10
"16604","Luzma","F",13,8,21
"16605","Luzmaria","F",20,28,48
"16606","Lya","F",50,46,96
"16607","Lyah","F",19,20,39
"16608","Lyam","M",94,104,198
"16609","Lyan","F",6,8,14
"16610","Lyan","M",22,32,54
"16611","Lyana","F",27,28,55
"16612","Lyanna","F",62,216,278
"16613","Lyanne","F",5,7,12
"16614","Lycan","M",6,5,11
"16615","Lyda","F",10,17,27
"16616","Lydell","M",14,16,30
"16617","Lyden","M",6,9,15
"16618","Lydia","F",3491,3590,7081
"16619","Lydiah","F",16,20,36
"16620","Lydian","F",11,15,26
"16621","Lydiana","F",6,8,14
"16622","Lydiann","F",17,10,27
"16623","Lydon","M",5,9,14
"16624","Lyfe","F",6,10,16
"16625","Lyfe","M",13,29,42
"16626","Lyla","F",2266,2209,4475
"16627","Lylah","F",450,414,864
"16628","Lylarose","F",6,6,12
"16629","Lyle","M",183,207,390
"16630","Lylee","F",7,7,14
"16631","Lyleigh","F",5,7,12
"16632","Lylia","F",17,13,30
"16633","Lyliah","F",8,6,14
"16634","Lylian","F",13,17,30
"16635","Lyliana","F",22,22,44
"16636","Lylianna","F",11,12,23
"16637","Lylith","F",10,11,21
"16638","Lylla","F",8,8,16
"16639","Lyllian","F",29,21,50
"16640","Lylliana","F",9,7,16
"16641","Lyman","M",12,16,28
"16642","Lyn","F",6,8,14
"16643","Lyna","F",21,13,34
"16644","Lynae","F",15,16,31
"16645","Lyncoln","F",24,16,40
"16646","Lyncoln","M",40,41,81
"16647","Lynda","F",34,31,65
"16648","Lyndee","F",18,14,32
"16649","Lyndell","M",8,7,15
"16650","Lynden","F",24,42,66
"16651","Lynden","M",34,34,68
"16652","Lyndi","F",32,18,50
"16653","Lyndie","F",13,7,20
"16654","Lyndon","F",24,24,48
"16655","Lyndon","M",155,134,289
"16656","Lyndsay","F",11,11,22
"16657","Lyndsey","F",41,51,92
"16658","Lynell","M",9,6,15
"16659","Lynelle","F",18,16,34
"16660","Lynette","F",96,88,184
"16661","Lynex","F",6,7,13
"16662","Lyniah","F",13,11,24
"16663","Lynix","F",13,13,26
"16664","Lynix","M",7,8,15
"16665","Lynk","M",7,12,19
"16666","Lynkin","M",19,21,40
"16667","Lynkoln","M",6,5,11
"16668","Lynkon","M",8,7,15
"16669","Lynlee","F",107,105,212
"16670","Lynleigh","F",33,31,64
"16671","Lynley","F",34,45,79
"16672","Lynlie","F",6,8,14
"16673","Lynn","F",82,92,174
"16674","Lynn","M",16,9,25
"16675","Lynna","F",11,12,23
"16676","Lynnae","F",17,9,26
"16677","Lynne","F",9,15,24
"16678","Lynnea","F",17,20,37
"16679","Lynnette","F",18,27,45
"16680","Lynnex","F",19,14,33
"16681","Lynniah","F",9,9,18
"16682","Lynnie","F",7,6,13
"16683","Lynnix","F",24,16,40
"16684","Lynnlee","F",62,63,125
"16685","Lynnleigh","F",14,15,29
"16686","Lynnley","F",10,12,22
"16687","Lynnon","F",13,11,24
"16688","Lynnox","F",20,33,53
"16689","Lynora","F",6,5,11
"16690","Lynsey","F",12,11,23
"16691","Lynx","M",12,12,24
"16692","Lynzee","F",9,9,18
"16693","Lynzi","F",10,8,18
"16694","Lynzie","F",12,10,22
"16695","Lyon","M",43,42,85
"16696","Lyonel","M",11,5,16
"16697","Lyra","F",275,292,567
"16698","Lyrah","F",8,11,19
"16699","Lyric","F",1107,1128,2235
"16700","Lyric","M",246,213,459
"16701","Lyrica","F",17,34,51
"16702","Lyrical","F",15,21,36
"16703","Lyricc","F",5,6,11
"16704","Lyrick","F",10,9,19
"16705","Lyrick","M",8,13,21
"16706","Lyrics","F",6,6,12
"16707","Lyrik","F",75,70,145
"16708","Lyrik","M",56,40,96
"16709","Lyriq","F",40,41,81
"16710","Lyriq","M",10,8,18
"16711","Lyrique","F",10,11,21
"16712","Lyrix","M",5,6,11
"16713","Lysander","M",34,27,61
"16714","Lyssa","F",12,12,24
"16715","Lyvia","F",25,37,62
"16716","Lyza","F",23,36,59
"16717","Maahi","F",29,34,63
"16718","Maahir","M",15,13,28
"16719","Maali","F",8,5,13
"16720","Maalik","M",14,15,29
"16721","Maaliyah","F",12,10,22
"16722","Maan","M",10,7,17
"16723","Maanav","M",5,5,10
"16724","Maanvi","F",23,33,56
"16725","Maanya","F",27,25,52
"16726","Maasai","M",5,7,12
"16727","Maat","F",10,14,24
"16728","Maaya","F",5,7,12
"16729","Maayan","F",26,16,42
"16730","Maaz","M",27,21,48
"16731","Mabel","F",529,602,1131
"16732","Mabelle","F",15,10,25
"16733","Mable","F",22,29,51
"16734","Mabrey","F",15,18,33
"16735","Mabry","F",71,70,141
"16736","Mac","M",177,173,350
"16737","Macai","M",12,12,24
"16738","Macallan","M",17,18,35
"16739","Macallister","M",10,12,22
"16740","Macari","M",10,10,20
"16741","Macaria","F",8,5,13
"16742","Macario","M",48,36,84
"16743","Macarius","M",11,6,17
"16744","Macarthur","M",14,14,28
"16745","Macayla","F",33,22,55
"16746","Mace","M",52,64,116
"16747","Macee","F",53,42,95
"16748","Macelyn","F",8,7,15
"16749","Macelynn","F",6,5,11
"16750","Macen","M",40,52,92
"16751","Maceo","M",69,91,160
"16752","Macey","F",246,211,457
"16753","Macgregor","M",7,5,12
"16754","Machai","M",9,13,22
"16755","Machi","M",19,11,30
"16756","Maci","F",1177,1185,2362
"16757","Maciah","M",7,6,13
"16758","Macie","F",764,672,1436
"16759","Macilynn","F",6,5,11
"16760","Macintyre","M",8,5,13
"16761","Mack","M",387,353,740
"16762","Mackay","M",7,8,15
"16763","Mackayla","F",34,23,57
"16764","Mackena","F",5,9,14
"16765","Mackenize","F",12,6,18
"16766","Mackenna","F",104,107,211
"16767","Mackensie","F",13,15,28
"16768","Mackenzee","F",19,10,29
"16769","Mackenzi","F",34,36,70
"16770","Mackenzie","F",3850,3390,7240
"16771","Mackenzie","M",29,27,56
"16772","Mackenzy","F",35,19,54
"16773","Mackenzye","F",7,6,13
"16774","Mackinlee","F",10,10,20
"16775","Mackinley","F",24,15,39
"16776","Mackinley","M",9,6,15
"16777","Mackinzie","F",15,6,21
"16778","Macklan","M",10,5,15
"16779","Macklen","M",18,13,31
"16780","Macklin","M",89,118,207
"16781","Macklyn","F",13,22,35
"16782","Macklyn","M",12,8,20
"16783","Macklynn","F",5,14,19
"16784","Macksen","M",8,10,18
"16785","Mackson","M",33,45,78
"16786","Mackynzie","F",34,11,45
"16787","Maclain","M",11,8,19
"16788","Maclan","M",11,11,22
"16789","Maclean","M",7,6,13
"16790","Maclin","M",28,40,68
"16791","Maclyn","F",10,10,20
"16792","Maclynn","F",7,5,12
"16793","Macon","M",48,32,80
"16794","Macoy","M",27,25,52
"16795","Macsen","M",35,35,70
"16796","Macy","F",772,628,1400
"16797","Macyn","F",62,42,104
"16798","Macyn","M",11,11,22
"16799","Madai","F",21,17,38
"16800","Madalee","F",9,11,20
"16801","Madalena","F",22,15,37
"16802","Madalene","F",5,9,14
"16803","Madalin","F",13,16,29
"16804","Madalina","F",7,5,12
"16805","Madaline","F",43,52,95
"16806","Madalyn","F",540,487,1027
"16807","Madalyne","F",11,12,23
"16808","Madalynn","F",414,354,768
"16809","Madalynne","F",16,16,32
"16810","Madasyn","F",12,12,24
"16811","Maddalena","F",35,31,66
"16812","Maddalyn","F",48,44,92
"16813","Maddalynn","F",21,20,41
"16814","Maddax","M",33,26,59
"16815","Maddelyn","F",38,42,80
"16816","Maddelynn","F",12,8,20
"16817","Madden","F",42,51,93
"16818","Madden","M",438,376,814
"16819","Maddex","M",104,96,200
"16820","Maddi","F",18,22,40
"16821","Maddie","F",249,243,492
"16822","Maddielynn","F",7,9,16
"16823","Maddilyn","F",95,101,196
"16824","Maddilynn","F",53,70,123
"16825","Maddisen","F",10,9,19
"16826","Maddison","F",1047,979,2026
"16827","Maddisyn","F",69,59,128
"16828","Maddix","F",19,29,48
"16829","Maddix","M",135,133,268
"16830","Maddock","M",14,15,29
"16831","Maddon","M",22,40,62
"16832","Maddox","F",90,119,209
"16833","Maddox","M",2775,2887,5662
"16834","Maddoxx","M",11,11,22
"16835","Maddux","F",18,18,36
"16836","Maddux","M",189,206,395
"16837","Maddy","F",26,27,53
"16838","Maddyn","F",61,68,129
"16839","Maddyson","F",49,31,80
"16840","Maddyx","F",8,21,29
"16841","Maddyx","M",13,17,30
"16842","Madelaine","F",21,23,44
"16843","Madeleine","F",1065,947,2012
"16844","Madelena","F",5,6,11
"16845","Madelene","F",9,7,16
"16846","Madeleyn","F",27,19,46
"16847","Madeliene","F",9,5,14
"16848","Madelin","F",49,49,98
"16849","Madelina","F",14,15,29
"16850","Madeline","F",3327,3257,6584
"16851","Madelon","F",5,9,14
"16852","Madelyn","F",4478,4208,8686
"16853","Madelyne","F",61,59,120
"16854","Madelynn","F",768,669,1437
"16855","Madelynne","F",48,50,98
"16856","Madhav","M",27,23,50
"16857","Madi","F",21,23,44
"16858","Madicyn","F",11,9,20
"16859","Madie","F",6,8,14
"16860","Madielyn","F",5,5,10
"16861","Madigan","F",26,15,41
"16862","Madiha","F",8,11,19
"16863","Madilyn","F",1022,999,2021
"16864","Madilyne","F",11,10,21
"16865","Madilynn","F",638,597,1235
"16866","Madilynne","F",29,19,48
"16867","Madina","F",50,68,118
"16868","Madinah","F",8,10,18
"16869","Madisen","F",61,41,102
"16870","Madison","F",10072,8982,19054
"16871","Madison","M",73,42,115
"16872","Madisson","F",27,39,66
"16873","Madisyn","F",675,575,1250
"16874","Madisynn","F",22,20,42
"16875","Madix","M",26,20,46
"16876","Madlyn","F",13,10,23
"16877","Madlynn","F",15,13,28
"16878","Madoc","M",11,23,34
"16879","Madolyn","F",12,17,29
"16880","Madonna","F",13,7,20
"16881","Madox","M",18,13,31
"16882","Madrid","F",5,5,10
"16883","Mads","M",13,8,21
"16884","Madsen","M",8,9,17
"16885","Madylan","F",7,6,13
"16886","Madylin","F",15,14,29
"16887","Madyn","F",12,14,26
"16888","Madysen","F",43,32,75
"16889","Madysin","F",6,8,14
"16890","Madyson","F",339,276,615
"16891","Madysyn","F",11,8,19
"16892","Madyx","M",9,7,16
"16893","Mae","F",511,527,1038
"16894","Maebel","F",17,16,33
"16895","Maebelle","F",15,14,29
"16896","Maebh","F",7,8,15
"16897","Maebree","F",8,10,18
"16898","Maebry","F",35,28,63
"16899","Maecy","F",5,8,13
"16900","Maecyn","F",11,9,20
"16901","Maegan","F",28,12,40
"16902","Maejor","M",25,7,32
"16903","Mael","M",33,35,68
"16904","Maela","F",16,16,32
"16905","Maelani","F",26,16,42
"16906","Maelee","F",91,88,179
"16907","Maeleigh","F",52,64,116
"16908","Maeley","F",23,16,39
"16909","Maeli","F",21,21,42
"16910","Maelie","F",44,31,75
"16911","Maelin","F",9,16,25
"16912","Maelle","F",18,25,43
"16913","Maely","F",20,19,39
"16914","Maelyn","F",104,94,198
"16915","Maelynn","F",110,131,241
"16916","Maelys","F",13,10,23
"16917","Maeryn","F",7,6,13
"16918","Maesie","F",5,5,10
"16919","Maeson","F",6,15,21
"16920","Maeson","M",39,24,63
"16921","Maesyn","F",26,12,38
"16922","Maeva","F",42,42,84
"16923","Maeve","F",699,816,1515
"16924","Maeven","F",16,14,30
"16925","Maevis","F",15,15,30
"16926","Maevry","F",6,7,13
"16927","Maevyn","F",8,17,25
"16928","Maezie","F",11,11,22
"16929","Magaby","F",10,7,17
"16930","Magali","F",51,41,92
"16931","Magaly","F",73,71,144
"16932","Magda","F",10,18,28
"16933","Magdalen","F",29,29,58
"16934","Magdalena","F",234,258,492
"16935","Magdalene","F",115,139,254
"16936","Magdaleno","M",5,7,12
"16937","Magdaline","F",6,8,14
"16938","Magdalyn","F",25,23,48
"16939","Magdalynn","F",8,7,15
"16940","Magdeline","F",5,5,10
"16941","Magdiel","M",10,12,22
"16942","Magenta","F",7,5,12
"16943","Maggi","F",8,8,16
"16944","Maggie","F",1328,1312,2640
"16945","Maggiemae","F",7,6,13
"16946","Maggy","F",12,18,30
"16947","Magic","M",9,8,17
"16948","Magnolia","F",448,609,1057
"16949","Magnus","M",262,293,555
"16950","Maguire","M",8,11,19
"16951","Maha","F",46,53,99
"16952","Mahad","M",23,28,51
"16953","Mahala","F",27,27,54
"16954","Mahaley","F",11,9,20
"16955","Mahalia","F",35,37,72
"16956","Maham","F",7,6,13
"16957","Mahamadou","M",13,5,18
"16958","Mahamed","M",13,10,23
"16959","Mahan","M",5,11,16
"16960","Mahari","F",14,19,33
"16961","Mahari","M",7,9,16
"16962","Mahathi","F",12,17,29
"16963","Mahayla","F",24,37,61
"16964","Mahdi","M",98,70,168
"16965","Mahdiya","F",13,16,29
"16966","Mahealani","F",17,20,37
"16967","Maheen","F",17,18,35
"16968","Mahek","F",8,10,18
"16969","Maher","M",37,35,72
"16970","Mahi","F",51,41,92
"16971","Mahia","F",5,9,14
"16972","Mahid","M",8,10,18
"16973","Mahika","F",14,13,27
"16974","Mahima","F",11,16,27
"16975","Mahina","F",19,25,44
"16976","Mahir","M",57,66,123
"16977","Mahira","F",30,49,79
"16978","Mahith","M",5,7,12
"16979","Mahkai","M",21,19,40
"16980","Mahkayla","F",5,6,11
"16981","Mahki","M",35,42,77
"16982","Mahlani","F",7,19,26
"16983","Mahlet","F",7,9,16
"16984","Mahli","F",5,6,11
"16985","Mahlia","F",19,21,40
"16986","Mahlik","M",11,7,18
"16987","Mahlon","M",43,40,83
"16988","Mahmood","M",9,14,23
"16989","Mahmoud","M",72,60,132
"16990","Mahmud","M",5,14,19
"16991","Mahnoor","F",27,39,66
"16992","Mahogani","F",6,12,18
"16993","Mahogany","F",80,83,163
"16994","Mahreen","F",12,7,19
"16995","Mahrosh","F",9,10,19
"16996","Mai","F",46,49,95
"16997","Maia","F",560,542,1102
"16998","Maiah","F",43,43,86
"16999","Maiana","F",8,8,16
"17000","Maiara","F",6,11,17
"17001","Maicee","F",9,11,20
"17002","Maicie","F",6,7,13
"17003","Maicol","M",11,18,29
"17004","Maida","F",44,43,87
"17005","Maidah","F",9,5,14
"17006","Maija","F",11,15,26
"17007","Maijor","M",18,17,35
"17008","Maika","F",17,11,28
"17009","Maika","M",11,8,19
"17010","Maikel","M",11,14,25
"17011","Maikol","M",13,18,31
"17012","Maila","F",15,23,38
"17013","Mailani","F",34,29,63
"17014","Maile","F",26,23,49
"17015","Mailee","F",15,12,27
"17016","Mailen","F",36,25,61
"17017","Mailey","F",19,22,41
"17018","Maily","F",11,18,29
"17019","Mailyn","F",34,29,63
"17020","Mailynn","F",14,6,20
"17021","Maimouna","F",23,33,56
"17022","Maimuna","F",9,15,24
"17023","Maira","F",68,52,120
"17024","Mairany","F",16,11,27
"17025","Maire","F",10,8,18
"17026","Mairead","F",24,25,49
"17027","Mairely","F",5,5,10
"17028","Mairen","F",6,7,13
"17029","Mairi","F",5,7,12
"17030","Mairin","F",12,18,30
"17031","Maisee","F",5,5,10
"17032","Maisen","M",21,12,33
"17033","Maisey","F",54,37,91
"17034","Maisha","F",16,13,29
"17035","Maisie","F",458,536,994
"17036","Maisley","F",15,20,35
"17037","Maison","F",24,21,45
"17038","Maison","M",268,302,570
"17039","Maisy","F",221,209,430
"17040","Maisyn","F",39,83,122
"17041","Maite","F",180,167,347
"17042","Maiya","F",145,109,254
"17043","Maiyah","F",30,19,49
"17044","Maize","F",9,6,15
"17045","Maizee","F",19,21,40
"17046","Maizey","F",33,44,77
"17047","Maizie","F",77,95,172
"17048","Maizley","F",5,5,10
"17049","Maizy","F",87,75,162
"17050","Maja","F",61,55,116
"17051","Majd","M",28,24,52
"17052","Majed","M",21,10,31
"17053","Majeed","M",8,5,13
"17054","Majesti","F",21,16,37
"17055","Majestic","F",6,6,12
"17056","Majestic","M",5,15,20
"17057","Majesty","F",91,136,227
"17058","Majesty","M",33,44,77
"17059","Majid","M",21,16,37
"17060","Major","M",908,975,1883
"17061","Majour","M",14,15,29
"17062","Mak","M",6,6,12
"17063","Maka","F",9,6,15
"17064","Makaela","F",52,36,88
"17065","Makaelyn","F",10,5,15
"17066","Makai","F",12,14,26
"17067","Makai","M",371,420,791
"17068","Makaia","F",15,5,20
"17069","Makaiah","F",8,8,16
"17070","Makaila","F",86,56,142
"17071","Makailah","F",7,12,19
"17072","Makailyn","F",9,9,18
"17073","Makaio","M",41,67,108
"17074","Makaius","M",5,5,10
"17075","Makaiya","F",10,8,18
"17076","Makala","F",13,11,24
"17077","Makalah","F",6,8,14
"17078","Makalya","F",10,7,17
"17079","Makalyn","F",12,11,23
"17080","Makana","F",9,8,17
"17081","Makana","M",14,29,43
"17082","Makani","M",14,10,24
"17083","Makar","M",14,19,33
"17084","Makara","F",8,5,13
"17085","Makari","F",8,10,18
"17086","Makari","M",42,57,99
"17087","Makaveli","M",5,5,10
"17088","Makaya","F",20,21,41
"17089","Makayah","F",7,9,16
"17090","Makayla","F",2248,1918,4166
"17091","Makaylah","F",99,88,187
"17092","Makaylee","F",53,37,90
"17093","Makaylie","F",8,10,18
"17094","Makaylyn","F",12,6,18
"17095","Makaylynn","F",8,11,19
"17096","Makeda","F",27,37,64
"17097","Makeila","F",9,7,16
"17098","Makel","M",18,22,40
"17099","Makelle","F",5,5,10
"17100","Makena","F",225,219,444
"17101","Makenah","F",7,10,17
"17102","Makenize","F",14,5,19
"17103","Makenlee","F",30,30,60
"17104","Makenleigh","F",5,9,14
"17105","Makenley","F",24,14,38
"17106","Makenli","F",9,8,17
"17107","Makenna","F",1113,1017,2130
"17108","Makennah","F",34,24,58
"17109","Makensie","F",25,10,35
"17110","Makenzee","F",26,27,53
"17111","Makenzi","F",117,97,214
"17112","Makenzie","F",1545,1299,2844
"17113","Makenzy","F",46,30,76
"17114","Makenzye","F",16,5,21
"17115","Makeyla","F",15,17,32
"17116","Makhai","M",49,49,98
"17117","Makhari","M",9,11,20
"17118","Makhi","F",7,6,13
"17119","Makhi","M",193,175,368
"17120","Makhia","F",17,7,24
"17121","Makhyla","F",6,5,11
"17122","Maki","M",12,13,25
"17123","Makia","F",15,11,26
"17124","Makiah","F",51,49,100
"17125","Makiah","M",19,11,30
"17126","Makinlee","F",27,29,56
"17127","Makinleigh","F",9,10,19
"17128","Makinley","F",102,95,197
"17129","Makinna","F",8,8,16
"17130","Makinsley","F",17,18,35
"17131","Makinze","F",5,8,13
"17132","Makinzee","F",6,8,14
"17133","Makinzi","F",14,7,21
"17134","Makinzie","F",17,26,43
"17135","Makiya","F",64,65,129
"17136","Makiyah","F",136,116,252
"17137","Makiyla","F",8,6,14
"17138","Mako","F",6,8,14
"17139","Mako","M",13,13,26
"17140","Makoa","M",38,36,74
"17141","Makoto","M",14,9,23
"17142","Maks","M",29,22,51
"17143","Maksim","M",158,143,301
"17144","Maksym","M",30,31,61
"17145","Maksymilian","M",14,17,31
"17146","Makya","F",26,22,48
"17147","Makyah","F",22,20,42
"17148","Makye","M",12,14,26
"17149","Makyia","F",7,11,18
"17150","Makyiah","F",12,12,24
"17151","Makyla","F",64,51,115
"17152","Makylah","F",26,24,50
"17153","Makylie","F",9,7,16
"17154","Makynlee","F",61,36,97
"17155","Makynleigh","F",15,6,21
"17156","Makynley","F",5,7,12
"17157","Makynli","F",13,12,25
"17158","Makynlie","F",7,7,14
"17159","Makynna","F",15,16,31
"17160","Makynzee","F",15,7,22
"17161","Makynzi","F",17,12,29
"17162","Makynzie","F",60,53,113
"17163","Makyra","F",8,12,20
"17164","Mala","F",10,9,19
"17165","Malaak","F",16,11,27
"17166","Malacai","M",7,6,13
"17167","Malachai","M",36,41,77
"17168","Malachi","F",16,9,25
"17169","Malachi","M",2558,2585,5143
"17170","Malachy","M",14,24,38
"17171","Malae","F",7,5,12
"17172","Malahkai","M",6,5,11
"17173","Malahki","M",6,7,13
"17174","Malai","F",9,5,14
"17175","Malaia","F",10,7,17
"17176","Malaiah","F",18,15,33
"17177","Malaijah","F",5,6,11
"17178","Malaika","F",63,57,120
"17179","Malaina","F",15,16,31
"17180","Malaiya","F",17,22,39
"17181","Malaiyah","F",14,24,38
"17182","Malajah","F",6,7,13
"17183","Malak","F",181,173,354
"17184","Malak","M",12,12,24
"17185","Malakai","M",599,721,1320
"17186","Malakhai","M",18,23,41
"17187","Malakhi","M",132,176,308
"17188","Malaki","M",207,199,406
"17189","Malaky","M",5,5,10
"17190","Malakye","M",21,18,39
"17191","Malala","F",10,10,20
"17192","Malan","F",11,10,21
"17193","Malana","F",22,25,47
"17194","Malani","F",196,207,403
"17195","Malania","F",24,20,44
"17196","Malanie","F",19,12,31
"17197","Malarie","F",10,7,17
"17198","Malasia","F",19,21,40
"17199","Malay","F",8,5,13
"17200","Malaya","F",390,440,830
"17201","Malayah","F",209,239,448
"17202","Malayasia","F",7,7,14
"17203","Malayia","F",25,28,53
"17204","Malayiah","F",17,18,35
"17205","Malayjah","F",8,6,14
"17206","Malayla","F",20,19,39
"17207","Malayna","F",42,43,85
"17208","Malaysha","F",10,12,22
"17209","Malayshia","F",22,16,38
"17210","Malaysia","F",722,683,1405
"17211","Malaysiah","F",5,11,16
"17212","Malcolm","M",739,774,1513
"17213","Malcom","M",49,39,88
"17214","Malea","F",59,46,105
"17215","Maleah","F",335,374,709
"17216","Maleaha","F",10,6,16
"17217","Maleak","M",7,7,14
"17218","Malee","F",10,10,20
"17219","Maleea","F",5,6,11
"17220","Maleeah","F",9,22,31
"17221","Maleeha","F",11,11,22
"17222","Maleek","M",47,38,85
"17223","Maleena","F",25,41,66
"17224","Maleeya","F",22,18,40
"17225","Maleeyah","F",16,14,30
"17226","Maleia","F",30,33,63
"17227","Maleiah","F",15,12,27
"17228","Maleigh","F",8,19,27
"17229","Maleigha","F",71,50,121
"17230","Malek","M",72,95,167
"17231","Malekai","M",16,9,25
"17232","Maleki","M",11,8,19
"17233","Maleko","M",10,7,17
"17234","Malena","F",100,82,182
"17235","Maleni","F",12,9,21
"17236","Malenie","F",8,6,14
"17237","Maleny","F",31,38,69
"17238","Malerie","F",16,15,31
"17239","Maley","F",7,12,19
"17240","Maleya","F",23,22,45
"17241","Maleyah","F",32,41,73
"17242","Malhar","M",6,7,13
"17243","Mali","F",41,36,77
"17244","Malia","F",1027,1227,2254
"17245","Maliah","F",297,310,607
"17246","Malichi","M",15,11,26
"17247","Malick","M",16,21,37
"17248","Malie","F",13,20,33
"17249","Maliek","M",14,11,25
"17250","Maliha","F",66,44,110
"17251","Malik","M",852,839,1691
"17252","Malika","F",54,85,139
"17253","Malikah","F",10,6,16
"17254","Malikai","M",77,83,160
"17255","Malikhi","M",14,13,27
"17256","Maliki","M",58,39,97
"17257","Malikye","M",22,12,34
"17258","Malila","F",5,5,10
"17259","Malillany","F",16,5,21
"17260","Malin","F",40,48,88
"17261","Malin","M",7,5,12
"17262","Malina","F",144,137,281
"17263","Malinda","F",77,63,140
"17264","Malini","F",9,5,14
"17265","Maliq","M",27,13,40
"17266","Malique","M",32,27,59
"17267","Malisa","F",6,6,12
"17268","Malissa","F",11,12,23
"17269","Maliya","F",129,108,237
"17270","Maliyah","F",727,754,1481
"17271","Malk","F",7,6,13
"17272","Malka","F",180,218,398
"17273","Malky","F",95,112,207
"17274","Malley","F",7,9,16
"17275","Mallie","F",37,43,80
"17276","Malloree","F",6,9,15
"17277","Mallori","F",21,22,43
"17278","Mallorie","F",79,81,160
"17279","Mallory","F",832,735,1567
"17280","Mally","F",9,5,14
"17281","Malone","F",18,23,41
"17282","Malone","M",8,8,16
"17283","Maloni","F",10,13,23
"17284","Malonie","F",10,5,15
"17285","Maloree","F",8,9,17
"17286","Malori","F",6,7,13
"17287","Malorie","F",63,40,103
"17288","Malory","F",9,9,18
"17289","Malosi","M",8,13,21
"17290","Malu","F",6,13,19
"17291","Malvin","M",17,9,26
"17292","Maly","F",5,5,10
"17293","Malya","F",12,20,32
"17294","Malyah","F",16,20,36
"17295","Malyiah","F",5,11,16
"17296","Malyk","M",6,8,14
"17297","Malyn","F",7,6,13
"17298","Malynn","F",5,8,13
"17299","Mamadou","M",63,75,138
"17300","Mame","F",9,16,25
"17301","Mamie","F",22,22,44
"17302","Man","F",11,16,27
"17303","Mana","F",25,16,41
"17304","Mana","M",7,10,17
"17305","Manaal","F",18,14,32
"17306","Manahil","F",15,20,35
"17307","Manaia","F",19,17,36
"17308","Manal","F",44,36,80
"17309","Manan","M",10,8,18
"17310","Manar","F",24,23,47
"17311","Manases","M",8,9,17
"17312","Manasseh","M",18,25,43
"17313","Manasvi","F",36,21,57
"17314","Manav","M",33,19,52
"17315","Mandalyn","F",5,5,10
"17316","Mandi","F",10,11,21
"17317","Mandie","F",9,6,15
"17318","Mandy","F",69,82,151
"17319","Mane","F",9,7,16
"17320","Maneh","F",13,11,24
"17321","Manessa","F",6,12,18
"17322","Mang","F",8,5,13
"17323","Mang","M",17,11,28
"17324","Manha","F",85,99,184
"17325","Mani","M",8,7,15
"17326","Maniah","F",8,9,17
"17327","Manish","M",6,5,11
"17328","Manisha","F",6,9,15
"17329","Manit","M",5,7,12
"17330","Maniya","F",19,10,29
"17331","Maniyah","F",26,21,47
"17332","Manna","F",8,8,16
"17333","Mannat","F",19,43,62
"17334","Mannie","M",6,5,11
"17335","Manning","M",41,27,68
"17336","Mannix","M",21,28,49
"17337","Manny","M",70,48,118
"17338","Manoah","M",11,18,29
"17339","Manolo","M",68,75,143
"17340","Manraj","M",18,15,33
"17341","Manreet","F",22,11,33
"17342","Manroop","F",8,5,13
"17343","Mansa","M",5,19,24
"17344","Mansirat","F",11,7,18
"17345","Mansoor","M",6,13,19
"17346","Mansour","M",18,14,32
"17347","Mansur","M",6,10,16
"17348","Manu","M",17,20,37
"17349","Manuel","M",1293,1291,2584
"17350","Manuela","F",63,66,129
"17351","Manuella","F",13,12,25
"17352","Manveer","M",9,13,22
"17353","Manvi","F",12,9,21
"17354","Manvir","M",8,5,13
"17355","Manvith","M",7,7,14
"17356","Manya","F",25,21,46
"17357","Maor","M",5,6,11
"17358","Maple","F",73,113,186
"17359","Mar","F",12,13,25
"17360","Mara","F",380,423,803
"17361","Marabella","F",9,6,15
"17362","Marabelle","F",12,9,21
"17363","Marae","F",6,5,11
"17364","Marah","F",34,38,72
"17365","Marai","F",5,7,12
"17366","Marajade","F",6,6,12
"17367","Maraki","F",11,14,25
"17368","Maram","F",29,31,60
"17369","Maranatha","F",5,11,16
"17370","Maranda","F",27,28,55
"17371","Maraya","F",17,17,34
"17372","Marayah","F",9,13,22
"17373","Marbella","F",80,72,152
"17374","Marc","M",376,356,732
"17375","Marcanthony","M",10,12,22
"17376","Marcas","M",5,7,12
"17377","Marcel","M",306,312,618
"17378","Marcela","F",103,127,230
"17379","Marcelina","F",33,36,69
"17380","Marceline","F",128,148,276
"17381","Marcelino","M",106,98,204
"17382","Marcell","M",55,73,128
"17383","Marcella","F",170,195,365
"17384","Marcelle","F",8,17,25
"17385","Marcello","M",155,154,309
"17386","Marcellous","M",9,8,17
"17387","Marcellus","M",145,153,298
"17388","Marcelo","M",313,316,629
"17389","Marci","F",19,20,39
"17390","Marcia","F",39,43,82
"17391","Marcial","M",14,19,33
"17392","Marciana","F",10,7,17
"17393","Marciano","M",33,27,60
"17394","Marcie","F",20,15,35
"17395","Marcio","M",13,8,21
"17396","Marck","M",10,11,21
"17397","Marco","M",1082,1056,2138
"17398","Marcoantonio","M",13,10,23
"17399","Marcos","M",762,716,1478
"17400","Marcus","M",2453,2156,4609
"17401","Marcy","F",32,39,71
"17402","Marek","M",111,106,217
"17403","Mareli","F",14,12,26
"17404","Marely","F",54,37,91
"17405","Marelyn","F",29,21,50
"17406","Maren","F",230,290,520
"17407","Marena","F",7,7,14
"17408","Mareya","F",6,6,12
"17409","Margaret","F",2103,2202,4305
"17410","Margarette","F",10,9,19
"17411","Margarita","F",125,134,259
"17412","Margarito","M",18,14,32
"17413","Margaux","F",118,157,275
"17414","Margeaux","F",24,22,46
"17415","Margie","F",19,14,33
"17416","Margo","F",190,252,442
"17417","Margot","F",505,742,1247
"17418","Margret","F",13,15,28
"17419","Marguerite","F",80,76,156
"17420","Mari","F",86,103,189
"17421","Maria","F",2819,2788,5607
"17422","Maria","M",6,7,13
"17423","Mariabelen","F",6,9,15
"17424","Mariaclara","F",18,8,26
"17425","Mariadejesus","F",5,6,11
"17426","Mariaeduarda","F",8,15,23
"17427","Mariaelena","F",12,25,37
"17428","Mariafernanda","F",32,34,66
"17429","Mariah","F",2097,1905,4002
"17430","Mariaisabella","F",8,5,13
"17431","Mariajose","F",105,123,228
"17432","Marialena","F",5,6,11
"17433","Marialuisa","F",8,10,18
"17434","Mariam","F",547,566,1113
"17435","Mariama","F",50,71,121
"17436","Mariamawit","F",10,21,31
"17437","Mariame","F",7,14,21
"17438","Marian","F",234,202,436
"17439","Mariana","F",1086,1106,2192
"17440","Mariangel","F",33,39,72
"17441","Mariangela","F",7,6,13
"17442","Mariani","F",7,5,12
"17443","Mariann","F",11,20,31
"17444","Marianna","F",325,339,664
"17445","Marianne","F",100,111,211
"17446","Marianny","F",11,10,21
"17447","Mariano","M",163,133,296
"17448","Mariapaula","F",8,10,18
"17449","Mariavictoria","F",8,10,18
"17450","Maribel","F",162,152,314
"17451","Maribell","F",8,9,17
"17452","Maribella","F",29,36,65
"17453","Maribelle","F",43,40,83
"17454","Maribeth","F",16,11,27
"17455","Maricarmen","F",14,12,26
"17456","Maricela","F",57,73,130
"17457","Maricella","F",26,15,41
"17458","Maricruz","F",27,23,50
"17459","Marie","F",551,526,1077
"17460","Mariea","F",5,6,11
"17461","Mariel","F",112,111,223
"17462","Mariela","F",141,136,277
"17463","Marielena","F",15,21,36
"17464","Marielis","F",8,7,15
"17465","Mariella","F",162,174,336
"17466","Marielle","F",115,157,272
"17467","Mariely","F",26,27,53
"17468","Marielys","F",12,13,25
"17469","Mariem","F",13,9,22
"17470","Marieme","F",9,8,17
"17471","Marietta","F",27,33,60
"17472","Marifer","F",17,12,29
"17473","Marigold","F",67,93,160
"17474","Marija","F",5,8,13
"17475","Marijane","F",7,8,15
"17476","Marijose","F",9,11,20
"17477","Marik","M",12,12,24
"17478","Marika","F",5,10,15
"17479","Mariko","F",8,12,20
"17480","Marilee","F",20,16,36
"17481","Marilena","F",12,14,26
"17482","Marilla","F",9,12,21
"17483","Marilu","F",14,23,37
"17484","Marily","F",11,13,24
"17485","Marilyn","F",746,628,1374
"17486","Marilynn","F",65,62,127
"17487","Marin","F",155,165,320
"17488","Marin","M",17,10,27
"17489","Marina","F",434,424,858
"17490","Marine","F",6,5,11
"17491","Marino","M",22,17,39
"17492","Mario","M",1287,1150,2437
"17493","Marion","F",149,158,307
"17494","Marion","M",77,76,153
"17495","Mariona","F",8,7,15
"17496","Marionna","F",18,21,39
"17497","Marios","M",5,5,10
"17498","Maripaz","F",10,6,16
"17499","Mariposa","F",9,14,23
"17500","Maris","F",41,60,101
"17501","Marisa","F",108,97,205
"17502","Marisabel","F",5,7,12
"17503","Marisela","F",61,40,101
"17504","Mariska","F",30,31,61
"17505","Marisol","F",333,290,623
"17506","Marissa","F",579,502,1081
"17507","Marit","F",15,15,30
"17508","Marita","F",12,18,30
"17509","Maritza","F",208,159,367
"17510","Marius","M",61,67,128
"17511","Marivel","F",8,11,19
"17512","Mariya","F",99,74,173
"17513","Mariyah","F",275,294,569
"17514","Mariyam","F",11,14,25
"17515","Mariyana","F",14,5,19
"17516","Mariza","F",10,6,16
"17517","Marjona","F",8,5,13
"17518","Marjorie","F",351,295,646
"17519","Marjory","F",5,8,13
"17520","Mark","M",2059,2057,4116
"17521","Markan","F",6,8,14
"17522","Markanthony","M",16,5,21
"17523","Markayla","F",58,54,112
"17524","Markee","M",7,5,12
"17525","Markeese","M",5,5,10
"17526","Markeith","M",27,18,45
"17527","Markel","M",110,92,202
"17528","Markell","M",86,107,193
"17529","Markella","F",12,10,22
"17530","Marken","M",5,8,13
"17531","Markese","M",10,17,27
"17532","Markia","F",8,6,14
"17533","Markie","F",13,10,23
"17534","Markis","M",12,15,27
"17535","Markita","F",6,6,12
"17536","Marko","M",100,94,194
"17537","Markon","M",15,9,24
"17538","Markos","M",34,25,59
"17539","Markus","M",259,259,518
"17540","Marla","F",66,69,135
"17541","Marlaina","F",18,12,30
"17542","Marlana","F",10,8,18
"17543","Marlaya","F",10,9,19
"17544","Marlayah","F",5,7,12
"17545","Marlayna","F",27,16,43
"17546","Marlaysia","F",20,14,34
"17547","Marlea","F",6,10,16
"17548","Marleah","F",10,8,18
"17549","Marlee","F",692,699,1391
"17550","Marlee","M",21,17,38
"17551","Marleen","F",17,17,34
"17552","Marlei","F",55,54,109
"17553","Marleigh","F",305,295,600
"17554","Marlen","F",62,63,125
"17555","Marlena","F",72,80,152
"17556","Marlene","F",216,198,414
"17557","Marleni","F",10,11,21
"17558","Marleny","F",20,37,57
"17559","Marley","F",1493,1491,2984
"17560","Marley","M",262,258,520
"17561","Marleyann","F",6,5,11
"17562","Marleyna","F",5,7,12
"17563","Marli","F",102,93,195
"17564","Marlie","F",207,180,387
"17565","Marliee","F",5,6,11
"17566","Marlii","F",6,5,11
"17567","Marlin","F",17,16,33
"17568","Marlin","M",79,70,149
"17569","Marlina","F",9,8,17
"17570","Marliyah","F",7,13,20
"17571","Marlo","F",77,92,169
"17572","Marlo","M",47,71,118
"17573","Marlon","M",276,283,559
"17574","Marlow","F",85,91,176
"17575","Marlow","M",19,22,41
"17576","Marlowe","F",221,256,477
"17577","Marlowe","M",17,17,34
"17578","Marly","F",40,45,85
"17579","Marlyn","F",42,37,79
"17580","Marlynn","F",12,8,20
"17581","Marlys","F",5,11,16
"17582","Marni","F",14,17,31
"17583","Marnie","F",23,27,50
"17584","Marquan","M",32,40,72
"17585","Marquavious","M",9,6,15
"17586","Marque","M",11,8,19
"17587","Marquel","M",44,34,78
"17588","Marquell","M",28,18,46
"17589","Marques","M",63,52,115
"17590","Marquese","M",14,13,27
"17591","Marquette","M",16,11,27
"17592","Marquez","M",71,86,157
"17593","Marquice","M",8,12,20
"17594","Marquis","M",229,220,449
"17595","Marquise","M",136,110,246
"17596","Marqus","M",7,8,15
"17597","Marriah","F",8,10,18
"17598","Marrion","M",5,7,12
"17599","Marry","F",5,7,12
"17600","Mars","M",27,56,83
"17601","Marsean","M",12,14,26
"17602","Marsel","M",6,6,12
"17603","Marsha","F",19,23,42
"17604","Marshae","F",10,6,16
"17605","Marshal","M",66,55,121
"17606","Marshall","M",1093,999,2092
"17607","Marshaun","M",29,29,58
"17608","Marshawn","M",128,102,230
"17609","Marshay","F",9,7,16
"17610","Marshon","M",14,11,25
"17611","Marshun","M",5,7,12
"17612","Marston","M",6,11,17
"17613","Marta","F",53,74,127
"17614","Martavia","F",5,5,10
"17615","Martavion","M",10,9,19
"17616","Martavious","M",21,22,43
"17617","Martavius","M",10,13,23
"17618","Martel","M",17,15,32
"17619","Martell","M",30,31,61
"17620","Martez","M",54,59,113
"17621","Martha","F",356,389,745
"17622","Marti","F",13,12,25
"17623","Martin","M",1339,1391,2730
"17624","Martina","F",130,147,277
"17625","Martinez","M",5,9,14
"17626","Martino","M",15,17,32
"17627","Martrell","M",10,8,18
"17628","Marty","M",41,40,81
"17629","Martyn","M",5,7,12
"17630","Martyna","F",8,6,14
"17631","Marvel","F",14,19,33
"17632","Marvel","M",17,20,37
"17633","Marvell","M",12,14,26
"17634","Marvella","F",9,14,23
"17635","Marvelous","F",9,8,17
"17636","Marvelous","M",7,10,17
"17637","Marvens","M",19,22,41
"17638","Marvin","M",519,529,1048
"17639","Marvion","M",5,5,10
"17640","Marvis","M",6,7,13
"17641","Marvyn","M",6,5,11
"17642","Marwa","F",96,86,182
"17643","Marwah","F",13,13,26
"17644","Marwan","M",36,51,87
"17645","Marx","M",16,5,21
"17646","Mary","F",2620,2487,5107
"17647","Marya","F",18,21,39
"17648","Maryah","F",52,63,115
"17649","Maryalice","F",23,24,47
"17650","Maryam","F",540,562,1102
"17651","Maryama","F",35,34,69
"17652","Maryan","F",25,34,59
"17653","Maryana","F",24,20,44
"17654","Maryann","F",116,107,223
"17655","Maryanna","F",32,31,63
"17656","Maryanne","F",42,42,84
"17657","Marybella","F",7,8,15
"17658","Marybelle","F",8,9,17
"17659","Marybeth","F",15,19,34
"17660","Marycatherine","F",10,17,27
"17661","Maryclaire","F",17,12,29
"17662","Maryel","F",5,5,10
"17663","Maryelizabeth","F",21,22,43
"17664","Maryella","F",24,23,47
"17665","Maryellen","F",23,26,49
"17666","Maryfer","F",8,9,17
"17667","Marygrace","F",30,32,62
"17668","Maryhelen","F",8,5,13
"17669","Maryiah","F",11,17,28
"17670","Maryjane","F",196,216,412
"17671","Maryjayne","F",7,9,16
"17672","Maryjean","F",5,6,11
"17673","Maryjo","F",11,18,29
"17674","Marykate","F",19,29,48
"17675","Marykatherine","F",10,13,23
"17676","Marykathryn","F",10,7,17
"17677","Marylee","F",13,10,23
"17678","Marylin","F",26,24,50
"17679","Marylou","F",25,20,45
"17680","Marylouise","F",5,8,13
"17681","Marylyn","F",8,11,19
"17682","Marylynn","F",8,20,28
"17683","Marymargaret","F",20,19,39
"17684","Maryn","F",87,104,191
"17685","Maryori","F",11,8,19
"17686","Maryrose","F",12,22,34
"17687","Marysol","F",11,12,23
"17688","Maryssa","F",11,10,21
"17689","Maryum","F",10,7,17
"17690","Maryuri","F",7,7,14
"17691","Marz","M",7,8,15
"17692","Marzell","M",6,7,13
"17693","Marzia","F",8,11,19
"17694","Masa","F",23,45,68
"17695","Masai","M",22,23,45
"17696","Masaki","M",5,5,10
"17697","Masato","M",10,5,15
"17698","Mase","M",12,19,31
"17699","Masen","M",145,146,291
"17700","Maseo","M",5,5,10
"17701","Masey","F",6,9,15
"17702","Masha","F",14,21,35
"17703","Masiah","F",7,8,15
"17704","Masiah","M",74,68,142
"17705","Masie","F",13,15,28
"17706","Masih","M",7,8,15
"17707","Masin","M",18,13,31
"17708","Masiya","F",5,7,12
"17709","Masiyah","F",10,11,21
"17710","Masiyah","M",9,10,19
"17711","Mason","F",92,87,179
"17712","Mason","M",16591,15192,31783
"17713","Massa","F",8,8,16
"17714","Massai","M",7,6,13
"17715","Massiah","M",81,83,164
"17716","Massiel","F",8,11,19
"17717","Massimiliano","M",14,23,37
"17718","Massimo","M",126,99,225
"17719","Masson","M",13,10,23
"17720","Master","M",11,11,22
"17721","Maston","M",5,5,10
"17722","Masud","M",14,16,30
"17723","Masyn","F",29,43,72
"17724","Masyn","M",79,79,158
"17725","Matai","M",26,22,48
"17726","Matalyn","F",8,7,15
"17727","Matalynn","F",6,7,13
"17728","Matan","M",23,20,43
"17729","Matas","M",5,7,12
"17730","Mataya","F",28,20,48
"17731","Matea","F",23,21,44
"17732","Mateen","M",19,10,29
"17733","Matei","M",11,17,28
"17734","Mateo","M",5010,6526,11536
"17735","Mateus","M",37,35,72
"17736","Mateusz","M",16,17,33
"17737","Mathayus","M",8,17,25
"17738","Matheo","M",108,116,224
"17739","Matheus","M",36,46,82
"17740","Mathew","M",624,558,1182
"17741","Mathias","M",508,596,1104
"17742","Mathieu","M",47,53,100
"17743","Mathilda","F",52,37,89
"17744","Mathilde","F",26,24,50
"17745","Mathis","M",85,139,224
"17746","Mathius","M",10,7,17
"17747","Matias","M",664,913,1577
"17748","Matilda","F",581,623,1204
"17749","Matilde","F",29,29,58
"17750","Matilyn","F",39,29,68
"17751","Matilynn","F",10,9,19
"17752","Matin","M",9,9,18
"17753","Matis","M",9,12,21
"17754","Matisse","M",15,10,25
"17755","Matix","M",48,32,80
"17756","Matson","M",8,14,22
"17757","Matt","M",57,58,115
"17758","Mattalynn","F",8,11,19
"17759","Mattea","F",26,25,51
"17760","Matteo","M",2166,2377,4543
"17761","Matteus","M",10,5,15
"17762","Mattew","M",16,19,35
"17763","Matthan","M",5,9,14
"17764","Mattheo","M",12,16,28
"17765","Mattheus","M",9,6,15
"17766","Matthew","F",15,12,27
"17767","Matthew","M",12717,12551,25268
"17768","Matthews","M",16,10,26
"17769","Matthias","M",515,602,1117
"17770","Matthieu","M",27,21,48
"17771","Matthis","M",5,5,10
"17772","Matti","F",12,16,28
"17773","Mattia","M",16,18,34
"17774","Mattias","M",103,106,209
"17775","Mattie","F",267,255,522
"17776","Mattilyn","F",30,21,51
"17777","Mattilynn","F",20,16,36
"17778","Mattingly","F",10,13,23
"17779","Mattis","M",16,39,55
"17780","Mattison","F",66,51,117
"17781","Mattisyn","F",9,12,21
"17782","Mattix","M",31,31,62
"17783","Mattox","M",47,35,82
"17784","Matty","F",21,18,39
"17785","Matvei","M",7,9,16
"17786","Matvey","M",18,14,32
"17787","Matviy","M",6,5,11
"17788","Maty","F",5,7,12
"17789","Matyas","M",17,6,23
"17790","Matylda","F",9,6,15
"17791","Maude","F",16,17,33
"17792","Maudie","F",11,5,16
"17793","Maui","F",7,7,14
"17794","Maura","F",154,143,297
"17795","Maureen","F",43,41,84
"17796","Mauriah","F",8,12,20
"17797","Maurice","M",432,406,838
"17798","Mauricio","M",509,500,1009
"17799","Maurizio","M",14,17,31
"17800","Mauro","M",100,104,204
"17801","Maury","M",5,11,16
"17802","Maven","F",44,69,113
"17803","Maven","M",14,24,38
"17804","Maveric","M",17,36,53
"17805","Maverick","F",23,25,48
"17806","Maverick","M",2265,2940,5205
"17807","Maverik","M",44,65,109
"17808","Mavery","F",9,9,18
"17809","Maveryck","M",9,12,21
"17810","Mavi","F",6,8,14
"17811","Mavin","M",5,6,11
"17812","Mavis","F",265,358,623
"17813","Mavric","M",9,11,20
"17814","Mavrick","M",62,69,131
"17815","Mavrik","M",32,36,68
"17816","Mavryck","M",9,14,23
"17817","Mavryk","M",14,12,26
"17818","Max","F",23,54,77
"17819","Max","M",3409,3394,6803
"17820","Maxamilian","M",6,6,12
"17821","Maxamillion","M",14,8,22
"17822","Maxamus","M",11,5,16
"17823","Maxden","M",10,11,21
"17824","Maxemiliano","M",36,26,62
"17825","Maxen","M",51,59,110
"17826","Maxfield","M",10,10,20
"17827","Maxi","M",9,6,15
"17828","Maxie","F",12,11,23
"17829","Maxim","M",301,263,564
"17830","Maxima","F",13,13,26
"17831","Maxime","M",38,31,69
"17832","Maximilian","M",698,715,1413
"17833","Maximiliano","M",1193,1381,2574
"17834","Maximilien","M",14,15,29
"17835","Maximillian","M",101,89,190
"17836","Maximilliano","M",37,45,82
"17837","Maximillion","M",15,24,39
"17838","Maximino","M",28,29,57
"17839","Maximo","M",263,319,582
"17840","Maximos","M",19,15,34
"17841","Maximus","M",2055,2108,4163
"17842","Maxin","M",7,7,14
"17843","Maxine","F",233,305,538
"17844","Maxon","M",104,96,200
"17845","Maxson","M",67,76,143
"17846","Maxten","M",11,10,21
"17847","Maxtin","M",9,6,15
"17848","Maxton","M",286,328,614
"17849","Maxtyn","M",8,8,16
"17850","Maxwel","M",5,8,13
"17851","Maxwell","F",40,60,100
"17852","Maxwell","M",3543,3559,7102
"17853","Maxx","F",6,10,16
"17854","Maxx","M",165,164,329
"17855","Maxximus","M",22,34,56
"17856","Maxxon","M",10,10,20
"17857","Maxxwell","M",13,9,22
"17858","Maxym","M",5,6,11
"17859","May","F",130,131,261
"17860","Maya","F",4115,4055,8170
"17861","Mayah","F",173,130,303
"17862","Mayan","F",8,6,14
"17863","Mayan","M",12,10,22
"17864","Mayana","F",6,6,12
"17865","Mayank","M",8,9,17
"17866","Mayar","F",73,60,133
"17867","Mayar","M",5,8,13
"17868","Mayara","F",8,6,14
"17869","Mayari","F",6,7,13
"17870","Maybel","F",16,14,30
"17871","Maybelle","F",35,33,68
"17872","Maybellene","F",6,7,13
"17873","Maybelline","F",19,21,40
"17874","Maybree","F",24,19,43
"17875","Maybrie","F",5,6,11
"17876","Mayce","F",5,7,12
"17877","Maycee","F",105,99,204
"17878","Maycen","M",11,7,18
"17879","Mayceon","M",5,5,10
"17880","Mayci","F",33,20,53
"17881","Maycie","F",63,62,125
"17882","Mayco","M",8,7,15
"17883","Maycol","M",14,17,31
"17884","Maycon","M",6,5,11
"17885","Maydelin","F",5,7,12
"17886","Maye","F",10,7,17
"17887","Mayela","F",11,8,19
"17888","Mayeli","F",27,49,76
"17889","Mayelin","F",11,5,16
"17890","Mayella","F",7,5,12
"17891","Mayer","M",61,64,125
"17892","Mayerlin","F",5,8,13
"17893","Mayerly","F",12,10,22
"17894","Mayes","M",8,6,14
"17895","Mayim","F",8,10,18
"17896","Mayjor","M",9,9,18
"17897","Maykel","M",9,8,17
"17898","Maykol","M",8,9,17
"17899","Mayla","F",80,89,169
"17900","Maylani","F",60,53,113
"17901","Maylanie","F",11,8,19
"17902","Maylea","F",13,11,24
"17903","Maylee","F",233,268,501
"17904","Mayleen","F",53,40,93
"17905","Mayleigh","F",48,48,96
"17906","Maylen","F",45,28,73
"17907","Maylene","F",29,28,57
"17908","Mayley","F",8,9,17
"17909","Mayli","F",21,15,36
"17910","Maylie","F",31,25,56
"17911","Maylin","F",103,80,183
"17912","Mayline","F",7,6,13
"17913","Maylyn","F",8,9,17
"17914","Maylynn","F",27,22,49
"17915","Maymuna","F",7,11,18
"17916","Maymunah","F",8,5,13
"17917","Maynard","M",16,6,22
"17918","Maynor","M",23,23,46
"17919","Mayra","F",189,178,367
"17920","Mayrani","F",15,17,32
"17921","Mayrin","F",46,24,70
"17922","Mays","F",8,5,13
"17923","Mays","M",5,12,17
"17924","Maysa","F",30,42,72
"17925","Maysam","F",7,6,13
"17926","Maysen","F",26,25,51
"17927","Maysen","M",39,52,91
"17928","Maysie","F",10,13,23
"17929","Maysin","M",8,10,18
"17930","Mayson","F",44,24,68
"17931","Mayson","M",294,265,559
"17932","Maysoon","F",9,5,14
"17933","Maytal","F",7,5,12
"17934","Mayte","F",89,92,181
"17935","Mayukh","M",9,5,14
"17936","Mayukha","F",13,8,21
"17937","Mayumi","F",21,17,38
"17938","Mayven","F",6,7,13
"17939","Mayvis","F",18,11,29
"17940","Mayzee","F",15,11,26
"17941","Mayzie","F",59,49,108
"17942","Mazal","F",10,10,20
"17943","Maze","M",14,11,25
"17944","Mazen","M",51,59,110
"17945","Mazey","F",15,10,25
"17946","Mazi","M",10,22,32
"17947","Maziah","F",5,9,14
"17948","Maziah","M",9,6,15
"17949","Mazie","F",117,130,247
"17950","Mazin","M",22,29,51
"17951","Maziyah","F",14,13,27
"17952","Mazlyn","F",7,7,14
"17953","Mazon","M",5,10,15
"17954","Mazy","F",13,13,26
"17955","Mazzie","F",7,9,16
"17956","Mazzy","F",33,39,72
"17957","Mcallister","M",5,9,14
"17958","Mccabe","M",7,7,14
"17959","Mccall","F",18,22,40
"17960","Mccartney","F",20,13,33
"17961","Mcclain","M",17,13,30
"17962","Mccormick","M",5,6,11
"17963","Mccoy","F",7,6,13
"17964","Mccoy","M",191,170,361
"17965","Mccrae","M",9,10,19
"17966","Mccray","M",5,6,11
"17967","Mcguire","M",6,5,11
"17968","Mckaela","F",12,5,17
"17969","Mckay","F",11,6,17
"17970","Mckay","M",41,54,95
"17971","Mckayla","F",261,217,478
"17972","Mckaylee","F",10,11,21
"17973","Mckena","F",5,9,14
"17974","Mckenize","F",8,9,17
"17975","Mckenlee","F",18,16,34
"17976","Mckenleigh","F",21,19,40
"17977","Mckenley","F",16,11,27
"17978","Mckenna","F",1299,1245,2544
"17979","Mckennah","F",20,13,33
"17980","Mckensie","F",13,10,23
"17981","Mckenzee","F",24,15,39
"17982","Mckenzi","F",59,54,113
"17983","Mckenzie","F",2124,1982,4106
"17984","Mckenzie","M",12,17,29
"17985","Mckenzy","F",22,21,43
"17986","Mckenzye","F",7,8,15
"17987","Mckinlee","F",83,94,177
"17988","Mckinleigh","F",29,36,65
"17989","Mckinley","F",858,755,1613
"17990","Mckinley","M",73,68,141
"17991","Mckinna","F",9,5,14
"17992","Mckinnley","F",38,26,64
"17993","Mckinnon","M",8,7,15
"17994","Mckinsey","F",18,20,38
"17995","Mckinsley","F",17,15,32
"17996","Mckinzie","F",23,19,42
"17997","Mckinzley","F",5,7,12
"17998","Mckoy","M",13,21,34
"17999","Mckyla","F",7,5,12
"18000","Mckynlee","F",54,42,96
"18001","Mckynleigh","F",8,6,14
"18002","Mckynlie","F",12,12,24
"18003","Mckynzi","F",6,6,12
"18004","Mckynzie","F",26,34,60
"18005","Mclain","M",10,6,16
"18006","Mclane","M",5,5,10
"18007","Mclean","M",6,6,12
"18008","Md","M",27,29,56
"18009","Mea","F",53,43,96
"18010","Meadow","F",420,423,843
"18011","Meagan","F",71,57,128
"18012","Meaghan","F",18,14,32
"18013","Meah","F",69,52,121
"18014","Meara","F",72,52,124
"18015","Meba","M",5,11,16
"18016","Mecca","F",21,32,53
"18017","Mecca","M",31,34,65
"18018","Mechel","M",7,7,14
"18019","Mechelle","F",6,6,12
"18020","Medha","F",29,34,63
"18021","Medhansh","M",11,6,17
"18022","Medina","F",26,26,52
"18023","Meeah","F",11,7,18
"18024","Meeka","F",21,8,29
"18025","Meeko","M",10,9,19
"18026","Meela","F",33,29,62
"18027","Meelah","F",28,16,44
"18028","Meena","F",26,45,71
"18029","Meenakshi","F",19,28,47
"18030","Meer","M",11,13,24
"18031","Meera","F",186,197,383
"18032","Meerab","F",18,17,35
"18033","Meesha","F",6,7,13
"18034","Meeya","F",6,7,13
"18035","Meeyah","F",5,10,15
"18036","Meg","F",20,19,39
"18037","Mega","M",11,18,29
"18038","Megan","F",850,743,1593
"18039","Megha","F",18,16,34
"18040","Meghan","F",240,201,441
"18041","Meghana","F",15,9,24
"18042","Meghna","F",24,16,40
"18043","Megyn","F",11,9,20
"18044","Mehak","F",12,8,20
"18045","Mehar","F",26,28,54
"18046","Mehar","M",7,9,16
"18047","Mehdi","M",25,27,52
"18048","Meher","F",36,30,66
"18049","Mehjabeen","F",5,5,10
"18050","Mehkai","M",10,11,21
"18051","Mehki","M",51,53,104
"18052","Mehmet","M",42,35,77
"18053","Mehr","F",12,12,24
"18054","Mehran","M",10,11,21
"18055","Mehreen","F",14,8,22
"18056","Mehtab","M",16,22,38
"18057","Mei","F",44,53,97
"18058","Meia","F",13,11,24
"18059","Meiah","F",19,7,26
"18060","Meika","F",27,21,48
"18061","Meila","F",49,37,86
"18062","Meilani","F",284,263,547
"18063","Meilanie","F",14,11,25
"18064","Meilany","F",21,9,30
"18065","Meilech","M",5,14,19
"18066","Meili","F",17,13,30
"18067","Meilin","F",7,14,21
"18068","Meiling","F",13,5,18
"18069","Meilyn","F",11,9,20
"18070","Meir","M",152,149,301
"18071","Meira","F",53,56,109
"18072","Meital","F",6,5,11
"18073","Meiya","F",6,5,11
"18074","Meiyah","F",6,17,23
"18075","Meka","F",5,6,11
"18076","Mekael","M",5,5,10
"18077","Mekai","M",12,8,20
"18078","Mekayla","F",22,21,43
"18079","Mekenna","F",7,8,15
"18080","Mekenzie","F",21,16,37
"18081","Mekhai","M",27,30,57
"18082","Mekhi","M",419,426,845
"18083","Meklit","F",32,34,66
"18084","Mel","F",8,10,18
"18085","Mela","F",37,32,69
"18086","Melah","F",26,21,47
"18087","Melaina","F",21,30,51
"18088","Melaine","F",11,9,20
"18089","Melanee","F",19,25,44
"18090","Melaney","F",16,12,28
"18091","Melani","F",120,146,266
"18092","Melania","F",90,131,221
"18093","Melanie","F",3490,3473,6963
"18094","Melaniee","F",5,8,13
"18095","Melannie","F",63,50,113
"18096","Melanny","F",67,46,113
"18097","Melany","F",657,550,1207
"18098","Melat","F",13,5,18
"18099","Melaya","F",7,11,18
"18100","Melayna","F",17,14,31
"18101","Melaysia","F",9,7,16
"18102","Melchizedek","M",15,18,33
"18103","Melchor","M",5,5,10
"18104","Mele","F",26,20,46
"18105","Melea","F",9,12,21
"18106","Meleah","F",27,27,54
"18107","Meleana","F",12,13,25
"18108","Meleena","F",9,6,15
"18109","Melek","F",17,15,32
"18110","Melena","F",13,13,26
"18111","Melenie","F",10,11,21
"18112","Meli","F",6,9,15
"18113","Melia","F",127,117,244
"18114","Meliah","F",30,29,59
"18115","Meliana","F",16,9,25
"18116","Melih","M",5,6,11
"18117","Melik","M",6,10,16
"18118","Melina","F",502,489,991
"18119","Melinda","F",172,138,310
"18120","Melinna","F",6,13,19
"18121","Melis","F",19,11,30
"18122","Melisa","F",69,72,141
"18123","Melissa","F",1276,1228,2504
"18124","Melita","F",6,5,11
"18125","Meliya","F",9,9,18
"18126","Meliyah","F",23,21,44
"18127","Meliza","F",5,6,11
"18128","Mellani","F",7,6,13
"18129","Mellanie","F",17,14,31
"18130","Mellany","F",11,7,18
"18131","Mellie","F",9,16,25
"18132","Mellody","F",6,14,20
"18133","Melo","M",15,16,31
"18134","Melodee","F",22,35,57
"18135","Melodi","F",39,27,66
"18136","Melodie","F",119,97,216
"18137","Melody","F",2173,2128,4301
"18138","Meloni","F",7,7,14
"18139","Melonie","F",30,29,59
"18140","Melony","F",37,29,66
"18141","Melrose","F",16,28,44
"18142","Melvin","M",361,328,689
"18143","Melvyn","M",5,7,12
"18144","Melyna","F",11,13,24
"18145","Melyssa","F",19,12,31
"18146","Memorie","F",8,8,16
"18147","Memory","F",16,16,32
"18148","Memphis","F",104,92,196
"18149","Memphis","M",399,428,827
"18150","Mena","F",28,28,56
"18151","Mena","M",9,7,16
"18152","Menaal","F",26,22,48
"18153","Menachem","M",180,192,372
"18154","Menashe","M",21,12,33
"18155","Mendel","M",78,56,134
"18156","Mendy","M",30,33,63
"18157","Menelik","M",9,12,21
"18158","Menna","F",7,16,23
"18159","Menno","M",26,15,41
"18160","Menucha","F",20,26,46
"18161","Mera","F",20,22,42
"18162","Meral","F",13,13,26
"18163","Merari","F",23,20,43
"18164","Merary","F",17,12,29
"18165","Mercedes","F",240,250,490
"18166","Mercedez","F",37,36,73
"18167","Mercer","F",8,17,25
"18168","Mercer","M",36,43,79
"18169","Merci","F",32,43,75
"18170","Mercie","F",5,7,12
"18171","Mercury","F",5,6,11
"18172","Mercury","M",9,5,14
"18173","Mercy","F",263,357,620
"18174","Mercy","M",11,12,23
"18175","Meredith","F",509,583,1092
"18176","Merek","M",17,22,39
"18177","Merelyn","F",10,13,23
"18178","Meri","F",8,13,21
"18179","Meria","F",5,5,10
"18180","Meriah","F",7,9,16
"18181","Meriam","F",14,20,34
"18182","Meric","M",7,9,16
"18183","Merick","M",12,5,17
"18184","Merida","F",99,101,200
"18185","Meridian","F",12,8,20
"18186","Meridith","F",6,7,13
"18187","Meriem","F",9,8,17
"18188","Merik","M",10,20,30
"18189","Merilyn","F",5,5,10
"18190","Merina","F",7,5,12
"18191","Merissa","F",7,9,16
"18192","Merit","F",12,10,22
"18193","Merit","M",10,15,25
"18194","Meritt","F",9,10,19
"18195","Meriwether","F",6,5,11
"18196","Merle","M",20,14,34
"18197","Merlin","F",12,11,23
"18198","Merlin","M",34,38,72
"18199","Merlyn","F",12,8,20
"18200","Merna","F",11,13,24
"18201","Meron","F",12,10,22
"18202","Merric","M",9,12,21
"18203","Merrick","F",20,15,35
"18204","Merrick","M",191,208,399
"18205","Merrik","M",12,12,24
"18206","Merrill","F",12,14,26
"18207","Merrill","M",10,11,21
"18208","Merrin","F",14,8,22
"18209","Merrit","M",5,6,11
"18210","Merritt","F",81,154,235
"18211","Merritt","M",71,78,149
"18212","Merry","F",24,32,56
"18213","Merryn","F",17,12,29
"18214","Mert","M",20,18,38
"18215","Mervin","M",48,53,101
"18216","Mery","F",8,9,17
"18217","Meryem","F",27,29,56
"18218","Meryl","F",50,29,79
"18219","Meryn","F",7,12,19
"18220","Mesa","F",32,29,61
"18221","Meshach","M",14,19,33
"18222","Meshal","M",7,9,16
"18223","Meshilem","M",17,31,48
"18224","Meshulem","M",12,10,22
"18225","Mesiah","M",22,26,48
"18226","Mesiyah","M",5,6,11
"18227","Messi","M",13,14,27
"18228","Messiah","F",49,35,84
"18229","Messiah","M",1512,1776,3288
"18230","Messiyah","M",10,15,25
"18231","Mete","M",12,7,19
"18232","Metzli","F",10,10,20
"18233","Metztli","F",15,11,26
"18234","Meya","F",26,27,53
"18235","Meyah","F",23,19,42
"18236","Meyer","F",14,21,35
"18237","Meyer","M",73,77,150
"18238","Meylani","F",9,7,16
"18239","Meylin","F",19,26,45
"18240","Meyson","M",5,6,11
"18241","Meziah","M",8,11,19
"18242","Meztli","F",18,12,30
"18243","Mi","F",10,6,16
"18244","Mia","F",14871,14366,29237
"18245","Mia","M",17,14,31
"18246","Miaa","F",17,16,33
"18247","Miabella","F",126,139,265
"18248","Miagrace","F",13,9,22
"18249","Miah","F",469,474,943
"18250","Miaisabella","F",9,6,15
"18251","Miakoda","F",13,9,22
"18252","Mialani","F",7,7,14
"18253","Mialynn","F",18,12,30
"18254","Miamarie","F",6,9,15
"18255","Miamor","F",51,43,94
"18256","Miamore","F",6,11,17
"18257","Miana","F",22,12,34
"18258","Miangel","F",47,47,94
"18259","Mianna","F",25,20,45
"18260","Miarose","F",27,15,42
"18261","Miasia","F",20,15,35
"18262","Miaya","F",8,10,18
"18263","Mica","F",32,19,51
"18264","Mica","M",21,12,33
"18265","Micaela","F",223,242,465
"18266","Micaella","F",15,11,26
"18267","Micah","F",334,276,610
"18268","Micah","M",3731,3447,7178
"18269","Micaiah","F",49,65,114
"18270","Micaiah","M",96,125,221
"18271","Micajah","M",8,5,13
"18272","Micayla","F",45,21,66
"18273","Micco","M",9,11,20
"18274","Micha","F",22,14,36
"18275","Micha","M",20,15,35
"18276","Michael","F",36,34,70
"18277","Michael","M",14396,13998,28394
"18278","Michaela","F",646,669,1315
"18279","Michaelah","F",7,6,13
"18280","Michaelangelo","M",52,38,90
"18281","Michaelanthony","M",7,9,16
"18282","Michaella","F",28,39,67
"18283","Michah","M",6,13,19
"18284","Michai","M",16,13,29
"18285","Michaiah","F",7,7,14
"18286","Michal","F",38,53,91
"18287","Michal","M",19,22,41
"18288","Michale","M",10,9,19
"18289","Michayla","F",21,17,38
"18290","Micheal","M",266,241,507
"18291","Micheala","F",8,12,20
"18292","Michel","F",13,6,19
"18293","Michel","M",41,19,60
"18294","Michela","F",23,17,40
"18295","Michelangelo","M",76,42,118
"18296","Michele","F",61,59,120
"18297","Michelina","F",11,8,19
"18298","Michell","F",16,12,28
"18299","Michella","F",5,5,10
"18300","Michelle","F",1699,1559,3258
"18301","Michoel","M",12,11,23
"18302","Miciah","M",10,9,19
"18303","Mick","M",36,41,77
"18304","Mickael","M",7,8,15
"18305","Mickaela","F",7,11,18
"18306","Mickayla","F",22,20,42
"18307","Mickel","M",12,14,26
"18308","Mickenzie","F",6,9,15
"18309","Mickey","F",11,11,22
"18310","Mickey","M",102,88,190
"18311","Micky","M",20,16,36
"18312","Midas","M",15,16,31
"18313","Midori","F",10,17,27
"18314","Mieko","F",5,5,10
"18315","Miesha","F",13,32,45
"18316","Miette","F",8,5,13
"18317","Miguel","M",2563,2492,5055
"18318","Miguelangel","M",85,81,166
"18319","Mihaela","F",7,7,14
"18320","Mihail","M",9,9,18
"18321","Mihailo","M",5,7,12
"18322","Mihajlo","M",9,6,15
"18323","Mihika","F",37,28,65
"18324","Mihir","M",42,33,75
"18325","Mihira","F",17,18,35
"18326","Mihran","M",11,6,17
"18327","Miia","F",16,14,30
"18328","Mika","F",199,183,382
"18329","Mika","M",43,48,91
"18330","Mikaeel","M",16,25,41
"18331","Mikael","M",157,214,371
"18332","Mikaela","F",483,485,968
"18333","Mikaella","F",33,19,52
"18334","Mikaelyn","F",5,5,10
"18335","Mikah","F",56,40,96
"18336","Mikah","M",120,131,251
"18337","Mikai","M",26,30,56
"18338","Mikaiah","F",5,8,13
"18339","Mikail","M",42,52,94
"18340","Mikaila","F",38,30,68
"18341","Mikal","F",8,6,14
"18342","Mikal","M",27,28,55
"18343","Mikala","F",22,18,40
"18344","Mikalyn","F",5,6,11
"18345","Mikaya","F",12,17,29
"18346","Mikayah","F",5,7,12
"18347","Mikayla","F",943,819,1762
"18348","Mikaylah","F",32,25,57
"18349","Mikaylee","F",12,9,21
"18350","Mike","M",195,189,384
"18351","Mikeal","M",20,12,32
"18352","Mikeala","F",6,7,13
"18353","Mikeila","F",7,6,13
"18354","Mikel","M",148,144,292
"18355","Mikela","F",13,5,18
"18356","Mikell","M",20,24,44
"18357","Mikella","F",12,6,18
"18358","Mikelle","F",9,8,17
"18359","Miken","M",12,11,23
"18360","Mikenna","F",33,25,58
"18361","Mikenzi","F",8,5,13
"18362","Mikenzie","F",31,37,68
"18363","Mikey","M",32,28,60
"18364","Mikeyla","F",20,17,37
"18365","Mikhael","M",56,44,100
"18366","Mikhaela","F",15,11,26
"18367","Mikhai","M",9,7,16
"18368","Mikhail","M",143,128,271
"18369","Mikhaila","F",5,11,16
"18370","Mikhayla","F",5,9,14
"18371","Mikhi","M",9,11,20
"18372","Miki","F",10,10,20
"18373","Mikia","F",6,6,12
"18374","Mikiah","F",11,7,18
"18375","Mikiah","M",8,6,14
"18376","Mikias","M",8,6,14
"18377","Miking","M",33,31,64
"18378","Mikiyah","F",15,12,27
"18379","Mikiyas","M",5,10,15
"18380","Mikka","F",10,6,16
"18381","Mikkel","M",19,15,34
"18382","Mikki","F",7,6,13
"18383","Mikko","M",44,38,82
"18384","Miklo","M",14,12,26
"18385","Miko","F",10,13,23
"18386","Miko","M",30,33,63
"18387","Mikyah","F",8,5,13
"18388","Mikyla","F",26,18,44
"18389","Mikylah","F",9,6,15
"18390","Mikyle","M",8,10,18
"18391","Mila","F",4724,4802,9526
"18392","Mila","M",8,8,16
"18393","Milad","M",14,12,26
"18394","Milagro","F",25,34,59
"18395","Milagros","F",186,149,335
"18396","Milah","F",212,198,410
"18397","Milaina","F",6,14,20
"18398","Milam","M",8,8,16
"18399","Milan","F",406,376,782
"18400","Milan","M",723,685,1408
"18401","Milana","F",419,395,814
"18402","Milanee","F",5,6,11
"18403","Milani","F",426,450,876
"18404","Milania","F",351,287,638
"18405","Milanie","F",22,15,37
"18406","Milanna","F",12,6,18
"18407","Milanni","F",9,5,14
"18408","Milano","M",6,8,14
"18409","Milany","F",23,13,36
"18410","Milanya","F",6,9,15
"18411","Milarose","F",6,10,16
"18412","Milas","M",7,5,12
"18413","Milaya","F",18,19,37
"18414","Milayah","F",21,18,39
"18415","Milayna","F",17,9,26
"18416","Milaysia","F",8,11,19
"18417","Milca","F",5,14,19
"18418","Milcah","F",9,6,15
"18419","Mildred","F",87,78,165
"18420","Mileah","F",15,13,28
"18421","Mileena","F",116,109,225
"18422","Mileidy","F",7,11,18
"18423","Milena","F",372,405,777
"18424","Milenka","F",7,7,14
"18425","Miles","F",11,11,22
"18426","Miles","M",3724,3714,7438
"18427","Miley","F",263,247,510
"18428","Milez","M",7,5,12
"18429","Mili","F",17,11,28
"18430","Milia","F",13,8,21
"18431","Miliah","F",7,5,12
"18432","Milian","F",5,9,14
"18433","Miliana","F",58,70,128
"18434","Miliani","F",34,24,58
"18435","Miliano","M",14,5,19
"18436","Miliany","F",5,6,11
"18437","Milica","F",15,12,27
"18438","Mililani","F",9,14,23
"18439","Milinda","F",6,9,15
"18440","Miliyah","F",15,18,33
"18441","Milka","F",13,7,20
"18442","Milla","F",81,55,136
"18443","Millan","M",18,9,27
"18444","Millani","F",6,6,12
"18445","Millard","M",9,10,19
"18446","Millee","F",13,14,27
"18447","Millena","F",9,7,16
"18448","Miller","F",71,77,148
"18449","Miller","M",271,261,532
"18450","Milli","F",11,19,30
"18451","Milliana","F",40,33,73
"18452","Milliani","F",5,7,12
"18453","Millianna","F",20,9,29
"18454","Millicent","F",83,119,202
"18455","Millie","F",677,735,1412
"18456","Million","M",9,17,26
"18457","Mills","M",15,22,37
"18458","Milly","F",88,112,200
"18459","Milo","F",13,26,39
"18460","Milo","M",1276,1495,2771
"18461","Miloh","M",17,24,41
"18462","Milos","M",11,16,27
"18463","Milton","M",153,149,302
"18464","Mily","F",11,16,27
"18465","Milynn","F",16,13,29
"18466","Mimi","F",23,20,43
"18467","Mina","F",368,380,748
"18468","Mina","M",20,31,51
"18469","Minaal","F",6,6,12
"18470","Minah","F",19,8,27
"18471","Minahil","F",9,25,34
"18472","Minato","M",10,18,28
"18473","Mindel","F",8,12,20
"18474","Mindy","F",78,88,166
"18475","Minerva","F",51,65,116
"18476","Minh","F",6,6,12
"18477","Minh","M",39,29,68
"18478","Minha","F",28,39,67
"18479","Minka","F",30,28,58
"18480","Minna","F",33,29,62
"18481","Minnah","F",15,23,38
"18482","Minnie","F",68,65,133
"18483","Minsa","F",10,13,23
"18484","Mio","F",15,15,30
"18485","Mio","M",7,8,15
"18486","Mionna","F",7,5,12
"18487","Miqueas","M",8,15,23
"18488","Miquel","M",11,9,20
"18489","Mir","M",17,14,31
"18490","Mira","F",515,567,1082
"18491","Mirabel","F",44,54,98
"18492","Mirabella","F",61,65,126
"18493","Mirabelle","F",99,81,180
"18494","Miracle","F",770,856,1626
"18495","Miracle","M",13,26,39
"18496","Mirae","F",7,5,12
"18497","Mirah","F",24,23,47
"18498","Mirai","F",13,18,31
"18499","Miraj","M",12,10,22
"18500","Mirakle","F",8,15,23
"18501","Miral","F",31,31,62
"18502","Miran","M",7,9,16
"18503","Miranda","F",1134,1135,2269
"18504","Miray","F",6,9,15
"18505","Miraya","F",29,26,55
"18506","Mireille","F",20,27,47
"18507","Mirel","F",26,31,57
"18508","Mirela","F",6,7,13
"18509","Mirella","F",31,31,62
"18510","Mirelle","F",7,5,12
"18511","Mirely","F",8,10,18
"18512","Mireya","F",153,184,337
"18513","Mireyah","F",7,9,16
"18514","Mirha","F",8,8,16
"18515","Miri","F",30,36,66
"18516","Miriah","F",10,8,18
"18517","Miriam","F",1098,1100,2198
"18518","Mirian","F",13,26,39
"18519","Miriana","F",5,8,13
"18520","Mirielle","F",25,43,68
"18521","Mirko","M",7,9,16
"18522","Mirna","F",27,38,65
"18523","Miro","M",9,15,24
"18524","Mirola","F",9,6,15
"18525","Miron","M",18,19,37
"18526","Miroslav","M",6,8,14
"18527","Miroslava","F",18,15,33
"18528","Mirra","F",11,21,32
"18529","Mirren","F",10,10,20
"18530","Miryam","F",18,15,33
"18531","Mirza","M",16,14,30
"18532","Misa","F",25,12,37
"18533","Misael","M",254,275,529
"18534","Misaki","F",8,11,19
"18535","Mischa","F",47,42,89
"18536","Misha","F",77,71,148
"18537","Misha","M",21,14,35
"18538","Mishael","M",7,11,18
"18539","Mishal","F",11,10,21
"18540","Misheel","F",5,9,14
"18541","Mishel","F",7,5,12
"18542","Mishell","F",10,5,15
"18543","Mishelle","F",15,10,25
"18544","Mishika","F",41,40,81
"18545","Mishka","F",42,56,98
"18546","Misk","F",16,17,33
"18547","Miski","F",6,7,13
"18548","Missael","M",16,12,28
"18549","Missy","F",9,10,19
"18550","Mister","M",26,18,44
"18551","Misty","F",52,43,95
"18552","Mitch","M",16,17,33
"18553","Mitchel","M",22,25,47
"18554","Mitchell","M",472,458,930
"18555","Mithila","F",5,6,11
"18556","Mithra","F",20,34,54
"18557","Mithran","M",20,30,50
"18558","Mithun","M",5,5,10
"18559","Mitra","F",9,11,20
"18560","Mitzi","F",25,16,41
"18561","Mitzy","F",15,8,23
"18562","Miu","F",7,6,13
"18563","Mivaan","M",8,17,25
"18564","Miwa","F",7,8,15
"18565","Miya","F",279,284,563
"18566","Miyah","F",195,169,364
"18567","Miyana","F",24,22,46
"18568","Miyani","F",6,5,11
"18569","Miyanna","F",25,14,39
"18570","Miyla","F",6,6,12
"18571","Miylah","F",6,7,13
"18572","Miyonna","F",17,10,27
"18573","Miyu","F",8,10,18
"18574","Miyuki","F",11,6,17
"18575","Mizael","M",20,17,37
"18576","Mizuki","F",16,8,24
"18577","Mkayla","F",7,6,13
"18578","Mkenzie","F",7,13,20
"18579","Moana","F",18,56,74
"18580","Moataz","M",8,7,15
"18581","Moath","M",8,7,15
"18582","Moayad","M",6,6,12
"18583","Moaz","M",7,6,13
"18584","Modesireoluwa","F",5,9,14
"18585","Modesto","M",10,10,20
"18586","Modesty","F",14,15,29
"18587","Modou","M",5,5,10
"18588","Mohamad","M",78,64,142
"18589","Mohamadali","M",6,6,12
"18590","Mohamed","M",671,646,1317
"18591","Mohamedamin","M",24,30,54
"18592","Mohammad","M",524,450,974
"18593","Mohammed","M",560,461,1021
"18594","Mohammedali","M",6,8,14
"18595","Mohamud","M",12,12,24
"18596","Mohan","M",6,12,18
"18597","Mohanad","M",7,9,16
"18598","Mohid","M",13,19,32
"18599","Mohit","M",7,7,14
"18600","Mohsen","M",7,15,22
"18601","Mohsin","M",13,19,32
"18602","Moira","F",131,117,248
"18603","Moise","M",12,8,20
"18604","Moises","M",625,632,1257
"18605","Moishe","M",37,22,59
"18606","Moishy","M",8,7,15
"18607","Moiz","M",8,6,14
"18608","Moksh","M",31,31,62
"18609","Moksha","F",20,17,37
"18610","Mollee","F",22,8,30
"18611","Molleigh","F",6,13,19
"18612","Molli","F",32,28,60
"18613","Mollie","F",272,261,533
"18614","Molly","F",2249,1977,4226
"18615","Momin","M",8,9,17
"18616","Momina","F",6,8,14
"18617","Momo","F",6,7,13
"18618","Momoka","F",13,7,20
"18619","Mona","F",107,119,226
"18620","Monae","F",52,53,105
"18621","Monalisa","F",9,7,16
"18622","Moncerrat","F",5,6,11
"18623","Mone","F",9,7,16
"18624","Monet","F",40,45,85
"18625","Monica","F",554,515,1069
"18626","Moniece","F",6,11,17
"18627","Monika","F",47,45,92
"18628","Monique","F",101,60,161
"18629","Monroe","F",394,416,810
"18630","Monroe","M",141,128,269
"18631","Monserat","F",8,6,14
"18632","Monserath","F",7,7,14
"18633","Monserrat","F",367,308,675
"18634","Monserrath","F",53,46,99
"18635","Montae","M",15,16,31
"18636","Montana","F",126,135,261
"18637","Montana","M",71,60,131
"18638","Montanna","F",10,11,21
"18639","Montavious","M",12,15,27
"18640","Monte","M",108,109,217
"18641","Montel","M",9,12,21
"18642","Montell","M",7,6,13
"18643","Montez","M",50,35,85
"18644","Montgomery","F",22,14,36
"18645","Montgomery","M",103,115,218
"18646","Montre","M",7,7,14
"18647","Montreal","M",14,7,21
"18648","Montrel","M",8,13,21
"18649","Montrell","M",50,44,94
"18650","Montrez","M",11,5,16
"18651","Montserrat","F",440,349,789
"18652","Montserrath","F",7,8,15
"18653","Monty","M",48,45,93
"18654","Montzerrat","F",18,7,25
"18655","Monzerrat","F",17,22,39
"18656","Monzerrath","F",7,5,12
"18657","Moo","M",8,5,13
"18658","Moon","F",8,7,15
"18659","Moosa","M",14,12,26
"18660","Mora","F",21,20,41
"18661","Morad","M",6,8,14
"18662","Mordche","M",9,15,24
"18663","Mordecai","M",57,67,124
"18664","Mordechai","M",173,179,352
"18665","Mordekai","M",6,5,11
"18666","Morelia","F",11,8,19
"18667","Morgan","F",2680,2319,4999
"18668","Morgan","M",378,407,785
"18669","Morgana","F",12,18,30
"18670","Morgen","F",19,9,28
"18671","Morghan","F",35,25,60
"18672","Morgyn","F",22,17,39
"18673","Moriah","F",277,281,558
"18674","Morireoluwa","F",7,9,16
"18675","Morireoluwa","M",7,5,12
"18676","Moriyah","F",8,20,28
"18677","Moroni","M",9,8,17
"18678","Morrigan","F",48,41,89
"18679","Morris","M",105,103,208
"18680","Morrison","F",7,7,14
"18681","Morrison","M",80,56,136
"18682","Mose","M",13,14,27
"18683","Moses","M",633,657,1290
"18684","Moshe","M",529,505,1034
"18685","Mosiah","M",30,35,65
"18686","Mosley","F",5,18,23
"18687","Moss","M",7,10,17
"18688","Mostafa","M",30,19,49
"18689","Motty","M",7,17,24
"18690","Motunrayo","F",6,5,11
"18691","Mouhamad","M",8,13,21
"18692","Mouhamadou","M",13,10,23
"18693","Mouhamed","M",32,35,67
"18694","Mourad","M",14,13,27
"18695","Mousa","M",19,16,35
"18696","Moussa","M",38,42,80
"18697","Moustafa","M",8,7,15
"18698","Moustapha","M",18,15,33
"18699","Mowgli","M",6,5,11
"18700","Moxie","F",36,47,83
"18701","Moxon","M",14,19,33
"18702","Moyinoluwa","F",5,7,12
"18703","Moziah","M",5,5,10
"18704","Muaad","M",7,10,17
"18705","Muaaz","M",7,9,16
"18706","Muad","M",30,25,55
"18707","Muadh","M",5,23,28
"18708","Muaz","M",17,20,37
"18709","Mubarak","M",22,27,49
"18710","Mubashir","M",9,19,28
"18711","Mubina","F",8,11,19
"18712","Mudasir","M",6,7,13
"18713","Mudassir","M",10,5,15
"18714","Muhamad","M",12,10,22
"18715","Muhamed","M",19,28,47
"18716","Muhammad","M",881,958,1839
"18717","Muhammadali","M",12,24,36
"18718","Muhammed","M",92,80,172
"18719","Muhanad","M",8,5,13
"18720","Muhannad","M",6,8,14
"18721","Muhsin","M",29,38,67
"18722","Mujtaba","M",14,18,32
"18723","Mukhtar","M",7,12,19
"18724","Mukund","M",9,10,19
"18725","Mulan","F",23,32,55
"18726","Mumina","F",7,6,13
"18727","Mumtaz","F",19,24,43
"18728","Muna","F",36,36,72
"18729","Munachimso","F",22,14,36
"18730","Munachimso","M",14,14,28
"18731","Munasar","M",6,9,15
"18732","Muneeb","M",6,6,12
"18733","Muneer","M",7,6,13
"18734","Mung","M",7,11,18
"18735","Munir","M",30,27,57
"18736","Munira","F",37,29,66
"18737","Munisa","F",6,5,11
"18738","Muntaha","F",19,18,37
"18739","Muntas","F",8,10,18
"18740","Muntasir","M",6,7,13
"18741","Murad","M",20,56,76
"18742","Murari","M",7,5,12
"18743","Murat","M",9,11,20
"18744","Murdock","M",5,13,18
"18745","Muriel","F",28,21,49
"18746","Murphie","F",6,9,15
"18747","Murphy","F",88,124,212
"18748","Murphy","M",149,162,311
"18749","Murray","M",44,43,87
"18750","Murtaza","M",12,12,24
"18751","Musa","M",228,219,447
"18752","Musab","M",47,50,97
"18753","Musashi","M",5,5,10
"18754","Muscab","M",6,12,18
"18755","Mushka","F",16,11,27
"18756","Mushtaq","F",6,9,15
"18757","Musiq","F",7,7,14
"18758","Musiq","M",6,8,14
"18759","Muska","F",5,5,10
"18760","Muskan","F",6,11,17
"18761","Muslima","F",9,10,19
"18762","Mussa","M",8,6,14
"18763","Mustaf","M",6,11,17
"18764","Mustafa","M",237,233,470
"18765","Mustafe","M",7,5,12
"18766","Mustapha","M",18,24,42
"18767","Muzamil","M",11,9,20
"18768","Muzammil","M",9,11,20
"18769","My","F",14,9,23
"18770","Mya","F",2196,1902,4098
"18771","Myah","F",414,442,856
"18772","Myalynn","F",8,7,15
"18773","Myana","F",17,10,27
"18774","Myangel","F",16,17,33
"18775","Myanna","F",25,17,42
"18776","Myasia","F",37,35,72
"18777","Myca","F",6,5,11
"18778","Mycah","F",21,11,32
"18779","Mycah","M",23,18,41
"18780","Mychael","M",26,21,47
"18781","Mychal","M",16,13,29
"18782","Myelle","F",14,10,24
"18783","Myer","M",28,21,49
"18784","Myers","F",5,7,12
"18785","Myers","M",17,23,40
"18786","Myesha","F",10,5,15
"18787","Myia","F",43,20,63
"18788","Myiah","F",37,47,84
"18789","Myka","F",104,84,188
"18790","Myka","M",20,24,44
"18791","Mykael","M",15,18,33
"18792","Mykaela","F",16,14,30
"18793","Mykah","F",52,43,95
"18794","Mykah","M",54,50,104
"18795","Mykai","M",7,6,13
"18796","Mykal","M",23,15,38
"18797","Mykala","F",11,6,17
"18798","Mykayla","F",42,39,81
"18799","Mykel","F",7,5,12
"18800","Mykel","M",63,59,122
"18801","Mykell","M",22,17,39
"18802","Mykelti","F",8,8,16
"18803","Mykenna","F",5,7,12
"18804","Mykenzie","F",29,28,57
"18805","Myking","M",19,17,36
"18806","Myla","F",969,892,1861
"18807","Mylah","F",253,223,476
"18808","Mylan","F",15,17,32
"18809","Mylan","M",48,44,92
"18810","Mylani","F",21,17,38
"18811","Mylea","F",11,7,18
"18812","Myleah","F",24,19,43
"18813","Mylee","F",85,76,161
"18814","Myleen","F",8,6,14
"18815","Mylei","F",14,10,24
"18816","Myleigh","F",28,20,48
"18817","Mylen","M",10,5,15
"18818","Mylena","F",13,8,21
"18819","Mylene","F",14,11,25
"18820","Myles","F",13,17,30
"18821","Myles","M",1732,1688,3420
"18822","Mylia","F",19,10,29
"18823","Myliah","F",15,10,25
"18824","Mylie","F",22,37,59
"18825","Mylin","F",6,10,16
"18826","Mylo","F",5,15,20
"18827","Mylo","M",84,105,189
"18828","Mylon","M",10,11,21
"18829","Mylynn","F",10,9,19
"18830","Myna","F",5,5,10
"18831","Mynor","M",19,17,36
"18832","Myonna","F",17,13,30
"18833","Myra","F",493,560,1053
"18834","Myracle","F",59,53,112
"18835","Myrah","F",45,51,96
"18836","Myrakle","F",5,9,14
"18837","Myranda","F",14,13,27
"18838","Myriah","F",22,17,39
"18839","Myriam","F",38,32,70
"18840","Myrical","F",14,15,29
"18841","Myrick","M",7,7,14
"18842","Myrikal","F",7,9,16
"18843","Myrna","F",14,16,30
"18844","Myron","M",102,104,206
"18845","Mysha","F",16,19,35
"18846","Myson","M",12,12,24
"18847","Mystic","F",7,5,12
"18848","Mythili","F",6,5,11
"18849","Naama","F",8,6,14
"18850","Naaman","M",16,15,31
"18851","Naara","F",8,7,15
"18852","Naasir","M",8,13,21
"18853","Naava","F",13,17,30
"18854","Naavya","F",14,13,27
"18855","Naba","F",14,12,26
"18856","Nabeeha","F",10,13,23
"18857","Nabeel","M",22,26,48
"18858","Nabiha","F",37,20,57
"18859","Nabil","M",62,51,113
"18860","Nabila","F",26,17,43
"18861","Nachman","M",28,21,49
"18862","Nachmen","M",5,6,11
"18863","Nachum","M",10,9,19
"18864","Nada","F",52,56,108
"18865","Nadalie","F",10,5,15
"18866","Nadalyn","F",12,10,22
"18867","Nadalynn","F",11,7,18
"18868","Nadav","M",30,32,62
"18869","Nadeem","M",14,16,30
"18870","Nadeen","F",22,22,44
"18871","Nadelyn","F",6,8,14
"18872","Nader","M",12,9,21
"18873","Nadezhda","F",8,11,19
"18874","Nadia","F",948,908,1856
"18875","Nadiah","F",9,11,20
"18876","Nadim","M",10,14,24
"18877","Nadine","F",162,173,335
"18878","Nadir","M",25,27,52
"18879","Nadira","F",10,22,32
"18880","Nadirah","F",7,7,14
"18881","Nadiya","F",44,53,97
"18882","Nadiyah","F",27,17,44
"18883","Nadja","F",7,11,18
"18884","Nadra","F",8,7,15
"18885","Nadya","F",69,44,113
"18886","Naeem","M",50,51,101
"18887","Naeema","F",11,7,18
"18888","Naeemah","F",12,8,20
"18889","Nael","M",31,39,70
"18890","Naelani","F",6,9,15
"18891","Naelle","F",14,7,21
"18892","Naethan","M",5,5,10
"18893","Naetochukwu","M",11,17,28
"18894","Naeva","F",5,7,12
"18895","Naevia","F",38,22,60
"18896","Nafis","M",11,12,23
"18897","Nafisa","F",20,16,36
"18898","Naftali","M",58,50,108
"18899","Naftoli","M",11,10,21
"18900","Naftula","M",6,9,15
"18901","Naftuli","M",24,30,54
"18902","Naftuly","M",5,5,10
"18903","Nagi","M",6,5,11
"18904","Nahara","F",11,12,23
"18905","Naheem","M",9,13,22
"18906","Naheim","M",7,7,14
"18907","Nahia","F",21,19,40
"18908","Nahiara","F",5,14,19
"18909","Nahiem","M",5,6,11
"18910","Nahla","F",195,198,393
"18911","Nahlani","F",6,5,11
"18912","Nahlia","F",15,12,27
"18913","Nahom","M",43,44,87
"18914","Nahomi","F",58,89,147
"18915","Nahomy","F",64,70,134
"18916","Nahshon","M",12,9,21
"18917","Nahuel","M",11,9,20
"18918","Nahum","M",63,58,121
"18919","Nahzir","M",6,8,14
"18920","Nai","F",11,5,16
"18921","Naia","F",94,85,179
"18922","Naiah","F",10,7,17
"18923","Naiara","F",33,22,55
"18924","Naida","F",7,8,15
"18925","Naidelyn","F",20,24,44
"18926","Naif","M",15,13,28
"18927","Naija","F",5,7,12
"18928","Naila","F",96,105,201
"18929","Nailah","F",159,157,316
"18930","Nailani","F",12,10,22
"18931","Nailea","F",27,28,55
"18932","Naim","M",42,45,87
"18933","Naima","F",155,151,306
"18934","Naimah","F",26,29,55
"18935","Nain","M",15,12,27
"18936","Naina","F",35,50,85
"18937","Nainika","F",13,31,44
"18938","Nainoa","M",14,20,34
"18939","Naiomi","F",48,33,81
"18940","Naira","F",55,57,112
"18941","Nairah","F",6,5,11
"18942","Nairi","F",15,13,28
"18943","Nairobi","F",14,21,35
"18944","Naisha","F",40,51,91
"18945","Naithan","M",14,19,33
"18946","Naitik","M",5,13,18
"18947","Naiya","F",73,53,126
"18948","Naiyah","F",23,23,46
"18949","Naiyana","F",15,12,27
"18950","Naja","F",9,11,20
"18951","Najae","F",8,9,17
"18952","Najah","F",22,21,43
"18953","Najat","F",7,9,16
"18954","Najee","M",30,23,53
"18955","Najeeb","M",8,5,13
"18956","Naji","M",15,21,36
"18957","Najib","M",10,10,20
"18958","Najla","F",9,11,20
"18959","Najma","F",33,38,71
"18960","Najmo","F",7,6,13
"18961","Najwa","F",7,13,20
"18962","Nakai","F",7,5,12
"18963","Nakai","M",38,33,71
"18964","Nakaiya","F",5,5,10
"18965","Nakari","F",5,6,11
"18966","Nakari","M",5,6,11
"18967","Nakayla","F",30,30,60
"18968","Nakhi","M",5,8,13
"18969","Nakia","F",15,21,36
"18970","Nakiah","F",9,11,20
"18971","Nakira","F",8,5,13
"18972","Nakita","F",9,7,16
"18973","Nakiya","F",24,15,39
"18974","Nakiyah","F",27,21,48
"18975","Nakoa","M",21,28,49
"18976","Nakoda","M",7,5,12
"18977","Nakota","F",9,5,14
"18978","Nakota","M",9,15,24
"18979","Naksh","M",41,65,106
"18980","Nakshatra","F",14,13,27
"18981","Nakya","F",7,6,13
"18982","Nakyla","F",10,9,19
"18983","Nala","F",286,361,647
"18984","Nalah","F",61,69,130
"18985","Nalan","M",6,14,20
"18986","Nalani","F",189,269,458
"18987","Nalaya","F",22,16,38
"18988","Nalayah","F",27,31,58
"18989","Nalaysia","F",8,9,17
"18990","Nalea","F",7,6,13
"18991","Naleah","F",24,28,52
"18992","Naleyah","F",5,8,13
"18993","Nali","F",7,11,18
"18994","Nalia","F",34,36,70
"18995","Naliah","F",15,19,34
"18996","Nalina","F",10,8,18
"18997","Nalini","F",13,6,19
"18998","Naliya","F",14,8,22
"18999","Naliyah","F",53,48,101
"19000","Nallah","F",6,10,16
"19001","Nalleli","F",6,8,14
"19002","Nallely","F",47,57,104
"19003","Naloni","F",5,11,16
"19004","Nam","M",29,26,55
"19005","Naman","M",20,19,39
"19006","Namari","M",5,7,12
"19007","Nami","F",29,36,65
"19008","Namia","F",6,5,11
"19009","Namiah","F",6,6,12
"19010","Namiko","F",9,11,20
"19011","Namine","F",13,15,28
"19012","Namir","M",32,22,54
"19013","Namira","F",6,10,16
"19014","Namirah","F",5,5,10
"19015","Namish","M",7,15,22
"19016","Namiyah","F",13,7,20
"19017","Namya","F",6,11,17
"19018","Nana","F",22,21,43
"19019","Nana","M",25,27,52
"19020","Nanako","F",6,6,12
"19021","Nanami","F",8,6,14
"19022","Nancy","F",341,306,647
"19023","Nandan","M",16,14,30
"19024","Nandana","F",10,10,20
"19025","Nandi","F",15,10,25
"19026","Nandini","F",33,28,61
"19027","Nang","M",9,7,16
"19028","Nani","F",14,21,35
"19029","Naod","M",12,20,32
"19030","Naoki","M",8,9,17
"19031","Naol","M",7,14,21
"19032","Naomi","F",3750,3772,7522
"19033","Naomi","M",5,6,11
"19034","Naomie","F",35,34,69
"19035","Naomii","F",9,9,18
"19036","Naomy","F",64,53,117
"19037","Naphtali","M",7,6,13
"19038","Napoleon","M",18,13,31
"19039","Naquan","M",10,15,25
"19040","Nara","F",43,28,71
"19041","Naraly","F",15,5,20
"19042","Narayan","M",16,13,29
"19043","Nardos","F",17,12,29
"19044","Nare","F",5,7,12
"19045","Nareh","F",8,9,17
"19046","Narek","M",26,23,49
"19047","Narely","F",5,5,10
"19048","Nari","F",17,38,55
"19049","Naria","F",5,11,16
"19050","Nariah","F",154,148,302
"19051","Narissa","F",8,8,16
"19052","Nariya","F",14,20,34
"19053","Nariyah","F",64,99,163
"19054","Narjis","F",13,15,28
"19055","Naryah","F",13,21,34
"19056","Naryiah","F",11,9,20
"19057","Nas","M",16,20,36
"19058","Naseem","M",19,19,38
"19059","Naseer","M",16,12,28
"19060","Naser","M",8,15,23
"19061","Nash","F",6,6,12
"19062","Nash","M",990,1254,2244
"19063","Nashaun","M",5,6,11
"19064","Nashawn","M",8,9,17
"19065","Nashira","F",5,5,10
"19066","Nashla","F",39,41,80
"19067","Nashley","F",31,15,46
"19068","Nashly","F",27,20,47
"19069","Nashoba","M",5,6,11
"19070","Nashon","M",10,5,15
"19071","Nashton","M",21,17,38
"19072","Nasia","F",6,7,13
"19073","Nasiah","F",14,11,25
"19074","Nasiah","M",11,14,25
"19075","Nasier","M",9,5,14
"19076","Nasiir","M",8,5,13
"19077","Nasim","M",10,10,20
"19078","Nasir","M",561,668,1229
"19079","Nasirah","F",7,5,12
"19080","Nasiya","F",8,8,16
"19081","Nasiyah","F",16,13,29
"19082","Nason","M",30,25,55
"19083","Nasr","M",6,6,12
"19084","Nasra","F",18,12,30
"19085","Nasreen","F",12,9,21
"19086","Nasri","M",5,8,13
"19087","Nasro","F",6,6,12
"19088","Nasser","M",29,42,71
"19089","Nassim","M",10,7,17
"19090","Nassir","M",30,19,49
"19091","Nastassia","F",5,10,15
"19092","Nasteho","F",10,9,19
"19093","Nasya","F",29,15,44
"19094","Naszir","M",8,11,19
"19095","Natacha","F",6,6,12
"19096","Natalea","F",5,6,11
"19097","Nataleah","F",7,5,12
"19098","Natalee","F",280,236,516
"19099","Nataleigh","F",69,61,130
"19100","Nataley","F",25,25,50
"19101","Natali","F",60,64,124
"19102","Natalia","F",2692,2813,5505
"19103","Nataliah","F",20,24,44
"19104","Natalie","F",6490,6156,12646
"19105","Natalija","F",6,7,13
"19106","Natalina","F",25,19,44
"19107","Nataliya","F",32,34,66
"19108","Nataliyah","F",8,11,19
"19109","Natallie","F",12,17,29
"19110","Natally","F",6,8,14
"19111","Nataly","F",303,353,656
"19112","Natalya","F",225,225,450
"19113","Natalyah","F",11,11,22
"19114","Natalye","F",10,6,16
"19115","Natalyn","F",30,38,68
"19116","Natalynn","F",35,22,57
"19117","Natan","M",56,62,118
"19118","Natanael","M",62,51,113
"19119","Natania","F",24,25,49
"19120","Nataniel","M",24,17,41
"19121","Natanya","F",10,8,18
"19122","Natasha","F",425,387,812
"19123","Natasia","F",7,5,12
"19124","Nataya","F",13,5,18
"19125","Nate","M",93,91,184
"19126","Nathalee","F",6,8,14
"19127","Nathali","F",11,22,33
"19128","Nathalia","F",322,305,627
"19129","Nathalie","F",455,434,889
"19130","Nathaly","F",332,295,627
"19131","Nathalya","F",7,10,17
"19132","Nathan","F",8,6,14
"19133","Nathan","M",8565,7933,16498
"19134","Nathanael","M",477,423,900
"19135","Nathanel","M",10,5,15
"19136","Nathania","F",20,10,30
"19137","Nathanial","M",50,51,101
"19138","Nathaniel","M",4202,3850,8052
"19139","Nathanyel","M",8,6,14
"19140","Nathen","M",79,56,135
"19141","Nathnael","M",5,7,12
"19142","Nathon","M",8,10,18
"19143","Nathyn","M",8,8,16
"19144","Natia","F",13,8,21
"19145","Natilee","F",22,14,36
"19146","Natilynn","F",5,8,13
"19147","Nation","F",5,5,10
"19148","Nation","M",7,17,24
"19149","Natividad","F",6,9,15
"19150","Natnael","M",14,26,40
"19151","Natsumi","F",6,7,13
"19152","Nature","F",9,11,20
"19153","Naturi","F",7,9,16
"19154","Naudia","F",18,21,39
"19155","Nautica","F",18,22,40
"19156","Nava","F",70,64,134
"19157","Navaeh","F",60,64,124
"19158","Navah","F",10,11,21
"19159","Navarro","M",5,9,14
"19160","Navaya","F",18,22,40
"19161","Navayah","F",24,16,40
"19162","Naveah","F",73,78,151
"19163","Naveed","M",25,17,42
"19164","Naveen","F",17,16,33
"19165","Naveen","M",40,45,85
"19166","Naveena","F",7,8,15
"19167","Naven","M",5,9,14
"19168","Navey","F",7,5,12
"19169","Naveya","F",13,11,24
"19170","Naveyah","F",10,8,18
"19171","Navi","F",49,74,123
"19172","Navi","M",10,7,17
"19173","Navia","F",22,15,37
"19174","Naviah","F",6,8,14
"19175","Navid","M",23,23,46
"19176","Navie","F",16,16,32
"19177","Navier","M",6,7,13
"19178","Navika","F",9,8,17
"19179","Navin","M",22,19,41
"19180","Navina","F",10,6,16
"19181","Navira","F",5,5,10
"19182","Navon","M",8,6,14
"19183","Navraj","M",9,14,23
"19184","Navy","F",116,152,268
"19185","Navy","M",36,29,65
"19186","Navya","F",111,115,226
"19187","Naw","F",8,9,17
"19188","Nawaf","M",28,27,55
"19189","Nawal","F",47,41,88
"19190","Nay","M",9,6,15
"19191","Naya","F",358,329,687
"19192","Nayah","F",24,28,52
"19193","Nayan","M",27,29,56
"19194","Nayana","F",17,17,34
"19195","Nayara","F",22,19,41
"19196","Naydelin","F",30,39,69
"19197","Nayden","M",11,15,26
"19198","Nayef","M",6,10,16
"19199","Nayel","M",20,25,45
"19200","Nayela","F",6,9,15
"19201","Nayeli","F",691,670,1361
"19202","Nayelie","F",14,12,26
"19203","Nayelis","F",22,14,36
"19204","Nayeliz","F",14,8,22
"19205","Nayelli","F",33,49,82
"19206","Nayely","F",40,47,87
"19207","Nayla","F",158,151,309
"19208","Naylaa","F",8,6,14
"19209","Naylah","F",32,48,80
"19210","Naylani","F",23,31,54
"19211","Naylanie","F",6,5,11
"19212","Naylea","F",16,22,38
"19213","Naylee","F",6,6,12
"19214","Nayleen","F",17,18,35
"19215","Nayomi","F",57,59,116
"19216","Nayra","F",14,18,32
"19217","Naysa","F",22,30,52
"19218","Naysha","F",12,12,24
"19219","Nayson","M",6,5,11
"19220","Naythan","M",17,27,44
"19221","Nayvee","F",8,11,19
"19222","Nayvie","F",14,15,29
"19223","Nazaire","M",12,12,24
"19224","Nazanin","F",6,13,19
"19225","Nazar","M",25,34,59
"19226","Nazarene","F",6,9,15
"19227","Nazaret","F",9,7,16
"19228","Nazareth","F",36,64,100
"19229","Nazareth","M",38,41,79
"19230","Nazari","F",5,6,11
"19231","Nazaria","F",13,18,31
"19232","Nazariah","F",7,12,19
"19233","Nazario","M",12,21,33
"19234","Nazariy","M",6,5,11
"19235","Nazeer","M",6,12,18
"19236","Naziah","F",6,7,13
"19237","Nazier","M",21,14,35
"19238","Nazir","M",105,129,234
"19239","Naziyah","F",21,16,37
"19240","Nazli","F",10,13,23
"19241","Nazly","F",12,6,18
"19242","Nazyia","F",8,8,16
"19243","Ndeye","F",9,9,18
"19244","Nea","F",11,12,23
"19245","Neah","F",21,26,47
"19246","Neal","M",151,150,301
"19247","Neala","F",34,19,53
"19248","Neamiah","M",5,8,13
"19249","Neave","F",8,13,21
"19250","Neaveh","F",7,5,12
"19251","Nechama","F",118,110,228
"19252","Nechuma","F",7,5,12
"19253","Ned","M",17,10,27
"19254","Neda","F",21,19,40
"19255","Neeka","F",9,5,14
"19256","Neeko","M",15,10,25
"19257","Neel","M",95,98,193
"19258","Neela","F",59,27,86
"19259","Neelah","F",5,5,10
"19260","Neeley","F",7,6,13
"19261","Neelia","F",7,6,13
"19262","Neely","F",38,44,82
"19263","Neema","F",28,32,60
"19264","Neemah","F",5,5,10
"19265","Neena","F",24,28,52
"19266","Neer","M",5,9,14
"19267","Neera","F",9,6,15
"19268","Neeson","M",5,5,10
"19269","Neev","M",49,54,103
"19270","Neeva","F",13,13,26
"19271","Neeya","F",5,6,11
"19272","Nefertari","F",17,34,51
"19273","Nefertiti","F",11,17,28
"19274","Neftali","M",39,50,89
"19275","Neftaly","M",5,6,11
"19276","Neha","F",46,38,84
"19277","Nehan","M",11,13,24
"19278","Nehemiah","F",20,24,44
"19279","Nehemiah","M",906,918,1824
"19280","Nehemias","M",86,89,175
"19281","Nehemie","F",8,11,19
"19282","Nehemyah","M",7,10,17
"19283","Neidy","F",8,9,17
"19284","Neiko","M",18,25,43
"19285","Neil","M",413,422,835
"19286","Neila","F",25,25,50
"19287","Neilan","M",7,13,20
"19288","Neilani","F",13,12,25
"19289","Neily","F",5,8,13
"19290","Neima","F",5,9,14
"19291","Neimar","M",5,5,10
"19292","Neisha","F",7,8,15
"19293","Neithan","M",20,23,43
"19294","Neiva","F",8,6,14
"19295","Neizan","M",12,15,27
"19296","Nejla","F",14,9,23
"19297","Nekhi","M",6,6,12
"19298","Neko","F",11,13,24
"19299","Neko","M",30,30,60
"19300","Nekoda","F",5,6,11
"19301","Nekoda","M",14,11,25
"19302","Nel","F",10,6,16
"19303","Nela","F",19,15,34
"19304","Nelani","F",10,10,20
"19305","Neleh","F",5,7,12
"19306","Nelia","F",24,16,40
"19307","Neliah","F",5,5,10
"19308","Nelida","F",8,5,13
"19309","Nell","F",61,69,130
"19310","Nella","F",59,58,117
"19311","Nelle","F",17,17,34
"19312","Nelli","F",9,7,16
"19313","Nellie","F",197,200,397
"19314","Nelliel","F",5,8,13
"19315","Nelly","F",121,104,225
"19316","Nels","M",14,15,29
"19317","Nelson","M",423,426,849
"19318","Nely","F",6,11,17
"19319","Nelya","F",5,5,10
"19320","Nema","F",10,8,18
"19321","Nemesis","F",8,6,14
"19322","Nemo","M",5,6,11
"19323","Nena","F",12,20,32
"19324","Neo","M",80,98,178
"19325","Neoma","F",6,7,13
"19326","Neomi","F",21,22,43
"19327","Nephi","M",8,7,15
"19328","Nerea","F",11,7,18
"19329","Nereida","F",17,11,28
"19330","Nereyda","F",11,9,20
"19331","Neri","F",6,9,15
"19332","Neri","M",14,16,30
"19333","Neriah","F",287,185,472
"19334","Neriah","M",6,5,11
"19335","Nerissa","F",5,15,20
"19336","Neriyah","F",13,13,26
"19337","Nero","M",22,18,40
"19338","Nerriah","F",6,5,11
"19339","Nery","M",26,22,48
"19340","Nesanel","M",16,13,29
"19341","Ness","M",5,7,12
"19342","Nessa","F",48,82,130
"19343","Nessiah","M",8,13,21
"19344","Nestor","M",125,106,231
"19345","Netanel","M",23,20,43
"19346","Netanya","F",16,20,36
"19347","Nethra","F",15,17,32
"19348","Netta","F",8,6,14
"19349","Nettie","F",8,19,27
"19350","Neva","F",84,91,175
"19351","Nevaan","M",18,18,36
"19352","Nevada","F",26,24,50
"19353","Nevaeh","F",3979,3756,7735
"19354","Nevaeh","M",9,6,15
"19355","Nevaeha","F",36,25,61
"19356","Nevaen","F",6,8,14
"19357","Nevah","F",13,9,22
"19358","Nevan","M",36,32,68
"19359","Nevaya","F",25,13,38
"19360","Nevayah","F",22,24,46
"19361","Neve","F",65,59,124
"19362","Neveah","F",235,218,453
"19363","Neven","M",18,10,28
"19364","Nevena","F",5,7,12
"19365","Neveyah","F",9,7,16
"19366","Neviah","F",11,13,24
"19367","Neville","M",16,16,32
"19368","Nevin","M",67,60,127
"19369","Nevina","F",5,6,11
"19370","Newt","M",8,12,20
"19371","Newton","M",26,17,43
"19372","Neya","F",16,9,25
"19373","Neyah","F",7,13,20
"19374","Neyla","F",24,24,48
"19375","Neyland","M",34,41,75
"19376","Neymar","M",294,244,538
"19377","Neysa","F",9,12,21
"19378","Neythan","M",23,24,47
"19379","Neytiri","F",13,19,32
"19380","Nezar","M",5,5,10
"19381","Neziah","M",10,16,26
"19382","Ngun","F",7,9,16
"19383","Nguyen","M",10,6,16
"19384","Nhi","F",19,13,32
"19385","Nhyira","F",7,7,14
"19386","Nia","F",715,730,1445
"19387","Niah","F",69,74,143
"19388","Niala","F",8,15,23
"19389","Nialah","F",8,8,16
"19390","Niall","M",55,53,108
"19391","Niam","M",126,155,281
"19392","Niamh","F",35,45,80
"19393","Niamiah","F",6,6,12
"19394","Niana","F",5,8,13
"19395","Niang","F",18,24,42
"19396","Niani","F",6,6,12
"19397","Nianna","F",8,7,15
"19398","Niaomi","F",11,10,21
"19399","Niara","F",29,30,59
"19400","Niasia","F",10,7,17
"19401","Nicanor","M",6,8,14
"19402","Nicco","M",28,31,59
"19403","Niccolo","M",38,29,67
"19404","Nicha","F",5,5,10
"19405","Nichelle","F",19,16,35
"19406","Nicholai","M",38,33,71
"19407","Nicholas","M",6222,5716,11938
"19408","Nicholaus","M",8,14,22
"19409","Nichole","F",112,112,224
"19410","Nicholette","F",5,5,10
"19411","Nicholi","M",14,15,29
"19412","Nick","M",152,175,327
"19413","Nickan","M",7,8,15
"19414","Nickayla","F",6,7,13
"19415","Nicki","F",14,10,24
"19416","Nicklas","M",22,15,37
"19417","Nicklaus","M",17,35,52
"19418","Nickolai","M",31,24,55
"19419","Nickolas","M",336,294,630
"19420","Nickolaus","M",12,7,19
"19421","Nickole","F",9,14,23
"19422","Nickoli","M",15,11,26
"19423","Nickson","M",8,15,23
"19424","Nicky","F",11,12,23
"19425","Nicky","M",11,16,27
"19426","Nico","F",37,31,68
"19427","Nico","M",651,603,1254
"19428","Nicodemus","M",30,26,56
"19429","Nicol","F",21,16,37
"19430","Nicola","F",20,21,41
"19431","Nicola","M",30,20,50
"19432","Nicolaas","M",5,9,14
"19433","Nicolae","M",8,6,14
"19434","Nicolai","M",78,65,143
"19435","Nicolas","M",1989,2065,4054
"19436","Nicole","F",2108,1941,4049
"19437","Nicoletta","F",32,12,44
"19438","Nicolette","F",127,154,281
"19439","Nicoli","M",16,14,30
"19440","Nicolina","F",19,23,42
"19441","Nicolle","F",58,56,114
"19442","Nicolo","M",33,29,62
"19443","Nida","F",13,9,22
"19444","Nidhi","F",37,35,72
"19445","Nidia","F",10,16,26
"19446","Niels","M",18,21,39
"19447","Niema","F",10,9,19
"19448","Nieves","F",5,5,10
"19449","Nigel","M",173,144,317
"19450","Nigeria","F",8,6,14
"19451","Nihaal","M",17,10,27
"19452","Nihaan","M",5,8,13
"19453","Nihal","F",11,23,34
"19454","Nihal","M",41,38,79
"19455","Nihan","M",12,10,22
"19456","Nihar","M",13,6,19
"19457","Niharika","F",21,19,40
"19458","Nihira","F",45,40,85
"19459","Nijah","F",15,11,26
"19460","Nijah","M",6,10,16
"19461","Nika","F",68,66,134
"19462","Nikai","M",8,5,13
"19463","Nikan","M",11,10,21
"19464","Nikayla","F",24,15,39
"19465","Nike","F",5,6,11
"19466","Nikesh","M",8,8,16
"19467","Nikhil","M",124,92,216
"19468","Niki","F",20,26,46
"19469","Nikit","M",6,6,12
"19470","Nikita","F",93,70,163
"19471","Nikita","M",92,92,184
"19472","Nikka","F",6,5,11
"19473","Nikki","F",133,91,224
"19474","Nikkie","F",7,5,12
"19475","Nikko","M",154,142,296
"19476","Nikkolai","M",5,6,11
"19477","Nikkole","F",5,6,11
"19478","Niklas","M",24,25,49
"19479","Niklaus","M",100,117,217
"19480","Niko","F",11,13,24
"19481","Niko","M",420,434,854
"19482","Nikodem","M",7,14,21
"19483","Nikol","F",7,13,20
"19484","Nikola","F",16,17,33
"19485","Nikola","M",141,130,271
"19486","Nikolai","M",625,637,1262
"19487","Nikolaj","M",8,16,24
"19488","Nikolaos","M",42,48,90
"19489","Nikolas","M",495,494,989
"19490","Nikolaus","M",21,23,44
"19491","Nikolay","M",27,15,42
"19492","Nikole","F",40,57,97
"19493","Nikoleta","F",7,8,15
"19494","Nikoletta","F",11,14,25
"19495","Nikolette","F",7,5,12
"19496","Nikoli","M",32,31,63
"19497","Nikolina","F",18,14,32
"19498","Nikoloz","M",5,5,10
"19499","Nikos","M",22,20,42
"19500","Nil","F",10,10,20
"19501","Nila","F",117,105,222
"19502","Nilah","F",70,65,135
"19503","Nilan","M",11,21,32
"19504","Nilani","F",9,12,21
"19505","Nilay","M",6,7,13
"19506","Nile","F",16,13,29
"19507","Nile","M",55,81,136
"19508","Niles","M",49,54,103
"19509","Niley","F",11,6,17
"19510","Nili","F",7,8,15
"19511","Nilo","M",9,14,23
"19512","Nils","M",20,21,41
"19513","Nilson","M",11,14,25
"19514","Nima","F",14,12,26
"19515","Nima","M",7,10,17
"19516","Nimah","F",5,15,20
"19517","Nimai","M",8,8,16
"19518","Nimco","F",11,12,23
"19519","Nimisha","F",7,5,12
"19520","Nimo","F",12,11,23
"19521","Nimrat","F",14,21,35
"19522","Nimrit","F",6,8,14
"19523","Nina","F",1075,1041,2116
"19524","Ninamarie","F",8,5,13
"19525","Nineveh","F",8,5,13
"19526","Nino","F",5,5,10
"19527","Nino","M",41,40,81
"19528","Niomi","F",34,41,75
"19529","Nira","F",7,13,20
"19530","Niralya","F",10,5,15
"19531","Niranjan","M",10,9,19
"19532","Nirav","M",9,16,25
"19533","Nirvaan","M",34,26,60
"19534","Nirvan","M",24,31,55
"19535","Nirvana","F",74,84,158
"19536","Nirvi","F",24,13,37
"19537","Nisa","F",37,27,64
"19538","Nisha","F",13,17,30
"19539","Nishaan","M",6,5,11
"19540","Nishanth","M",7,8,15
"19541","Nishi","F",12,9,21
"19542","Nishika","F",10,14,24
"19543","Nishka","F",26,25,51
"19544","Nishtha","F",12,9,21
"19545","Nisreen","F",12,8,20
"19546","Nissa","F",11,15,26
"19547","Nissi","F",26,33,59
"19548","Nissim","M",8,13,21
"19549","Nita","F",13,12,25
"19550","Nitara","F",7,20,27
"19551","Nithila","F",8,11,19
"19552","Nithin","M",10,16,26
"19553","Nithya","F",45,43,88
"19554","Nitin","M",7,5,12
"19555","Nitya","F",34,37,71
"19556","Niva","F",21,23,44
"19557","Nivaan","M",60,58,118
"19558","Nivan","M",10,9,19
"19559","Nivea","F",38,34,72
"19560","Niveah","F",8,14,22
"19561","Nived","M",5,9,14
"19562","Nivedh","M",8,9,17
"19563","Nivek","M",6,8,14
"19564","Nivia","F",11,5,16
"19565","Nivin","M",13,20,33
"19566","Nix","M",5,7,12
"19567","Nixen","M",13,7,20
"19568","Nixie","F",25,17,42
"19569","Nixon","F",20,26,46
"19570","Nixon","M",559,566,1125
"19571","Nixson","M",6,5,11
"19572","Nixxon","M",11,7,18
"19573","Niya","F",120,111,231
"19574","Niyah","F",107,89,196
"19575","Niyam","M",14,15,29
"19576","Niyana","F",7,8,15
"19577","Niyanna","F",10,10,20
"19578","Niyati","F",6,18,24
"19579","Niyla","F",28,23,51
"19580","Niylah","F",37,40,77
"19581","Niyonna","F",5,7,12
"19582","Nizar","M",20,14,34
"19583","Nizhoni","F",26,22,48
"19584","Nnamdi","M",14,27,41
"19585","Nneka","F",5,5,10
"19586","Nneoma","F",7,6,13
"19587","Noa","F",368,389,757
"19588","Noa","M",63,68,131
"19589","Noach","M",22,19,41
"19590","Noah","F",137,131,268
"19591","Noah","M",19594,19015,38609
"19592","Noam","M",119,103,222
"19593","Noami","F",10,12,22
"19594","Noan","M",5,6,11
"19595","Nobel","M",11,9,20
"19596","Noble","F",11,15,26
"19597","Noble","M",145,140,285
"19598","Nochum","M",14,13,27
"19599","Noe","F",14,15,29
"19600","Noe","M",424,397,821
"19601","Noeh","M",7,10,17
"19602","Noel","F",208,202,410
"19603","Noel","M",860,844,1704
"19604","Noela","F",7,10,17
"19605","Noelani","F",78,87,165
"19606","Noeli","F",16,12,28
"19607","Noelia","F",136,161,297
"19608","Noelie","F",7,7,14
"19609","Noell","F",8,9,17
"19610","Noell","M",7,6,13
"19611","Noella","F",94,95,189
"19612","Noelle","F",1282,1260,2542
"19613","Noelle","M",8,7,15
"19614","Noellie","F",6,6,12
"19615","Noelly","F",7,9,16
"19616","Noely","F",18,16,34
"19617","Noemi","F",362,360,722
"19618","Noemie","F",27,20,47
"19619","Noemy","F",22,25,47
"19620","Noga","F",12,8,20
"19621","Noha","F",11,13,24
"19622","Nohea","F",11,18,29
"19623","Nohealani","F",8,14,22
"19624","Nohelia","F",9,5,14
"19625","Nohely","F",14,8,22
"19626","Nohemi","F",34,38,72
"19627","Nohemy","F",9,14,23
"19628","Nohlan","M",8,9,17
"19629","Nola","F",368,347,715
"19630","Nolah","F",17,15,32
"19631","Nolan","F",18,23,41
"19632","Nolan","M",5731,5615,11346
"19633","Noland","M",26,21,47
"19634","Nolawi","M",9,11,20
"19635","Nolberto","M",7,5,12
"19636","Nolen","M",88,91,179
"19637","Nolin","M",24,17,41
"19638","Nollie","F",9,5,14
"19639","Nolyn","F",14,13,27
"19640","Nolyn","M",36,34,70
"19641","Nolynn","F",7,7,14
"19642","Nomar","M",24,19,43
"19643","Nomi","F",15,17,32
"19644","Nona","F",25,36,61
"19645","Noni","F",13,18,31
"19646","Nooh","M",10,7,17
"19647","Noor","F",272,306,578
"19648","Noor","M",41,33,74
"19649","Noora","F",44,43,87
"19650","Nora","F",5314,5561,10875
"19651","Noraa","F",14,14,28
"19652","Norah","F",2026,2016,4042
"19653","Noralee","F",9,13,22
"19654","Noralyn","F",7,6,13
"19655","Noralynn","F",5,5,10
"19656","Norbert","M",9,5,14
"19657","Norberto","M",28,26,54
"19658","Nore","M",5,5,10
"19659","Noreen","F",25,22,47
"19660","Norelle","F",9,6,15
"19661","Nori","F",134,168,302
"19662","Nori","M",9,13,22
"19663","Noria","F",6,5,11
"19664","Noriah","F",23,22,45
"19665","Noriana","F",6,5,11
"19666","Norie","F",21,16,37
"19667","Norielle","F",14,6,20
"19668","Norlan","M",8,8,16
"19669","Norma","F",77,86,163
"19670","Normajean","F",6,7,13
"19671","Norman","M",146,180,326
"19672","Norrin","M",13,15,28
"19673","Norris","M",21,17,38
"19674","North","M",10,11,21
"19675","Nosson","M",34,34,68
"19676","Nouman","M",5,7,12
"19677","Nour","F",97,87,184
"19678","Nour","M",22,13,35
"19679","Noura","F",39,47,86
"19680","Nova","F",1518,2272,3790
"19681","Nova","M",129,150,279
"19682","Novah","F",110,148,258
"19683","Novah","M",25,32,57
"19684","Novak","M",18,28,46
"19685","Novalea","F",6,9,15
"19686","Novalee","F",218,286,504
"19687","Novalei","F",8,14,22
"19688","Novaleigh","F",55,71,126
"19689","Novali","F",7,10,17
"19690","Novalie","F",20,28,48
"19691","Novaly","F",5,7,12
"19692","Novalyn","F",7,20,27
"19693","Novalynn","F",24,33,57
"19694","Novella","F",35,39,74
"19695","November","F",27,49,76
"19696","Novi","F",10,16,26
"19697","Novia","F",15,12,27
"19698","Nox","M",15,13,28
"19699","Noya","F",15,20,35
"19700","Nuala","F",9,11,20
"19701","Nubia","F",44,45,89
"19702","Nuchem","M",12,10,22
"19703","Nuh","M",20,18,38
"19704","Nuha","F",26,19,45
"19705","Nunzio","M",5,9,14
"19706","Nur","F",12,19,31
"19707","Nur","M",13,12,25
"19708","Nura","F",30,35,65
"19709","Nuri","F",20,29,49
"19710","Nuri","M",18,19,37
"19711","Nuria","F",21,17,38
"19712","Nuriyah","F",16,6,22
"19713","Nusaiba","F",13,9,22
"19714","Nusaibah","F",5,6,11
"19715","Nusayba","F",9,12,21
"19716","Nusaybah","F",19,27,46
"19717","Nusrat","F",9,14,23
"19718","Nussen","M",6,6,12
"19719","Nuvia","F",15,12,27
"19720","Nya","F",188,133,321
"19721","Nyah","F",169,144,313
"19722","Nyaire","M",5,9,14
"19723","Nyala","F",16,13,29
"19724","Nyan","M",6,6,12
"19725","Nyana","F",10,11,21
"19726","Nyanna","F",15,18,33
"19727","Nyara","F",7,8,15
"19728","Nyarai","F",11,7,18
"19729","Nyari","F",10,18,28
"19730","Nyarie","F",5,7,12
"19731","Nyasia","F",88,70,158
"19732","Nycere","M",7,7,14
"19733","Nydia","F",17,21,38
"19734","Nyeem","M",9,10,19
"19735","Nyeema","F",13,6,19
"19736","Nyel","M",5,5,10
"19737","Nyela","F",7,9,16
"19738","Nyelah","F",6,7,13
"19739","Nyeli","F",7,13,20
"19740","Nyella","F",11,6,17
"19741","Nyelle","F",24,30,54
"19742","Nyelli","F",11,15,26
"19743","Nyellie","F",7,14,21
"19744","Nyema","F",10,18,28
"19745","Nyemah","F",8,10,18
"19746","Nyemiah","F",15,5,20
"19747","Nygel","M",7,10,17
"19748","Nyhla","F",8,5,13
"19749","Nyia","F",10,6,16
"19750","Nyiah","F",14,6,20
"19751","Nyima","F",12,12,24
"19752","Nyimah","F",7,7,14
"19753","Nyjah","F",16,6,22
"19754","Nyjah","M",55,41,96
"19755","Nykia","F",5,8,13
"19756","Nyko","M",8,10,18
"19757","Nyla","F",1000,993,1993
"19758","Nylah","F",720,795,1515
"19759","Nylan","F",8,9,17
"19760","Nylan","M",24,26,50
"19761","Nylani","F",6,11,17
"19762","Nyle","M",48,96,144
"19763","Nyleah","F",21,14,35
"19764","Nylee","F",16,14,30
"19765","Nylen","M",6,13,19
"19766","Nyles","M",26,26,52
"19767","Nylia","F",11,9,20
"19768","Nyliah","F",20,10,30
"19769","Nyliyah","F",7,8,15
"19770","Nymir","M",8,9,17
"19771","Nyna","F",8,10,18
"19772","Nyomi","F",187,160,347
"19773","Nyomie","F",7,6,13
"19774","Nyonna","F",5,6,11
"19775","Nyota","F",5,6,11
"19776","Nyra","F",31,41,72
"19777","Nyrah","F",5,7,12
"19778","Nyree","F",23,8,31
"19779","Nyrie","F",7,10,17
"19780","Nysa","F",23,29,52
"19781","Nysha","F",17,12,29
"19782","Nysir","M",12,11,23
"19783","Nyssa","F",24,40,64
"19784","Nyx","F",16,12,28
"19785","Nyxon","M",6,8,14
"19786","Nyzaiah","M",10,5,15
"19787","Nyzir","M",21,11,32
"19788","Nzinga","F",7,5,12
"19789","Oak","M",25,40,65
"19790","Oaken","M",9,11,20
"19791","Oakes","M",12,16,28
"19792","Oaklan","M",7,10,17
"19793","Oakland","F",5,7,12
"19794","Oakland","M",36,46,82
"19795","Oaklea","F",5,6,11
"19796","Oaklee","F",157,207,364
"19797","Oaklee","M",49,50,99
"19798","Oaklei","F",8,8,16
"19799","Oakleigh","F",114,143,257
"19800","Oaklen","M",20,33,53
"19801","Oakley","F",471,531,1002
"19802","Oakley","M",494,478,972
"19803","Oaklie","F",58,33,91
"19804","Oaklyn","F",55,161,216
"19805","Oaklyn","M",9,13,22
"19806","Oaklynn","F",57,102,159
"19807","Oaks","M",10,6,16
"19808","Oasis","F",9,9,18
"19809","Obadiah","M",92,106,198
"19810","Obaloluwa","M",12,14,26
"19811","Obed","M",88,96,184
"19812","Oberon","M",11,14,25
"19813","Oberyn","M",14,8,22
"19814","Obi","M",10,7,17
"19815","Obie","M",15,13,28
"19816","Obinna","M",17,18,35
"19817","Obrian","M",7,14,21
"19818","Ocean","F",65,82,147
"19819","Ocean","M",81,102,183
"19820","Oceana","F",23,28,51
"19821","Oceane","F",9,10,19
"19822","Oceanna","F",10,8,18
"19823","Ociel","M",13,8,21
"19824","Octavia","F",174,255,429
"19825","Octavian","M",31,56,87
"19826","Octavio","M",186,148,334
"19827","Octavious","M",30,25,55
"19828","Octavius","M",57,51,108
"19829","October","F",41,56,97
"19830","Odalis","F",26,11,37
"19831","Odalys","F",38,51,89
"19832","Oday","M",8,10,18
"19833","Odelia","F",30,34,64
"19834","Odell","M",21,30,51
"19835","Oden","M",72,88,160
"19836","Odessa","F",75,76,151
"19837","Odette","F",86,78,164
"19838","Odie","M",5,7,12
"19839","Odin","M",688,831,1519
"19840","Odinn","M",14,11,25
"19841","Odis","M",9,6,15
"19842","Odyn","M",23,27,50
"19843","Odysseus","M",23,26,49
"19844","Odyssey","F",31,19,50
"19845","Ofelia","F",58,69,127
"19846","Ogden","M",8,7,15
"19847","Ogechi","F",6,6,12
"19848","Ogheneruno","M",5,6,11
"19849","Ohana","F",13,30,43
"19850","Oisin","M",16,20,36
"19851","Ojas","M",19,21,40
"19852","Okalani","F",5,6,11
"19853","Oksana","F",17,11,28
"19854","Oktober","F",7,7,14
"19855","Ola","F",17,19,36
"19856","Olaf","M",18,10,28
"19857","Olajuwon","M",8,9,17
"19858","Olamide","F",11,14,25
"19859","Olamide","M",21,19,40
"19860","Olamiposi","F",6,6,12
"19861","Olan","M",25,20,45
"19862","Olana","F",8,6,14
"19863","Olanna","F",13,11,24
"19864","Olanrewaju","M",6,6,12
"19865","Olaoluwa","M",18,17,35
"19866","Ole","M",18,21,39
"19867","Oleg","M",16,13,29
"19868","Oleksiy","M",5,5,10
"19869","Olen","M",33,52,85
"19870","Olena","F",22,13,35
"19871","Olesya","F",6,6,12
"19872","Olga","F",59,46,105
"19873","Oli","M",9,10,19
"19874","Oliana","F",9,9,18
"19875","Olin","M",107,93,200
"19876","Olina","F",11,15,26
"19877","Oliva","F",28,26,54
"19878","Olive","F",1205,1155,2360
"19879","Olivea","F",19,11,30
"19880","Oliver","F",20,18,38
"19881","Oliver","M",11635,12975,24610
"19882","Oliverio","M",6,7,13
"19883","Olivia","F",19638,19246,38884
"19884","Olivia","M",8,15,23
"19885","Oliviagrace","F",14,17,31
"19886","Oliviah","F",41,39,80
"19887","Oliviana","F",26,27,53
"19888","Olivianna","F",19,21,40
"19889","Oliviarose","F",13,17,30
"19890","Olivier","M",77,71,148
"19891","Olivine","F",5,10,15
"19892","Oliviya","F",5,5,10
"19893","Oliviyah","F",10,5,15
"19894","Olivya","F",10,12,22
"19895","Oliwia","F",11,9,20
"19896","Olli","M",7,5,12
"19897","Ollie","F",56,66,122
"19898","Ollie","M",122,101,223
"19899","Ollin","M",9,13,22
"19900","Ollivander","M",7,8,15
"19901","Olliver","M",44,23,67
"19902","Olly","M",7,13,20
"19903","Olman","M",5,5,10
"19904","Olsen","M",22,20,42
"19905","Olson","M",12,16,28
"19906","Oluchi","F",7,8,15
"19907","Olufemi","M",7,6,13
"19908","Olujimi","M",6,7,13
"19909","Olumide","M",11,6,17
"19910","Oluwadamilare","M",14,13,27
"19911","Oluwadamilola","F",12,14,26
"19912","Oluwadamilola","M",13,13,26
"19913","Oluwadara","F",5,5,10
"19914","Oluwadarasimi","F",33,48,81
"19915","Oluwadarasimi","M",20,17,37
"19916","Oluwademilade","F",6,11,17
"19917","Oluwademilade","M",18,21,39
"19918","Oluwadunmininu","F",5,5,10
"19919","Oluwafemi","M",7,10,17
"19920","Oluwaferanmi","M",14,10,24
"19921","Oluwafikayomi","F",5,9,14
"19922","Oluwajomiloju","M",10,12,22
"19923","Oluwanifemi","F",14,21,35
"19924","Oluwanifemi","M",12,13,25
"19925","Oluwapelumi","M",5,5,10
"19926","Oluwasemilore","F",9,14,23
"19927","Oluwasemilore","M",15,15,30
"19928","Oluwaseun","F",5,5,10
"19929","Oluwaseun","M",7,14,21
"19930","Oluwaseyi","M",9,14,23
"19931","Oluwatamilore","F",19,18,37
"19932","Oluwatamilore","M",9,7,16
"19933","Oluwatimilehin","M",15,7,22
"19934","Oluwatimileyin","M",9,7,16
"19935","Oluwatobi","M",19,20,39
"19936","Oluwatobiloba","M",14,20,34
"19937","Oluwatofunmi","F",7,10,17
"19938","Oluwatomi","M",8,7,15
"19939","Oluwatomisin","F",13,7,20
"19940","Oluwatomisin","M",6,9,15
"19941","Oluwatoni","F",8,13,21
"19942","Olvin","M",11,16,27
"19943","Olympia","F",39,51,90
"19944","Olyver","M",15,30,45
"19945","Olyvia","F",92,79,171
"19946","Om","M",87,86,173
"19947","Omair","M",8,5,13
"19948","Omar","M",1834,1730,3564
"19949","Omaree","M",7,7,14
"19950","Omari","F",15,12,27
"19951","Omari","M",564,550,1114
"19952","Omaria","F",7,7,14
"19953","Omarian","M",9,13,22
"19954","Omarie","M",7,8,15
"19955","Omarii","M",10,11,21
"19956","Omarion","M",84,57,141
"19957","Omega","F",5,9,14
"19958","Omega","M",33,31,64
"19959","Omeir","M",6,6,12
"19960","Omer","M",75,82,157
"19961","Omera","F",6,7,13
"19962","Omere","M",32,29,61
"19963","Omid","M",13,17,30
"19964","Omir","M",16,13,29
"19965","Omkar","M",7,10,17
"19966","Omni","F",9,9,18
"19967","Omnia","F",7,8,15
"19968","Omran","M",7,17,24
"19969","Omri","M",27,31,58
"19970","Ona","F",39,35,74
"19971","Onalee","F",16,26,42
"19972","Ondine","F",13,13,26
"19973","Oneal","M",9,9,18
"19974","Oneida","F",11,6,17
"19975","Oneil","M",9,14,23
"19976","Onesimo","M",7,5,12
"19977","Onesti","F",5,7,12
"19978","Onesty","F",5,12,17
"19979","Oni","F",9,9,18
"19980","Onika","F",11,17,28
"19981","Onix","M",6,13,19
"19982","Oniyah","F",5,8,13
"19983","Onna","F",33,19,52
"19984","Onora","F",11,11,22
"19985","Onur","M",10,12,22
"19986","Onyinyechi","F",12,7,19
"19987","Onyinyechukwu","F",5,7,12
"19988","Onyx","F",38,56,94
"19989","Onyx","M",118,172,290
"19990","Oona","F",130,109,239
"19991","Oonagh","F",6,6,12
"19992","Opal","F",231,256,487
"19993","Ophelia","F",276,529,805
"19994","Opie","M",14,29,43
"19995","Ora","F",35,35,70
"19996","Ora","M",5,5,10
"19997","Oralia","F",7,11,18
"19998","Oran","M",22,23,45
"19999","Orchid","F",11,8,19
"20000","Orel","M",7,6,13
"20001","Oren","F",7,6,13
"20002","Oren","M",128,119,247
"20003","Oreoluwa","F",17,24,41
"20004","Oreoluwa","M",9,12,21
"20005","Orhan","M",10,9,19
"20006","Ori","F",8,14,22
"20007","Ori","M",50,51,101
"20008","Oria","F",7,6,13
"20009","Oriah","F",20,12,32
"20010","Orian","M",18,18,36
"20011","Oriana","F",103,120,223
"20012","Orianna","F",47,52,99
"20013","Orie","M",7,5,12
"20014","Oriel","M",10,7,17
"20015","Orien","M",7,9,16
"20016","Orin","M",79,85,164
"20017","Orion","F",22,33,55
"20018","Orion","M",870,1059,1929
"20019","Oriya","F",7,5,12
"20020","Oriyah","F",13,17,30
"20021","Orla","F",30,30,60
"20022","Orlando","M",436,430,866
"20023","Orli","F",16,20,36
"20024","Orlin","M",18,19,37
"20025","Orly","F",24,32,56
"20026","Ornella","F",9,6,15
"20027","Orren","M",8,5,13
"20028","Orrin","M",83,52,135
"20029","Orry","M",6,5,11
"20030","Orson","M",66,90,156
"20031","Orville","M",12,13,25
"20032","Oryan","M",45,32,77
"20033","Osama","M",14,13,27
"20034","Osbaldo","M",30,17,47
"20035","Osborn","M",12,16,28
"20036","Osborne","M",10,9,19
"20037","Oscar","M",2291,2251,4542
"20038","Oseas","M",18,16,34
"20039","Oshae","M",5,8,13
"20040","Oshay","M",7,8,15
"20041","Oshea","M",45,64,109
"20042","Oshen","M",7,5,12
"20043","Osiah","M",10,15,25
"20044","Osias","M",35,37,72
"20045","Osiel","M",67,67,134
"20046","Osinachi","M",7,17,24
"20047","Osiris","F",11,18,29
"20048","Osiris","M",100,131,231
"20049","Osirus","M",6,7,13
"20050","Oskar","M",110,159,269
"20051","Oslo","M",16,12,28
"20052","Osman","M",99,86,185
"20053","Osmany","M",7,6,13
"20054","Osmar","M",70,72,142
"20055","Osmara","F",7,7,14
"20056","Osmin","M",14,13,27
"20057","Osmond","M",11,14,25
"20058","Osric","M",10,5,15
"20059","Ostin","M",19,21,40
"20060","Osvaldo","M",207,187,394
"20061","Oswald","M",26,35,61
"20062","Oswaldo","M",64,57,121
"20063","Oswin","F",11,13,24
"20064","Oswin","M",15,19,34
"20065","Otavio","M",7,6,13
"20066","Othello","M",6,10,16
"20067","Othman","M",12,19,31
"20068","Othniel","M",31,27,58
"20069","Otilia","F",6,9,15
"20070","Otis","M",266,321,587
"20071","Otoniel","M",24,20,44
"20072","Ottilia","F",6,8,14
"20073","Ottilie","F",12,15,27
"20074","Otto","M",524,556,1080
"20075","Oumar","M",21,24,45
"20076","Oumou","F",32,31,63
"20077","Ousman","M",7,26,33
"20078","Ousmane","M",28,32,60
"20079","Ovadia","M",9,9,18
"20080","Ovi","F",12,6,18
"20081","Ovidio","M",7,6,13
"20082","Oviya","F",6,7,13
"20083","Owain","M",8,8,16
"20084","Owais","M",13,18,31
"20085","Owen","F",18,26,44
"20086","Owen","M",9583,10249,19832
"20087","Owenn","M",7,10,17
"20088","Owin","M",6,10,16
"20089","Owyn","F",6,5,11
"20090","Owyn","M",47,46,93
"20091","Owynn","F",11,8,19
"20092","Owynn","M",9,14,23
"20093","Oxford","M",9,7,16
"20094","Oxley","M",12,13,25
"20095","Oyindamola","F",10,6,16
"20096","Oyinkansola","F",6,10,16
"20097","Oz","M",24,27,51
"20098","Ozan","M",9,13,22
"20099","Oziah","M",20,23,43
"20100","Ozias","M",52,72,124
"20101","Oziel","M",74,75,149
"20102","Ozil","M",13,11,24
"20103","Ozioma","F",7,5,12
"20104","Ozzie","F",6,6,12
"20105","Ozzie","M",56,46,102
"20106","Ozzy","M",71,60,131
"20107","Paarth","M",9,9,18
"20108","Pablo","M",800,787,1587
"20109","Pace","F",6,5,11
"20110","Pace","M",42,36,78
"20111","Pacey","F",15,21,36
"20112","Pacey","M",16,20,36
"20113","Paco","M",9,7,16
"20114","Paden","F",8,6,14
"20115","Paden","M",24,27,51
"20116","Padme","F",7,16,23
"20117","Padraic","M",9,9,18
"20118","Padraig","M",28,28,56
"20119","Paelynn","F",6,5,11
"20120","Paeton","F",15,12,27
"20121","Paetyn","F",62,45,107
"20122","Page","F",17,20,37
"20123","Paiden","F",12,6,18
"20124","Paiden","M",17,7,24
"20125","Paidyn","F",7,10,17
"20126","Paige","F",2287,2041,4328
"20127","Paighton","F",19,26,45
"20128","Paije","F",6,9,15
"20129","Pailyn","F",10,7,17
"20130","Pailynn","F",13,13,26
"20131","Paisely","F",13,6,19
"20132","Paislea","F",11,9,20
"20133","Paislee","F",1009,1130,2139
"20134","Paislei","F",13,10,23
"20135","Paisleigh","F",241,206,447
"20136","Paisley","F",5069,4839,9908
"20137","Paisleyann","F",6,6,12
"20138","Paisli","F",9,7,16
"20139","Paislie","F",51,37,88
"20140","Paisly","F",16,7,23
"20141","Paislyn","F",16,17,33
"20142","Paislynn","F",19,34,53
"20143","Paisyn","F",18,16,34
"20144","Paiten","F",7,12,19
"20145","Paitlyn","F",5,12,17
"20146","Paiton","F",19,23,42
"20147","Paiton","M",7,5,12
"20148","Paityn","F",337,317,654
"20149","Paitynn","F",19,17,36
"20150","Paizlee","F",101,93,194
"20151","Paizleigh","F",19,18,37
"20152","Paizley","F",115,110,225
"20153","Paizlie","F",8,5,13
"20154","Palin","F",5,5,10
"20155","Pallas","F",11,6,17
"20156","Pallavi","F",6,6,12
"20157","Palmer","F",176,241,417
"20158","Palmer","M",137,133,270
"20159","Paloma","F",304,287,591
"20160","Palyn","F",5,10,15
"20161","Pamela","F",166,182,348
"20162","Panagiota","F",5,7,12
"20163","Panagiotis","M",18,22,40
"20164","Panav","M",7,7,14
"20165","Panayiotis","M",7,7,14
"20166","Pandora","F",55,43,98
"20167","Panth","M",6,5,11
"20168","Paola","F",383,336,719
"20169","Paolo","M",57,61,118
"20170","Papa","M",11,12,23
"20171","Paradise","F",29,35,64
"20172","Param","M",17,16,33
"20173","Pari","F",30,36,66
"20174","Paris","F",1212,1152,2364
"20175","Paris","M",84,80,164
"20176","Parisa","F",31,24,55
"20177","Parish","F",6,9,15
"20178","Parish","M",13,17,30
"20179","Pariss","F",7,5,12
"20180","Park","M",13,9,22
"20181","Parker","F",1442,1470,2912
"20182","Parker","M",5400,4685,10085
"20183","Parks","M",42,39,81
"20184","Parley","M",8,13,21
"20185","Parneet","F",10,6,16
"20186","Parnika","F",22,30,52
"20187","Parris","F",24,26,50
"20188","Parris","M",9,14,23
"20189","Parrish","M",19,21,40
"20190","Parsa","M",23,28,51
"20191","Parson","M",7,7,14
"20192","Parth","M",63,44,107
"20193","Parthenia","F",10,9,19
"20194","Parthiv","M",8,10,18
"20195","Parv","M",12,8,20
"20196","Parx","M",6,6,12
"20197","Parys","F",12,9,21
"20198","Pascal","M",34,35,69
"20199","Pascale","F",13,11,24
"20200","Pascual","M",27,27,54
"20201","Pasha","M",12,10,22
"20202","Pasleigh","F",5,6,11
"20203","Pasquale","M",18,21,39
"20204","Passion","F",37,43,80
"20205","Pate","M",8,11,19
"20206","Patience","F",241,203,444
"20207","Patrice","F",22,20,42
"20208","Patricia","F",347,380,727
"20209","Patricio","M",95,85,180
"20210","Patrick","M",2525,2344,4869
"20211","Patrik","M",15,7,22
"20212","Patryk","M",19,15,34
"20213","Patsy","F",16,16,32
"20214","Patterson","M",16,6,22
"20215","Patti","F",6,5,11
"20216","Patton","F",7,6,13
"20217","Patton","M",70,67,137
"20218","Patty","F",7,7,14
"20219","Pau","M",27,24,51
"20220","Paul","M",2020,1921,3941
"20221","Paula","F",310,346,656
"20222","Paulette","F",95,78,173
"20223","Paulina","F",314,367,681
"20224","Pauline","F",77,61,138
"20225","Paulino","M",14,21,35
"20226","Paulo","M",67,63,130
"20227","Pavan","M",8,6,14
"20228","Pavel","M",34,40,74
"20229","Pavle","M",11,14,25
"20230","Pavlos","M",7,5,12
"20231","Paw","F",17,26,43
"20232","Pax","F",7,11,18
"20233","Pax","M",63,73,136
"20234","Paxon","M",28,22,50
"20235","Paxson","M",33,34,67
"20236","Paxten","M",22,18,40
"20237","Paxtin","M",7,6,13
"20238","Paxton","F",69,91,160
"20239","Paxton","M",1670,1976,3646
"20240","Paxtyn","F",30,39,69
"20241","Paxtyn","M",34,39,73
"20242","Payden","F",28,21,49
"20243","Payden","M",39,27,66
"20244","Payeton","F",6,5,11
"20245","Payge","F",23,13,36
"20246","Paylin","F",10,7,17
"20247","Payne","M",17,14,31
"20248","Paysen","F",13,12,25
"20249","Paysen","M",9,10,19
"20250","Payslee","F",48,35,83
"20251","Paysley","F",15,11,26
"20252","Payslie","F",19,14,33
"20253","Payson","F",68,53,121
"20254","Payson","M",78,70,148
"20255","Paytan","F",6,6,12
"20256","Payten","F",118,93,211
"20257","Payten","M",9,11,20
"20258","Paytin","F",19,23,42
"20259","Payton","F",2106,1793,3899
"20260","Payton","M",362,280,642
"20261","Paytyn","F",19,17,36
"20262","Payzlee","F",24,18,42
"20263","Payzleigh","F",6,7,13
"20264","Payzley","F",5,8,13
"20265","Payzlie","F",10,8,18
"20266","Paz","F",14,18,32
"20267","Peace","F",19,19,38
"20268","Peace","M",7,20,27
"20269","Pearce","M",36,31,67
"20270","Pearl","F",458,546,1004
"20271","Pearla","F",13,13,26
"20272","Pearse","M",8,13,21
"20273","Pearson","F",7,6,13
"20274","Pearson","M",49,51,100
"20275","Pedro","M",873,874,1747
"20276","Peggy","F",13,19,32
"20277","Peighton","F",140,140,280
"20278","Peighton","M",7,8,15
"20279","Peightyn","F",15,13,28
"20280","Pema","F",13,11,24
"20281","Pemberley","F",9,7,16
"20282","Penellope","F",6,10,16
"20283","Penelope","F",5936,6367,12303
"20284","Penelope","M",5,9,14
"20285","Penelopi","F",10,7,17
"20286","Penelopy","F",7,10,17
"20287","Peniel","F",10,10,20
"20288","Peniel","M",6,11,17
"20289","Penina","F",18,20,38
"20290","Penley","F",9,6,15
"20291","Penn","M",55,63,118
"20292","Pennelope","F",14,15,29
"20293","Penni","F",5,8,13
"20294","Pennie","F",16,11,27
"20295","Penny","F",372,416,788
"20296","Pennylane","F",7,5,12
"20297","Peony","F",5,7,12
"20298","Pepper","F",149,136,285
"20299","Percival","M",16,12,28
"20300","Percy","M",58,46,104
"20301","Peregrine","F",8,6,14
"20302","Peregrine","M",15,16,31
"20303","Perel","F",30,26,56
"20304","Peretz","M",14,15,29
"20305","Perez","M",6,7,13
"20306","Peri","F",40,36,76
"20307","Perl","F",19,31,50
"20308","Perla","F",442,407,849
"20309","Pernell","M",5,8,13
"20310","Perpetua","F",14,8,22
"20311","Perri","F",44,46,90
"20312","Perrie","F",14,16,30
"20313","Perrin","F",18,17,35
"20314","Perrin","M",44,42,86
"20315","Perry","F",87,87,174
"20316","Perry","M",139,120,259
"20317","Persephanie","F",10,13,23
"20318","Persephone","F",176,194,370
"20319","Persephonie","F",11,8,19
"20320","Perseus","M",51,63,114
"20321","Persia","F",23,21,44
"20322","Pessel","F",7,10,17
"20323","Pessy","F",46,34,80
"20324","Petal","F",6,5,11
"20325","Petar","M",17,13,30
"20326","Pete","M",62,49,111
"20327","Peter","M",1927,1904,3831
"20328","Peterson","M",10,12,22
"20329","Petra","F",176,156,332
"20330","Petrona","F",12,13,25
"20331","Petros","M",18,7,25
"20332","Peyson","F",14,10,24
"20333","Peyson","M",12,8,20
"20334","Peytan","F",10,6,16
"20335","Peyten","F",15,19,34
"20336","Peyten","M",5,6,11
"20337","Peytin","F",10,7,17
"20338","Peyton","F",3895,3482,7377
"20339","Peyton","M",1376,1237,2613
"20340","Peytyn","F",13,7,20
"20341","Phaedra","F",35,30,65
"20342","Phaith","F",8,8,16
"20343","Pharaoh","M",117,138,255
"20344","Pharell","M",7,6,13
"20345","Pharoah","M",21,20,41
"20346","Pharrah","F",16,15,31
"20347","Pharrell","M",14,14,28
"20348","Phebe","F",29,32,61
"20349","Phelan","M",11,6,17
"20350","Phelix","M",6,7,13
"20351","Phenix","F",13,14,27
"20352","Phenix","M",24,23,47
"20353","Phenyx","F",5,6,11
"20354","Pheobe","F",22,9,31
"20355","Pheonix","F",13,11,24
"20356","Pheonix","M",13,11,24
"20357","Phil","M",17,15,32
"20358","Philemon","M",15,16,31
"20359","Philip","M",704,709,1413
"20360","Philipp","M",7,15,22
"20361","Philippa","F",61,74,135
"20362","Philippe","M",21,15,36
"20363","Phillip","M",758,701,1459
"20364","Philo","M",6,11,17
"20365","Philomena","F",78,92,170
"20366","Philopateer","M",11,14,25
"20367","Phineas","M",94,139,233
"20368","Phinehas","M",29,25,54
"20369","Phinley","F",14,12,26
"20370","Phoebe","F",1115,1021,2136
"20371","Phoenix","F",693,719,1412
"20372","Phoenix","M",1157,1226,2383
"20373","Phoenyx","F",34,31,65
"20374","Phoenyx","M",17,22,39
"20375","Phong","M",6,8,14
"20376","Phyllis","F",22,21,43
"20377","Phynix","F",8,6,14
"20378","Pia","F",73,105,178
"20379","Pieper","F",11,9,20
"20380","Pier","M",5,5,10
"20381","Pierce","F",20,14,34
"20382","Pierce","M",648,641,1289
"20383","Piercen","M",14,7,21
"20384","Piero","M",23,12,35
"20385","Pierre","M",169,172,341
"20386","Piers","M",11,7,18
"20387","Pierson","M",134,143,277
"20388","Pietra","F",14,12,26
"20389","Pietro","M",38,37,75
"20390","Pihu","F",19,18,37
"20391","Pike","M",11,9,20
"20392","Pilar","F",50,43,93
"20393","Pilot","M",15,7,22
"20394","Pinchas","M",33,31,64
"20395","Pinches","M",5,6,11
"20396","Pinchos","M",9,20,29
"20397","Pinchus","M",23,20,43
"20398","Pio","M",5,6,11
"20399","Piotr","M",10,5,15
"20400","Piper","F",4122,3926,8048
"20401","Piper","M",14,12,26
"20402","Pippa","F",92,101,193
"20403","Pippin","F",5,7,12
"20404","Pius","M",9,5,14
"20405","Pixie","F",13,9,22
"20406","Platon","M",7,12,19
"20407","Poe","M",9,7,16
"20408","Poet","F",11,9,20
"20409","Poet","M",8,9,17
"20410","Poetry","F",9,10,19
"20411","Pol","M",5,5,10
"20412","Pola","F",10,15,25
"20413","Polina","F",67,73,140
"20414","Polly","F",51,51,102
"20415","Pollyanna","F",12,8,20
"20416","Polo","M",8,11,19
"20417","Pooja","F",5,8,13
"20418","Poppy","F",259,379,638
"20419","Porfirio","M",13,17,30
"20420","Porsha","F",13,15,28
"20421","Porter","F",59,56,115
"20422","Porter","M",859,739,1598
"20423","Portia","F",42,29,71
"20424","Portland","F",5,7,12
"20425","Portland","M",5,7,12
"20426","Portlyn","F",7,6,13
"20427","Poseidon","M",21,27,48
"20428","Posey","F",41,36,77
"20429","Posie","F",7,12,19
"20430","Posy","F",11,10,21
"20431","Powell","M",7,11,18
"20432","Power","M",6,5,11
"20433","Poyraz","M",9,5,14
"20434","Prabhav","M",6,5,11
"20435","Prabhjot","M",5,6,11
"20436","Prachi","F",8,10,18
"20437","Pragathi","F",6,7,13
"20438","Pragna","F",6,6,12
"20439","Pragya","F",12,13,25
"20440","Prairie","F",6,16,22
"20441","Praise","F",31,43,74
"20442","Praise","M",27,20,47
"20443","Prajna","F",10,8,18
"20444","Prakriti","F",9,11,20
"20445","Pranathi","F",6,7,13
"20446","Pranav","M",133,139,272
"20447","Pranavi","F",27,24,51
"20448","Pranay","M",20,17,37
"20449","Praneel","M",8,18,26
"20450","Pranesh","M",7,9,16
"20451","Pranika","F",8,10,18
"20452","Pranish","M",6,10,16
"20453","Pranisha","F",7,11,18
"20454","Pranshi","F",10,7,17
"20455","Prapti","F",11,9,20
"20456","Prarthana","F",7,9,16
"20457","Prashant","M",8,6,14
"20458","Prateek","M",5,8,13
"20459","Pratham","M",20,17,37
"20460","Prathik","M",6,6,12
"20461","Pratik","M",15,12,27
"20462","Pratyush","M",5,9,14
"20463","Praxton","M",5,5,10
"20464","Prayag","M",6,9,15
"20465","Prayan","M",7,21,28
"20466","Praylee","F",5,5,10
"20467","Precious","F",130,106,236
"20468","Precious","M",5,6,11
"20469","Preesha","F",11,9,20
"20470","Preet","M",7,9,16
"20471","Prem","M",17,13,30
"20472","Premier","M",5,7,12
"20473","Prentice","M",21,10,31
"20474","Prentiss","M",9,9,18
"20475","Prescott","F",5,5,10
"20476","Prescott","M",18,33,51
"20477","Preslea","F",7,5,12
"20478","Preslee","F",201,206,407
"20479","Presleigh","F",139,106,245
"20480","Presley","F",1720,1595,3315
"20481","Presley","M",129,121,250
"20482","Presli","F",17,12,29
"20483","Preslie","F",77,78,155
"20484","Presly","F",8,6,14
"20485","Preslyn","F",13,11,24
"20486","Preslynn","F",7,8,15
"20487","Pressley","F",28,24,52
"20488","Presten","M",25,10,35
"20489","Prestin","M",14,19,33
"20490","Preston","F",19,23,42
"20491","Preston","M",2439,2297,4736
"20492","Prestyn","F",21,13,34
"20493","Prestyn","M",28,52,80
"20494","Prezley","F",6,6,12
"20495","Pria","F",18,11,29
"20496","Priam","M",5,8,13
"20497","Price","F",6,10,16
"20498","Price","M",38,52,90
"20499","Pricila","F",15,7,22
"20500","Pricilla","F",12,13,25
"20501","Prim","F",13,20,33
"20502","Primo","M",7,8,15
"20503","Primrose","F",50,59,109
"20504","Prince","M",820,1007,1827
"20505","Princeamir","M",9,6,15
"20506","Princedavid","M",5,7,12
"20507","Princess","F",268,369,637
"20508","Princeston","M",23,36,59
"20509","Princeton","M",709,769,1478
"20510","Prinston","M",10,8,18
"20511","Prisca","F",11,16,27
"20512","Priscila","F",78,84,162
"20513","Priscilla","F",631,666,1297
"20514","Prish","M",8,10,18
"20515","Prisha","F",141,169,310
"20516","Prisila","F",6,6,12
"20517","Prisma","F",5,5,10
"20518","Pristine","F",6,5,11
"20519","Prithvi","M",14,17,31
"20520","Pritika","F",6,5,11
"20521","Priya","F",171,164,335
"20522","Priyah","F",5,6,11
"20523","Priyal","F",6,11,17
"20524","Priyan","M",6,11,17
"20525","Priyana","F",11,10,21
"20526","Priyanka","F",30,26,56
"20527","Priyansh","M",8,9,17
"20528","Promise","F",245,212,457
"20529","Promise","M",18,10,28
"20530","Promyse","F",27,17,44
"20531","Prophet","M",6,11,17
"20532","Prosper","M",21,18,39
"20533","Prosperity","F",12,6,18
"20534","Providence","F",10,12,22
"20535","Prudence","F",69,79,148
"20536","Pruitt","M",5,5,10
"20537","Pryce","M",57,40,97
"20538","Prynce","M",27,35,62
"20539","Pryncess","F",7,8,15
"20540","Prynceton","M",9,7,16
"20541","Pryor","M",9,14,23
"20542","Psalm","F",11,5,16
"20543","Psalm","M",6,8,14
"20544","Purav","M",9,5,14
"20545","Purity","F",17,17,34
"20546","Purvi","F",7,6,13
"20547","Pyper","F",240,213,453
"20548","Qadir","M",14,12,26
"20549","Qais","M",22,24,46
"20550","Qamar","F",15,22,37
"20551","Qasim","M",36,35,71
"20552","Qays","M",5,7,12
"20553","Qiana","F",5,8,13
"20554","Qirat","F",9,5,14
"20555","Quade","M",35,36,71
"20556","Quadir","M",28,20,48
"20557","Quaid","M",28,36,64
"20558","Quamir","M",11,12,23
"20559","Quan","M",21,13,34
"20560","Quavon","M",11,6,17
"20561","Queen","F",148,197,345
"20562","Queena","F",30,50,80
"20563","Queenie","F",41,52,93
"20564","Quentin","M",613,628,1241
"20565","Quenton","M",24,29,53
"20566","Quentyn","M",16,8,24
"20567","Quest","M",28,35,63
"20568","Quetzali","F",12,9,21
"20569","Quetzalli","F",33,26,59
"20570","Quetzally","F",9,10,19
"20571","Quetzaly","F",26,28,54
"20572","Quiana","F",8,5,13
"20573","Quianna","F",6,5,11
"20574","Quill","M",21,23,44
"20575","Quillan","M",10,13,23
"20576","Quin","F",28,22,50
"20577","Quin","M",36,34,70
"20578","Quince","M",5,5,10
"20579","Quincee","F",13,10,23
"20580","Quincee","M",5,5,10
"20581","Quincey","F",29,22,51
"20582","Quincey","M",24,23,47
"20583","Quinci","F",8,5,13
"20584","Quincie","F",6,5,11
"20585","Quincy","F",147,163,310
"20586","Quincy","M",456,473,929
"20587","Quindarius","M",6,8,14
"20588","Quinlan","F",25,28,53
"20589","Quinlan","M",51,48,99
"20590","Quinlee","F",18,23,41
"20591","Quinley","F",36,57,93
"20592","Quinlyn","F",18,23,41
"20593","Quinlynn","F",12,13,25
"20594","Quinn","F",3089,3636,6725
"20595","Quinn","M",945,1040,1985
"20596","Quinne","F",6,5,11
"20597","Quinnlee","F",7,8,15
"20598","Quinnleigh","F",5,5,10
"20599","Quinnley","F",20,24,44
"20600","Quinnly","F",10,10,20
"20601","Quinnlyn","F",23,23,46
"20602","Quinnlynn","F",6,6,12
"20603","Quinnton","M",9,10,19
"20604","Quint","M",14,10,24
"20605","Quintavious","M",13,11,24
"20606","Quinten","M",140,149,289
"20607","Quintin","M",219,182,401
"20608","Quinton","M",462,453,915
"20609","Quintrell","M",17,10,27
"20610","Quintus","M",22,26,48
"20611","Quintyn","M",17,17,34
"20612","Quorra","F",24,23,47
"20613","Quran","M",36,36,72
"20614","Qusai","M",26,13,39
"20615","Qusay","M",10,9,19
"20616","Quynh","F",8,8,16
"20617","Quynn","F",10,11,21
"20618","Ra","M",9,7,16
"20619","Raad","M",9,10,19
"20620","Raaga","F",8,6,14
"20621","Raaghav","M",7,7,14
"20622","Raahi","F",9,13,22
"20623","Raahim","M",11,6,17
"20624","Raam","M",7,7,14
"20625","Raaya","F",5,7,12
"20626","Rabia","F",11,18,29
"20627","Race","M",28,19,47
"20628","Racer","M",6,6,12
"20629","Rachael","F",183,162,345
"20630","Racheal","F",17,21,38
"20631","Rachel","F",1922,1854,3776
"20632","Rachell","F",30,22,52
"20633","Rachelle","F",95,61,156
"20634","Rachit","M",10,8,18
"20635","Racquel","F",15,11,26
"20636","Radeen","M",6,5,11
"20637","Radek","M",7,9,16
"20638","Radford","M",8,8,16
"20639","Radha","F",27,35,62
"20640","Radhika","F",17,19,36
"20641","Radiance","F",8,6,14
"20642","Radin","M",11,8,19
"20643","Radlee","M",5,6,11
"20644","Radley","F",8,17,25
"20645","Radley","M",66,69,135
"20646","Rae","F",95,190,285
"20647","Raea","F",7,12,19
"20648","Raeann","F",28,19,47
"20649","Raeanna","F",19,13,32
"20650","Raeanne","F",14,8,22
"20651","Raed","M",14,16,30
"20652","Raeden","F",6,5,11
"20653","Raeden","M",21,13,34
"20654","Raedyn","F",18,22,40
"20655","Raedyn","M",16,8,24
"20656","Raef","M",10,13,23
"20657","Raegan","F",1165,1129,2294
"20658","Raegan","M",8,19,27
"20659","Raegen","F",37,42,79
"20660","Raeghan","F",28,36,64
"20661","Raegin","F",5,5,10
"20662","Raegyn","F",36,20,56
"20663","Raekwon","M",11,9,20
"20664","Rael","F",6,6,12
"20665","Rael","M",7,6,13
"20666","Raela","F",8,10,18
"20667","Raelan","F",17,6,23
"20668","Raelee","F",103,91,194
"20669","Raeleen","F",6,11,17
"20670","Raeleigh","F",127,129,256
"20671","Raelene","F",16,9,25
"20672","Raeley","F",15,14,29
"20673","Raeli","F",5,5,10
"20674","Raelie","F",9,6,15
"20675","Raelin","F",38,22,60
"20676","Raelinn","F",11,6,17
"20677","Raelle","F",15,16,31
"20678","Raelyn","F",961,1024,1985
"20679","Raelynn","F",1797,1971,3768
"20680","Raelynne","F",43,47,90
"20681","Raena","F",28,42,70
"20682","Raeonna","F",5,6,11
"20683","Raeven","F",9,8,17
"20684","Raevyn","F",26,31,57
"20685","Raeya","F",32,49,81
"20686","Rafael","M",1222,1232,2454
"20687","Rafaela","F",38,45,83
"20688","Rafaella","F",27,40,67
"20689","Rafay","M",10,8,18
"20690","Rafe","M",82,85,167
"20691","Rafeal","M",6,6,12
"20692","Rafeef","F",9,9,18
"20693","Raffaele","M",14,17,31
"20694","Raffaella","F",10,7,17
"20695","Rafferty","M",12,10,22
"20696","Raffi","M",11,19,30
"20697","Rafi","M",18,15,33
"20698","Rafif","F",7,5,12
"20699","Rafiq","M",8,7,15
"20700","Ragan","F",16,17,33
"20701","Rage","M",9,6,15
"20702","Ragen","F",7,5,12
"20703","Raghad","F",18,22,40
"20704","Raghav","M",66,55,121
"20705","Ragnar","M",32,39,71
"20706","Raha","F",10,12,22
"20707","Rahaf","F",49,46,95
"20708","Raheel","F",8,7,15
"20709","Raheel","M",7,12,19
"20710","Raheem","M",152,156,308
"20711","Raheim","M",6,9,15
"20712","Rahel","F",12,9,21
"20713","Rahi","F",9,12,21
"20714","Rahiem","M",13,11,24
"20715","Rahil","F",5,6,11
"20716","Rahil","M",20,12,32
"20717","Rahim","M",39,39,78
"20718","Rahima","F",15,8,23
"20719","Rahkeem","M",10,13,23
"20720","Rahm","M",7,7,14
"20721","Rahma","F",75,97,172
"20722","Rahmah","F",16,17,33
"20723","Rahman","M",20,23,43
"20724","Rahmel","M",9,9,18
"20725","Rahmir","M",21,27,48
"20726","Rahsaan","M",7,16,23
"20727","Rahul","M",14,16,30
"20728","Rai","M",9,21,30
"20729","Raia","F",11,16,27
"20730","Raidan","M",5,6,11
"20731","Raiden","F",26,39,65
"20732","Raiden","M",632,736,1368
"20733","Raider","M",32,28,60
"20734","Raidon","M",7,6,13
"20735","Raidyn","F",8,9,17
"20736","Raidyn","M",32,45,77
"20737","Raif","M",18,10,28
"20738","Raife","M",6,5,11
"20739","Raigan","F",38,39,77
"20740","Raigen","F",20,13,33
"20741","Raighan","F",7,5,12
"20742","Raihan","M",12,14,26
"20743","Railee","F",16,18,34
"20744","Raileigh","F",16,16,32
"20745","Railey","F",27,35,62
"20746","Railyn","F",48,64,112
"20747","Railynn","F",61,61,122
"20748","Raima","F",8,10,18
"20749","Rain","F",93,96,189
"20750","Rain","M",34,31,65
"20751","Raina","F",295,341,636
"20752","Rainah","F",14,8,22
"20753","Rainan","M",5,5,10
"20754","Rainbow","F",12,15,27
"20755","Raine","F",89,97,186
"20756","Raine","M",14,10,24
"20757","Rainee","F",11,15,26
"20758","Rainer","M",36,43,79
"20759","Rainey","F",44,60,104
"20760","Raini","F",5,8,13
"20761","Rainie","F",13,14,27
"20762","Rainier","M",35,30,65
"20763","Rainn","F",6,7,13
"20764","Rainn","M",5,5,10
"20765","Rainna","F",7,8,15
"20766","Rainy","F",28,23,51
"20767","Raisa","F",27,23,50
"20768","Raissa","F",7,14,21
"20769","Raistlin","M",9,7,16
"20770","Raiven","F",8,6,14
"20771","Raivyn","F",9,8,17
"20772","Raiya","F",28,23,51
"20773","Raiyah","F",10,8,18
"20774","Raiyan","M",10,17,27
"20775","Raiyn","F",7,5,12
"20776","Raiyne","F",5,10,15
"20777","Raiza","F",9,10,19
"20778","Raizel","F",47,49,96
"20779","Raizy","F",100,87,187
"20780","Raj","M",38,23,61
"20781","Raja","M",15,13,28
"20782","Rajah","M",6,14,20
"20783","Rajan","M",14,18,32
"20784","Rajon","M",27,20,47
"20785","Rajveer","M",25,32,57
"20786","Rajvir","M",7,6,13
"20787","Rakan","M",34,54,88
"20788","Rakeb","F",8,10,18
"20789","Rakeem","M",31,40,71
"20790","Rakel","F",8,9,17
"20791","Rakim","M",14,32,46
"20792","Rakiya","F",8,11,19
"20793","Rakiyah","F",14,12,26
"20794","Raksha","F",6,7,13
"20795","Rakshan","M",5,9,14
"20796","Raleigh","F",154,168,322
"20797","Raleigh","M",77,89,166
"20798","Raley","F",10,11,21
"20799","Raliyah","F",9,6,15
"20800","Rally","M",7,10,17
"20801","Ralph","M",184,204,388
"20802","Ralston","M",15,12,27
"20803","Ralyn","F",7,7,14
"20804","Ralynn","F",16,9,25
"20805","Ram","M",30,42,72
"20806","Rama","F",21,21,42
"20807","Ramadan","M",12,15,27
"20808","Ramaj","M",6,7,13
"20809","Raman","M",8,7,15
"20810","Ramani","F",6,7,13
"20811","Ramari","M",7,7,14
"20812","Ramata","F",7,10,17
"20813","Ramatoulaye","F",6,6,12
"20814","Ramaya","F",12,5,17
"20815","Rameen","F",16,12,28
"20816","Rameer","M",5,5,10
"20817","Ramel","M",16,21,37
"20818","Ramell","M",8,6,14
"20819","Ramelo","M",5,7,12
"20820","Ramere","M",5,5,10
"20821","Rameses","M",8,8,16
"20822","Ramesses","M",12,16,28
"20823","Ramey","F",8,10,18
"20824","Rami","M",56,76,132
"20825","Ramia","F",6,9,15
"20826","Ramiah","F",22,20,42
"20827","Ramie","F",7,8,15
"20828","Ramiel","M",6,6,12
"20829","Ramier","M",5,7,12
"20830","Ramin","M",5,13,18
"20831","Ramir","M",42,34,76
"20832","Ramiro","M",198,224,422
"20833","Ramiya","F",18,13,31
"20834","Ramiyah","F",46,33,79
"20835","Ramla","F",15,13,28
"20836","Ramon","M",419,440,859
"20837","Ramona","F",243,285,528
"20838","Ramone","M",36,24,60
"20839","Ramsay","M",6,7,13
"20840","Ramses","M",114,127,241
"20841","Ramsey","F",83,115,198
"20842","Ramsey","M",130,150,280
"20843","Ramsie","F",6,10,16
"20844","Ramy","M",18,13,31
"20845","Ramya","F",30,27,57
"20846","Ramyah","F",6,11,17
"20847","Ramzey","M",8,9,17
"20848","Ramzi","M",21,21,42
"20849","Ramzy","M",13,14,27
"20850","Rana","F",46,62,108
"20851","Rana","M",13,8,21
"20852","Ranae","F",11,7,18
"20853","Ranbir","M",16,7,23
"20854","Rance","M",30,12,42
"20855","Rand","F",11,11,22
"20856","Rand","M",18,21,39
"20857","Randa","F",10,6,16
"20858","Randal","M",39,24,63
"20859","Randall","M",193,190,383
"20860","Randee","F",7,6,13
"20861","Randell","M",19,16,35
"20862","Randi","F",74,82,156
"20863","Randolph","M",44,36,80
"20864","Randon","M",22,10,32
"20865","Randy","M",491,417,908
"20866","Raneem","F",19,21,40
"20867","Ranger","M",49,69,118
"20868","Rani","F",18,25,43
"20869","Rania","F",101,89,190
"20870","Raniah","F",14,13,27
"20871","Raniya","F",36,60,96
"20872","Raniyah","F",117,103,220
"20873","Ransom","M",103,107,210
"20874","Ranveer","M",30,44,74
"20875","Ranvir","M",11,13,24
"20876","Ranya","F",28,29,57
"20877","Raphael","M",530,547,1077
"20878","Raphaela","F",9,19,28
"20879","Raphaella","F",15,16,31
"20880","Raphaelle","F",9,7,16
"20881","Rapheal","M",20,12,32
"20882","Raquan","M",22,6,28
"20883","Raquel","F",375,332,707
"20884","Raquelle","F",15,10,25
"20885","Rarity","F",9,8,17
"20886","Rasean","M",7,7,14
"20887","Raseel","F",12,11,23
"20888","Rasha","F",6,14,20
"20889","Rashaad","M",39,38,77
"20890","Rashad","M",221,184,405
"20891","Rashard","M",30,42,72
"20892","Rashaud","M",19,20,39
"20893","Rashaun","M",35,41,76
"20894","Rashawn","M",85,55,140
"20895","Rashed","M",32,23,55
"20896","Rasheed","M",45,48,93
"20897","Rasheem","M",7,11,18
"20898","Rasheen","M",7,9,16
"20899","Rashel","F",16,13,29
"20900","Rashell","F",11,9,20
"20901","Rashelle","F",12,9,21
"20902","Rashi","F",6,5,11
"20903","Rashid","M",33,52,85
"20904","Rashod","M",13,10,23
"20905","Rashon","M",21,13,34
"20906","Rashun","M",6,9,15
"20907","Rasika","F",5,9,14
"20908","Rasul","M",8,12,20
"20909","Rateel","F",10,9,19
"20910","Raudel","M",15,19,34
"20911","Raul","M",691,649,1340
"20912","Raunak","M",9,10,19
"20913","Raveena","F",10,6,16
"20914","Raven","F",652,626,1278
"20915","Raven","M",37,39,76
"20916","Ravenna","F",26,21,47
"20917","Ravi","M",47,50,97
"20918","Ravleen","F",5,10,15
"20919","Ravneet","F",7,5,12
"20920","Ravon","M",8,10,18
"20921","Ravya","F",7,6,13
"20922","Ravyn","F",71,75,146
"20923","Ravynn","F",6,5,11
"20924","Rawan","F",32,45,77
"20925","Rawley","M",5,16,21
"20926","Rawlins","M",8,5,13
"20927","Rawson","M",8,7,15
"20928","Ray","F",10,21,31
"20929","Ray","M",347,322,669
"20930","Raya","F",203,232,435
"20931","Rayaan","F",23,10,33
"20932","Rayaan","M",57,45,102
"20933","Rayah","F",49,56,105
"20934","Rayan","F",61,55,116
"20935","Rayan","M",475,512,987
"20936","Rayana","F",19,31,50
"20937","Rayann","F",28,30,58
"20938","Rayanna","F",39,37,76
"20939","Rayanne","F",16,13,29
"20940","Rayansh","M",27,23,50
"20941","Rayce","M",50,27,77
"20942","Raycen","M",6,5,11
"20943","Raychel","F",8,12,20
"20944","Raydan","M",5,6,11
"20945","Raydel","M",10,17,27
"20946","Rayden","F",28,19,47
"20947","Rayden","M",379,328,707
"20948","Rayder","M",12,10,22
"20949","Raydin","M",8,13,21
"20950","Raydon","M",18,16,34
"20951","Raydyn","M",6,7,13
"20952","Raye","F",10,8,18
"20953","Rayelle","F",12,17,29
"20954","Rayelynn","F",10,5,15
"20955","Rayen","F",15,11,26
"20956","Rayen","M",6,11,17
"20957","Raygan","F",53,38,91
"20958","Raygen","F",34,32,66
"20959","Rayhan","M",30,32,62
"20960","Rayhana","F",15,14,29
"20961","Rayla","F",35,44,79
"20962","Raylah","F",6,5,11
"20963","Raylan","F",57,32,89
"20964","Raylan","M",630,481,1111
"20965","Rayland","M",46,46,92
"20966","Raylea","F",10,11,21
"20967","Raylee","F",261,253,514
"20968","Raylee","M",6,6,12
"20969","Rayleen","F",13,23,36
"20970","Raylei","F",8,11,19
"20971","Rayleigh","F",156,158,314
"20972","Raylen","F",55,34,89
"20973","Raylen","M",104,91,195
"20974","Raylene","F",33,28,61
"20975","Rayley","F",6,10,16
"20976","Rayli","F",5,7,12
"20977","Raylie","F",25,19,44
"20978","Raylin","F",78,67,145
"20979","Raylin","M",41,33,74
"20980","Raylinn","F",19,15,34
"20981","Raylon","M",79,59,138
"20982","Raylyn","F",54,45,99
"20983","Raylyn","M",9,6,15
"20984","Raylynn","F",195,213,408
"20985","Raylynne","F",10,5,15
"20986","Raymir","M",5,6,11
"20987","Raymon","M",35,40,75
"20988","Raymond","M",1378,1264,2642
"20989","Raymone","M",8,10,18
"20990","Raymundo","M",84,74,158
"20991","Rayn","F",20,20,40
"20992","Rayn","M",9,8,17
"20993","Rayna","F",392,431,823
"20994","Raynah","F",12,15,27
"20995","Raynaldo","M",8,8,16
"20996","Raynard","M",20,11,31
"20997","Raynav","M",6,7,13
"20998","Rayne","F",260,289,549
"20999","Rayne","M",28,42,70
"21000","Raynee","F",16,15,31
"21001","Rayner","M",16,17,33
"21002","Raynie","F",10,12,22
"21003","Raynor","M",16,18,34
"21004","Rayon","M",19,17,36
"21005","Rayonna","F",14,27,41
"21006","Rayquan","M",27,11,38
"21007","Raysean","M",12,10,22
"21008","Rayshaun","M",12,11,23
"21009","Rayshawn","M",54,52,106
"21010","Rayshon","M",7,13,20
"21011","Rayshun","M",5,5,10
"21012","Rayson","M",11,17,28
"21013","Rayven","F",87,66,153
"21014","Rayvin","F",8,11,19
"21015","Rayvn","F",9,5,14
"21016","Rayvon","M",39,30,69
"21017","Raza","M",14,5,19
"21018","Razan","F",61,63,124
"21019","Razia","F",6,6,12
"21020","Raziel","M",50,57,107
"21021","Raziya","F",23,24,47
"21022","Raziyah","F",9,14,23
"21023","Rea","F",15,23,38
"21024","Reagan","F",3047,3081,6128
"21025","Reagan","M",206,202,408
"21026","Reagen","F",17,12,29
"21027","Reaghan","F",38,46,84
"21028","Reagyn","F",17,10,27
"21029","Reality","F",5,5,10
"21030","Realynn","F",8,9,17
"21031","Reana","F",5,9,14
"21032","Reanna","F",24,29,53
"21033","Reanne","F",5,5,10
"21034","Reata","F",13,14,27
"21035","Reba","F",14,22,36
"21036","Rebeca","F",179,214,393
"21037","Rebecca","F",1718,1563,3281
"21038","Rebecka","F",14,15,29
"21039","Rebeka","F",30,31,61
"21040","Rebekah","F",600,522,1122
"21041","Rebekka","F",15,10,25
"21042","Rebekkah","F",12,16,28
"21043","Rebel","F",83,102,185
"21044","Rebel","M",45,44,89
"21045","Rece","M",7,13,20
"21046","Red","M",6,9,15
"21047","Reda","M",15,15,30
"21048","Redd","M",6,10,16
"21049","Redding","M",19,33,52
"21050","Reddington","M",12,13,25
"21051","Redford","M",8,12,20
"21052","Redmond","M",17,22,39
"21053","Reece","F",179,175,354
"21054","Reece","M",492,474,966
"21055","Reed","F",37,38,75
"21056","Reed","M",1043,960,2003
"21057","Reef","M",51,56,107
"21058","Reegan","F",48,42,90
"21059","Reegan","M",10,16,26
"21060","Reem","F",119,104,223
"21061","Reema","F",53,45,98
"21062","Reena","F",27,29,56
"21063","Rees","F",5,8,13
"21064","Rees","M",18,10,28
"21065","Reesa","F",10,5,15
"21066","Reese","F",1853,1815,3668
"21067","Reese","M",357,380,737
"21068","Reet","F",33,18,51
"21069","Reeva","F",44,37,81
"21070","Reeve","F",12,12,24
"21071","Reeve","M",37,50,87
"21072","Reeves","M",26,25,51
"21073","Reeya","F",6,19,25
"21074","Refael","M",14,8,22
"21075","Refoel","M",12,8,20
"21076","Refugio","M",6,8,14
"21077","Regan","F",261,213,474
"21078","Regan","M",50,46,96
"21079","Reggie","F",11,8,19
"21080","Reggie","M",64,58,122
"21081","Reghan","F",19,18,37
"21082","Regina","F",604,733,1337
"21083","Reginae","F",39,43,82
"21084","Reginald","M",252,277,529
"21085","Regino","M",6,7,13
"21086","Regis","M",10,13,23
"21087","Reha","F",6,8,14
"21088","Rehaan","M",16,24,40
"21089","Reham","F",17,15,32
"21090","Rehan","M",64,70,134
"21091","Rehana","F",10,6,16
"21092","Rehema","F",5,7,12
"21093","Rehmat","F",5,9,14
"21094","Rei","F",13,26,39
"21095","Rei","M",21,14,35
"21096","Reia","F",11,16,27
"21097","Reid","F",34,35,69
"21098","Reid","M",1335,1393,2728
"21099","Reigan","F",10,18,28
"21100","Reighlyn","F",16,20,36
"21101","Reighlynn","F",14,20,34
"21102","Reighn","F",6,14,20
"21103","Reign","F",232,344,576
"21104","Reign","M",120,158,278
"21105","Reigna","F",13,10,23
"21106","Reika","F",7,6,13
"21107","Reiko","F",6,6,12
"21108","Reiley","F",12,12,24
"21109","Reilly","F",89,97,186
"21110","Reilly","M",84,94,178
"21111","Reily","M",12,6,18
"21112","Reilyn","F",15,10,25
"21113","Reilynn","F",16,12,28
"21114","Rein","F",8,8,16
"21115","Rein","M",6,9,15
"21116","Reina","F",284,328,612
"21117","Reinaldo","M",18,16,34
"21118","Reine","F",8,12,20
"21119","Reiner","M",12,9,21
"21120","Reis","M",16,20,36
"21121","Reiya","F",5,8,13
"21122","Reizy","F",5,5,10
"21123","Rejoice","F",8,10,18
"21124","Relena","F",7,8,15
"21125","Rella","F",5,9,14
"21126","Rema","F",6,11,17
"21127","Remas","F",15,9,24
"21128","Remedi","F",6,8,14
"21129","Remedy","F",36,39,75
"21130","Remi","F",633,1095,1728
"21131","Remi","M",90,174,264
"21132","Remie","F",27,35,62
"21133","Remiel","M",15,5,20
"21134","Remigio","M",11,6,17
"21135","Remii","F",5,7,12
"21136","Remilynn","F",5,7,12
"21137","Remington","F",461,696,1157
"21138","Remington","M",1202,1401,2603
"21139","Remingtyn","F",9,20,29
"21140","Reminisce","F",5,7,12
"21141","Remmi","F",25,22,47
"21142","Remmie","F",19,19,38
"21143","Remmington","F",17,16,33
"21144","Remmington","M",17,25,42
"21145","Remmy","F",19,24,43
"21146","Remmy","M",46,61,107
"21147","Remo","M",8,10,18
"21148","Remus","M",9,19,28
"21149","Remy","F",332,394,726
"21150","Remy","M",554,648,1202
"21151","Ren","F",13,28,41
"21152","Ren","M",71,113,184
"21153","Rena","F",63,68,131
"21154","Renad","F",17,12,29
"21155","Renae","F",52,35,87
"21156","Renaldo","M",12,9,21
"21157","Renan","M",8,10,18
"21158","Renard","M",8,9,17
"21159","Renata","F",446,573,1019
"21160","Renatha","F",7,11,18
"21161","Renato","M",50,42,92
"21162","Renatta","F",19,36,55
"21163","Rene","F",19,20,39
"21164","Rene","M",276,245,521
"21165","Renea","F",13,11,24
"21166","Renee","F",240,257,497
"21167","Renesmae","F",40,27,67
"21168","Renesmay","F",15,10,25
"21169","Renesme","F",17,14,31
"21170","Renesmee","F",128,154,282
"21171","Renezmae","F",10,16,26
"21172","Reniya","F",10,15,25
"21173","Reniyah","F",24,11,35
"21174","Renlee","F",7,11,18
"21175","Renleigh","F",12,12,24
"21176","Renley","F",19,24,43
"21177","Renley","M",15,14,29
"21178","Renly","F",10,10,20
"21179","Renly","M",28,29,57
"21180","Renn","F",5,9,14
"21181","Renn","M",17,13,30
"21182","Renna","F",9,15,24
"21183","Renner","M",38,39,77
"21184","Rennick","M",7,5,12
"21185","Reno","M",21,26,47
"21186","Renzo","M",75,87,162
"21187","Reo","M",8,9,17
"21188","Reon","M",5,7,12
"21189","Retaj","F",19,15,34
"21190","Retal","F",23,18,41
"21191","Rett","M",7,5,12
"21192","Reuben","M",253,246,499
"21193","Reuel","M",8,13,21
"21194","Reuven","M",38,32,70
"21195","Reva","F",67,51,118
"21196","Revan","M",55,65,120
"21197","Revel","F",8,9,17
"21198","Revel","M",18,12,30
"21199","Reven","M",6,7,13
"21200","Revere","M",9,14,23
"21201","Reverie","F",14,17,31
"21202","Revin","M",8,6,14
"21203","Rex","M",371,419,790
"21204","Rexford","M",16,10,26
"21205","Rexton","M",25,37,62
"21206","Rexx","M",5,5,10
"21207","Rey","M",239,254,493
"21208","Reya","F",107,176,283
"21209","Reyaan","M",41,42,83
"21210","Reyaansh","M",16,28,44
"21211","Reyah","F",8,17,25
"21212","Reyan","M",40,48,88
"21213","Reyanna","F",5,5,10
"21214","Reyansh","M",255,317,572
"21215","Reyden","M",15,35,50
"21216","Reyes","M",68,56,124
"21217","Reygan","F",17,21,38
"21218","Reylan","M",7,10,17
"21219","Reyli","M",29,10,39
"21220","Reylynn","F",6,15,21
"21221","Reymond","M",12,12,24
"21222","Reymundo","M",38,34,72
"21223","Reyna","F",399,435,834
"21224","Reynaldo","M",171,144,315
"21225","Reyniel","M",6,5,11
"21226","Reynold","M",8,8,16
"21227","Reynolds","F",9,7,16
"21228","Reynolds","M",10,17,27
"21229","Reza","M",20,29,49
"21230","Reznor","M",9,10,19
"21231","Rhaegan","F",5,6,11
"21232","Rhaelyn","F",7,7,14
"21233","Rhaya","F",8,7,15
"21234","Rhea","F",271,285,556
"21235","Rheagan","F",26,28,54
"21236","Rhealynn","F",10,9,19
"21237","Rheanna","F",7,5,12
"21238","Rhegan","F",9,10,19
"21239","Rhema","F",41,43,84
"21240","Rhemi","F",13,26,39
"21241","Rhen","M",7,16,23
"21242","Rhet","M",5,13,18
"21243","Rhett","F",12,17,29
"21244","Rhett","M",1338,1761,3099
"21245","Rheya","F",14,41,55
"21246","Rhia","F",9,7,16
"21247","Rhian","F",35,22,57
"21248","Rhianna","F",36,29,65
"21249","Rhiannon","F",119,140,259
"21250","Rhilee","F",16,11,27
"21251","Rhiley","F",54,60,114
"21252","Rhiley","M",10,7,17
"21253","Rhilyn","F",8,10,18
"21254","Rhilynn","F",9,25,34
"21255","Rhoda","F",47,50,97
"21256","Rhodes","M",63,59,122
"21257","Rhody","M",6,5,11
"21258","Rhonan","M",9,10,19
"21259","Rhonda","F",18,24,42
"21260","Rhone","M",8,13,21
"21261","Rhonin","M",8,17,25
"21262","Rhya","F",10,11,21
"21263","Rhyan","F",102,119,221
"21264","Rhyan","M",30,29,59
"21265","Rhyann","F",11,19,30
"21266","Rhyanna","F",6,7,13
"21267","Rhyatt","M",6,7,13
"21268","Rhyder","F",11,12,23
"21269","Rhyder","M",76,70,146
"21270","Rhydian","M",46,43,89
"21271","Rhyen","F",9,12,21
"21272","Rhyett","M",6,12,18
"21273","Rhyis","M",5,8,13
"21274","Rhyker","M",34,40,74
"21275","Rhyla","F",5,8,13
"21276","Rhylan","F",19,19,38
"21277","Rhylan","M",48,35,83
"21278","Rhyland","M",24,21,45
"21279","Rhylee","F",121,128,249
"21280","Rhylee","M",18,23,41
"21281","Rhylei","F",9,11,20
"21282","Rhyleigh","F",36,39,75
"21283","Rhylen","F",12,10,22
"21284","Rhylen","M",16,13,29
"21285","Rhylie","F",41,29,70
"21286","Rhylin","F",12,14,26
"21287","Rhylin","M",9,7,16
"21288","Rhylynn","F",15,13,28
"21289","Rhys","F",22,21,43
"21290","Rhys","M",560,606,1166
"21291","Rhyse","M",5,10,15
"21292","Rhyson","M",5,5,10
"21293","Rhythm","F",23,28,51
"21294","Rhythm","M",33,39,72
"21295","Ria","F",84,108,192
"21296","Riaan","M",229,261,490
"21297","Riah","F",34,28,62
"21298","Rian","F",88,91,179
"21299","Rian","M",123,153,276
"21300","Riana","F",38,27,65
"21301","Riann","F",9,12,21
"21302","Rianna","F",38,41,79
"21303","Rianne","F",11,16,27
"21304","Riansh","M",6,5,11
"21305","Rianshi","F",8,7,15
"21306","Riata","F",6,5,11
"21307","Ricardo","M",1337,1293,2630
"21308","Riccardo","M",10,8,18
"21309","Ricco","M",20,11,31
"21310","Rich","M",18,17,35
"21311","Richa","F",8,7,15
"21312","Richard","M",2671,2499,5170
"21313","Richardo","M",7,12,19
"21314","Richardson","M",5,14,19
"21315","Richelle","F",25,21,46
"21316","Richie","M",68,69,137
"21317","Richmond","M",24,24,48
"21318","Richter","M",6,6,12
"21319","Richy","M",9,5,14
"21320","Rick","M",81,66,147
"21321","Rickey","M",87,78,165
"21322","Ricki","F",38,25,63
"21323","Rickie","F",8,17,25
"21324","Rickie","M",31,13,44
"21325","Ricky","F",8,8,16
"21326","Ricky","M",474,444,918
"21327","Rico","M",121,119,240
"21328","Rida","F",25,34,59
"21329","Rida","M",6,7,13
"21330","Riddhi","F",24,23,47
"21331","Riddick","M",39,52,91
"21332","Rider","M",60,45,105
"21333","Ridge","M",226,246,472
"21334","Ridger","M",5,5,10
"21335","Ridhaan","M",16,18,34
"21336","Ridhi","F",28,22,50
"21337","Ridhima","F",15,9,24
"21338","Ridhwan","M",7,5,12
"21339","Ridley","F",71,83,154
"21340","Ridley","M",62,78,140
"21341","Ridwan","M",45,33,78
"21342","Rieley","F",6,6,12
"21343","Rielle","F",26,30,56
"21344","Rielyn","F",16,13,29
"21345","Rielynn","F",19,17,36
"21346","Rifka","F",13,17,30
"21347","Rifky","F",19,14,33
"21348","Rigby","F",9,9,18
"21349","Rigby","M",32,24,56
"21350","Rigdon","M",6,11,17
"21351","Rigel","M",27,34,61
"21352","Riggen","M",6,6,12
"21353","Riggin","M",34,21,55
"21354","Riggins","M",44,52,96
"21355","Riggs","M",66,65,131
"21356","Righteous","M",15,11,26
"21357","Rigley","F",7,7,14
"21358","Rigley","M",9,9,18
"21359","Rigo","M",36,27,63
"21360","Rigoberto","M",109,115,224
"21361","Rihaan","M",41,44,85
"21362","Riham","F",17,10,27
"21363","Rihan","M",17,37,54
"21364","Rihana","F",8,13,21
"21365","Rihanna","F",178,177,355
"21366","Rika","F",11,6,17
"21367","Riker","M",94,95,189
"21368","Riki","F",9,7,16
"21369","Rikki","F",68,64,132
"21370","Riko","F",7,6,13
"21371","Riku","M",16,17,33
"21372","Rilan","M",16,15,31
"21373","Rilee","F",122,127,249
"21374","Rilee","M",16,17,33
"21375","Rilei","F",7,7,14
"21376","Rileigh","F",123,127,250
"21377","Rilen","M",8,5,13
"21378","Riley","F",5720,7110,12830
"21379","Riley","M",2081,1706,3787
"21380","Rileyann","F",11,11,22
"21381","Rilla","F",11,8,19
"21382","Rilyn","F",77,83,160
"21383","Rilyn","M",15,10,25
"21384","Rilynn","F",234,242,476
"21385","Rilynne","F",13,12,25
"21386","Rim","F",5,8,13
"21387","Rima","F",38,26,64
"21388","Rin","F",16,15,31
"21389","Rina","F",63,67,130
"21390","Ringo","M",12,5,17
"21391","Rinka","F",5,7,12
"21392","Rinley","F",15,9,24
"21393","Rinna","F",5,5,10
"21394","Rinnah","F",9,11,20
"21395","Rinoa","F",30,33,63
"21396","Rio","F",38,61,99
"21397","Rio","M",103,132,235
"21398","Rion","F",5,12,17
"21399","Rion","M",36,36,72
"21400","Riona","F",33,27,60
"21401","Riordan","M",10,7,17
"21402","Riot","F",9,10,19
"21403","Riot","M",61,68,129
"21404","Ripken","M",15,15,30
"21405","Riplee","F",5,5,10
"21406","Ripley","F",97,128,225
"21407","Ripley","M",30,26,56
"21408","Risa","F",16,24,40
"21409","Risha","F",28,14,42
"21410","Rishaan","M",110,93,203
"21411","Rishab","M",15,17,32
"21412","Rishabh","M",30,27,57
"21413","Rishan","M",31,27,58
"21414","Rishav","M",11,12,23
"21415","Rishi","M",134,133,267
"21416","Rishik","M",28,32,60
"21417","Rishika","F",27,22,49
"21418","Rishita","F",13,10,23
"21419","Rita","F",189,209,398
"21420","Ritaj","F",15,15,30
"21421","Rital","F",10,6,16
"21422","Ritchie","M",24,29,53
"21423","Rithanya","F",8,6,14
"21424","Rithik","M",13,17,30
"21425","Rithika","F",12,12,24
"21426","Rithvik","M",29,29,58
"21427","Rithvika","F",5,5,10
"21428","Rithwik","M",5,5,10
"21429","Ritika","F",14,15,29
"21430","Ritisha","F",5,8,13
"21431","Rito","M",5,5,10
"21432","Ritter","M",7,17,24
"21433","Ritvik","M",7,12,19
"21434","Ritwik","M",10,10,20
"21435","Riva","F",22,35,57
"21436","Rivaan","M",22,28,50
"21437","Rivan","M",24,9,33
"21438","Riven","F",9,13,22
"21439","Riven","M",11,8,19
"21440","River","F",945,1118,2063
"21441","River","M",1509,1825,3334
"21442","Riverlynn","F",7,7,14
"21443","Rivers","F",31,21,52
"21444","Rivers","M",82,78,160
"21445","Rivka","F",324,325,649
"21446","Rivkah","F",33,34,67
"21447","Rivky","F",78,87,165
"21448","Rixon","M",8,12,20
"21449","Rixton","M",10,6,16
"21450","Riya","F",228,272,500
"21451","Riyaan","F",6,7,13
"21452","Riyaan","M",43,45,88
"21453","Riyad","M",18,14,32
"21454","Riyah","F",36,41,77
"21455","Riyan","F",34,42,76
"21456","Riyan","M",63,59,122
"21457","Riyana","F",20,14,34
"21458","Riyansh","M",39,46,85
"21459","Riyanshi","F",9,14,23
"21460","Riza","F",8,5,13
"21461","Rizwan","M",11,19,30
"21462","Rj","M",19,24,43
"21463","Rmani","F",12,8,20
"21464","Roaa","F",6,11,17
"21465","Roan","F",10,10,20
"21466","Roan","M",98,84,182
"21467","Roanan","M",5,5,10
"21468","Roane","M",7,8,15
"21469","Roark","M",16,17,33
"21470","Roarke","M",13,11,24
"21471","Robben","M",8,11,19
"21472","Robbie","F",15,14,29
"21473","Robbie","M",63,56,119
"21474","Robby","M",25,28,53
"21475","Robel","M",28,26,54
"21476","Robert","M",6100,5953,12053
"21477","Roberta","F",60,61,121
"21478","Roberto","M",924,886,1810
"21479","Robin","F",260,237,497
"21480","Robin","M",213,169,382
"21481","Robinson","M",54,54,108
"21482","Robiya","F",6,5,11
"21483","Roby","M",5,5,10
"21484","Robyn","F",252,244,496
"21485","Robynn","F",12,13,25
"21486","Rocco","M",654,673,1327
"21487","Rochel","F",103,109,212
"21488","Rochelle","F",59,47,106
"21489","Rocio","F",104,74,178
"21490","Rock","M",30,30,60
"21491","Rocket","M",26,23,49
"21492","Rockford","M",18,14,32
"21493","Rockie","F",8,5,13
"21494","Rockland","M",8,8,16
"21495","Rocklyn","F",13,7,20
"21496","Rocko","M",15,16,31
"21497","Rockwell","M",91,97,188
"21498","Rocky","M",229,215,444
"21499","Roczen","M",42,26,68
"21500","Rod","M",6,11,17
"21501","Roda","F",5,5,10
"21502","Rodderick","M",7,5,12
"21503","Roddrick","M",7,7,14
"21504","Roderick","M",185,199,384
"21505","Rodger","M",35,25,60
"21506","Rodina","F",10,8,18
"21507","Rodney","M",344,338,682
"21508","Rodolfo","M",227,193,420
"21509","Rodrick","M",51,46,97
"21510","Rodrigo","M",658,592,1250
"21511","Rodriguez","M",5,12,17
"21512","Rodriquez","M",16,12,28
"21513","Roel","M",40,36,76
"21514","Roemello","M",7,9,16
"21515","Roen","F",5,9,14
"21516","Roen","M",45,50,95
"21517","Rogan","F",10,5,15
"21518","Rogan","M",87,94,181
"21519","Rogelio","M",268,261,529
"21520","Rogen","M",12,8,20
"21521","Roger","M",477,407,884
"21522","Rogers","M",8,7,15
"21523","Rogue","F",33,45,78
"21524","Rogue","M",25,17,42
"21525","Roha","F",5,7,12
"21526","Rohaan","M",20,20,40
"21527","Rohan","M",385,327,712
"21528","Rohen","M",29,24,53
"21529","Rohin","M",16,9,25
"21530","Rohit","M",15,15,30
"21531","Rohith","M",10,6,16
"21532","Rohnan","M",6,7,13
"21533","Roi","M",14,19,33
"21534","Roisin","F",28,26,54
"21535","Roiza","F",5,7,12
"21536","Roizy","F",9,10,19
"21537","Rojelio","M",9,11,20
"21538","Rokaya","F",8,7,15
"21539","Roko","M",6,5,11
"21540","Rola","F",9,10,19
"21541","Rolan","M",20,25,45
"21542","Roland","M",470,508,978
"21543","Rolando","M",217,223,440
"21544","Roldan","M",8,7,15
"21545","Rolen","M",10,7,17
"21546","Rolland","M",20,16,36
"21547","Rollie","M",14,10,24
"21548","Rollin","M",17,16,33
"21549","Rollins","M",8,7,15
"21550","Rollo","M",10,9,19
"21551","Roma","F",40,45,85
"21552","Romaan","M",5,5,10
"21553","Romain","M",5,5,10
"21554","Romaine","M",9,6,15
"21555","Romaisa","F",5,5,10
"21556","Roman","F",25,27,52
"21557","Roman","M",3877,4187,8064
"21558","Romana","F",6,6,12
"21559","Romani","F",10,10,20
"21560","Romar","M",5,5,10
"21561","Romari","M",6,7,13
"21562","Romario","M",15,14,29
"21563","Rome","F",20,16,36
"21564","Rome","M",121,142,263
"21565","Romel","M",45,48,93
"21566","Romelia","F",6,16,22
"21567","Romell","M",31,26,57
"21568","Romelle","M",9,5,14
"21569","Romello","M",56,56,112
"21570","Romelo","M",38,39,77
"21571","Romen","M",20,19,39
"21572","Romeo","M",851,893,1744
"21573","Romero","M",24,25,49
"21574","Romey","F",9,13,22
"21575","Romi","F",31,39,70
"21576","Romie","F",6,11,17
"21577","Romilly","F",6,7,13
"21578","Romina","F",321,321,642
"21579","Romir","M",10,7,17
"21580","Rommel","M",32,20,52
"21581","Romon","M",5,5,10
"21582","Romulo","M",6,13,19
"21583","Romulus","M",10,8,18
"21584","Romy","F",76,87,163
"21585","Romyn","M",10,19,29
"21586","Ron","M",39,47,86
"21587","Rona","F",26,27,53
"21588","Ronak","M",9,12,21
"21589","Ronal","M",6,7,13
"21590","Ronald","M",702,724,1426
"21591","Ronaldo","M",160,128,288
"21592","Ronan","F",14,22,36
"21593","Ronan","M",1027,1101,2128
"21594","Ronav","M",24,18,42
"21595","Ronda","F",6,6,12
"21596","Rondell","M",17,28,45
"21597","Ronel","M",9,13,22
"21598","Ronell","M",11,15,26
"21599","Ronen","M",52,44,96
"21600","Roni","F",25,28,53
"21601","Roni","M",6,19,25
"21602","Roniel","M",6,10,16
"21603","Ronika","F",5,5,10
"21604","Ronin","F",8,11,19
"21605","Ronin","M",605,587,1192
"21606","Ronit","M",18,15,33
"21607","Ronith","M",5,8,13
"21608","Roniya","F",6,14,20
"21609","Roniyah","F",14,6,20
"21610","Ronnell","M",12,29,41
"21611","Ronney","M",6,6,12
"21612","Ronni","F",25,28,53
"21613","Ronnie","F",32,41,73
"21614","Ronnie","M",307,259,566
"21615","Ronny","M",48,58,106
"21616","Ronon","M",6,7,13
"21617","Rony","M",41,45,86
"21618","Rook","M",36,30,66
"21619","Rooney","F",36,38,74
"21620","Rooney","M",26,11,37
"21621","Roosevelt","F",6,13,19
"21622","Roosevelt","M",50,55,105
"21623","Roper","M",19,20,39
"21624","Roqaya","F",6,9,15
"21625","Roque","M",36,35,71
"21626","Roran","M",23,41,64
"21627","Rorey","F",8,8,16
"21628","Rori","F",114,103,217
"21629","Rorie","F",33,44,77
"21630","Rorik","M",15,24,39
"21631","Rory","F",418,465,883
"21632","Rory","M",852,819,1671
"21633","Rosa","F",452,459,911
"21634","Rosabel","F",8,6,14
"21635","Rosabella","F",69,69,138
"21636","Rosabelle","F",22,31,53
"21637","Rosaisela","F",5,7,12
"21638","Rosalba","F",14,10,24
"21639","Rosalea","F",8,5,13
"21640","Rosaleah","F",7,6,13
"21641","Rosalee","F",228,245,473
"21642","Rosaleen","F",17,16,33
"21643","Rosaleigh","F",55,60,115
"21644","Rosalena","F",12,10,22
"21645","Rosali","F",10,10,20
"21646","Rosalia","F",139,132,271
"21647","Rosalie","F",1187,1241,2428
"21648","Rosalin","F",14,17,31
"21649","Rosalina","F",141,139,280
"21650","Rosalind","F",146,161,307
"21651","Rosalinda","F",92,106,198
"21652","Rosaline","F",32,42,74
"21653","Rosalio","M",7,12,19
"21654","Rosalva","F",6,8,14
"21655","Rosaly","F",21,22,43
"21656","Rosalyn","F",223,281,504
"21657","Rosalynn","F",135,115,250
"21658","Rosalynne","F",7,7,14
"21659","Rosamaria","F",14,11,25
"21660","Rosamund","F",11,8,19
"21661","Rosana","F",12,6,18
"21662","Rosanna","F",67,57,124
"21663","Rosaria","F",16,13,29
"21664","Rosario","F",69,82,151
"21665","Rosario","M",19,17,36
"21666","Rosary","F",6,8,14
"21667","Rosaura","F",9,12,21
"21668","Rosco","M",9,9,18
"21669","Roscoe","M",71,63,134
"21670","Rose","F",1938,2016,3954
"21671","Rosealee","F",12,6,18
"21672","Rosealie","F",5,8,13
"21673","Rosealyn","F",7,12,19
"21674","Roseann","F",7,7,14
"21675","Roseanna","F",21,17,38
"21676","Roseanne","F",11,17,28
"21677","Rosebella","F",7,7,14
"21678","Roselani","F",6,8,14
"21679","Roselee","F",17,12,29
"21680","Roselena","F",5,6,11
"21681","Roselia","F",8,9,17
"21682","Roselie","F",15,14,29
"21683","Roselin","F",15,22,37
"21684","Roselina","F",15,11,26
"21685","Roseline","F",17,21,38
"21686","Rosella","F",44,46,90
"21687","Roselle","F",19,12,31
"21688","Rosely","F",13,13,26
"21689","Roselyn","F",383,342,725
"21690","Roselynn","F",105,129,234
"21691","Rosemarie","F",133,115,248
"21692","Rosemary","F",604,729,1333
"21693","Rosendo","M",34,23,57
"21694","Rosetta","F",39,43,82
"21695","Rosey","F",20,16,36
"21696","Rosha","F",5,6,11
"21697","Roshan","M",32,43,75
"21698","Roshawn","M",8,15,23
"21699","Roshni","F",16,15,31
"21700","Rosi","F",9,13,22
"21701","Rosibel","F",12,5,17
"21702","Rosie","F",364,391,755
"21703","Rosilyn","F",7,7,14
"21704","Rosina","F",23,21,44
"21705","Rosita","F",23,26,49
"21706","Roslin","F",11,6,17
"21707","Roslyn","F",181,215,396
"21708","Roslynn","F",38,28,66
"21709","Rosmery","F",15,21,36
"21710","Ross","M",158,191,349
"21711","Rosselyn","F",8,17,25
"21712","Rossi","F",16,18,34
"21713","Rossi","M",11,9,20
"21714","Rossie","F",5,10,15
"21715","Rosslyn","F",33,26,59
"21716","Rosslynn","F",5,5,10
"21717","Rossy","F",27,15,42
"21718","Roston","M",6,5,11
"21719","Rosy","F",53,51,104
"21720","Rourke","M",10,15,25
"21721","Roux","F",15,16,31
"21722","Rowan","F",985,1344,2329
"21723","Rowan","M",1809,2178,3987
"21724","Rowdy","M",133,129,262
"21725","Rowe","F",5,11,16
"21726","Rowe","M",15,15,30
"21727","Rowen","F",131,177,308
"21728","Rowen","M",402,396,798
"21729","Rowena","F",12,19,31
"21730","Rowin","M",11,18,29
"21731","Rowland","M",19,19,38
"21732","Rowyn","F",156,215,371
"21733","Rowyn","M",36,40,76
"21734","Rowynn","F",26,42,68
"21735","Roxana","F",127,107,234
"21736","Roxann","F",6,9,15
"21737","Roxanna","F",96,91,187
"21738","Roxanne","F",179,185,364
"21739","Roxas","M",32,18,50
"21740","Roxi","F",14,17,31
"21741","Roxie","F",55,51,106
"21742","Roxy","F",80,58,138
"21743","Roy","M",531,536,1067
"21744","Roya","F",50,45,95
"21745","Royal","F",376,474,850
"21746","Royal","M",647,660,1307
"21747","Royale","F",70,67,137
"21748","Royale","M",35,29,64
"21749","Royalle","F",9,8,17
"21750","Royalti","F",19,30,49
"21751","Royalty","F",219,581,800
"21752","Royalty","M",30,39,69
"21753","Royce","F",46,62,108
"21754","Royce","M",532,659,1191
"21755","Royel","M",9,6,15
"21756","Royelle","F",9,14,23
"21757","Royer","M",12,9,21
"21758","Royse","M",5,5,10
"21759","Royston","M",8,10,18
"21760","Roza","F",15,17,32
"21761","Rozalee","F",5,11,16
"21762","Rozalia","F",10,8,18
"21763","Rozalie","F",8,6,14
"21764","Rozalyn","F",28,30,58
"21765","Rozalynn","F",22,14,36
"21766","Rozella","F",5,5,10
"21767","Rozelyn","F",7,9,16
"21768","Rozlyn","F",51,74,125
"21769","Rozlynn","F",51,41,92
"21770","Ruah","F",10,14,24
"21771","Ruairi","M",13,10,23
"21772","Ruari","F",10,15,25
"21773","Ruari","M",14,8,22
"21774","Ruba","F",10,10,20
"21775","Rubani","F",8,7,15
"21776","Rubee","F",19,22,41
"21777","Ruben","M",860,796,1656
"21778","Rubens","M",14,15,29
"21779","Rubi","F",177,183,360
"21780","Rubie","F",45,40,85
"21781","Rubin","M",30,18,48
"21782","Rubina","F",9,8,17
"21783","Ruby","F",3454,3796,7250
"21784","Rubyann","F",13,7,20
"21785","Ruchama","F",6,8,14
"21786","Ruchel","F",13,13,26
"21787","Ruchy","F",25,22,47
"21788","Rucker","M",8,12,20
"21789","Rudi","F",7,9,16
"21790","Rudi","M",12,5,17
"21791","Rudolfo","M",7,7,14
"21792","Rudolph","M",41,33,74
"21793","Rudra","M",72,84,156
"21794","Rudransh","M",9,21,30
"21795","Rudy","F",8,13,21
"21796","Rudy","M",260,261,521
"21797","Rue","F",27,35,62
"21798","Rueben","M",24,21,45
"21799","Rueger","M",10,9,19
"21800","Rufino","M",7,8,15
"21801","Rufus","M",43,35,78
"21802","Ruger","M",138,167,305
"21803","Ruhaan","M",18,18,36
"21804","Ruhama","F",13,15,28
"21805","Ruhan","M",10,22,32
"21806","Ruhani","F",15,15,30
"21807","Ruhee","F",5,6,11
"21808","Ruhi","F",78,65,143
"21809","Rui","M",19,18,37
"21810","Rukaya","F",7,6,13
"21811","Rukia","F",6,12,18
"21812","Rumaisa","F",5,18,23
"21813","Rumaysa","F",19,18,37
"21814","Rumaysah","F",7,5,12
"21815","Rumer","F",8,7,15
"21816","Rumi","F",28,26,54
"21817","Rumi","M",20,24,44
"21818","Rumor","F",8,5,13
"21819","Runa","F",18,30,48
"21820","Rune","M",22,19,41
"21821","Rupert","M",22,15,37
"21822","Ruqaya","F",11,8,19
"21823","Ruqiya","F",6,7,13
"21824","Rush","M",65,68,133
"21825","Rushda","F",7,7,14
"21826","Rushika","F",6,16,22
"21827","Rushil","M",14,7,21
"21828","Rushton","M",9,7,16
"21829","Ruslan","M",27,20,47
"21830","Russ","M",8,8,16
"21831","Russel","M",20,20,40
"21832","Russell","M",764,780,1544
"21833","Rustam","M",6,8,14
"21834","Rustin","M",53,47,100
"21835","Ruston","M",26,17,43
"21836","Rusty","M",46,40,86
"21837","Rustyn","M",15,15,30
"21838","Rut","F",18,27,45
"21839","Rutger","M",5,6,11
"21840","Ruth","F",1099,1081,2180
"21841","Ruthann","F",24,30,54
"21842","Ruthanna","F",5,10,15
"21843","Ruthanne","F",17,16,33
"21844","Ruthie","F",133,134,267
"21845","Ruthvik","M",9,19,28
"21846","Ruthvika","F",6,7,13
"21847","Rutila","F",5,11,16
"21848","Rutledge","M",18,19,37
"21849","Ruvim","M",14,14,28
"21850","Ruwayda","F",17,8,25
"21851","Ruweyda","F",11,17,28
"21852","Ruxin","M",18,14,32
"21853","Ruzgar","M",5,5,10
"21854","Rya","F",63,57,120
"21855","Ryaan","M",17,21,38
"21856","Ryah","F",50,51,101
"21857","Ryan","F",677,680,1357
"21858","Ryan","M",8511,8215,16726
"21859","Ryana","F",9,11,20
"21860","Ryane","F",6,9,15
"21861","Ryann","F",332,343,675
"21862","Ryann","M",8,11,19
"21863","Ryanna","F",26,35,61
"21864","Ryanne","F",73,64,137
"21865","Ryatt","F",8,7,15
"21866","Ryatt","M",99,92,191
"21867","Rydan","M",9,7,16
"21868","Ryden","M",98,112,210
"21869","Ryder","F",133,115,248
"21870","Ryder","M",4144,3854,7998
"21871","Rydge","M",6,11,17
"21872","Rydin","M",8,7,15
"21873","Rye","F",8,8,16
"21874","Rye","M",40,45,85
"21875","Ryelee","F",10,11,21
"21876","Ryeleigh","F",7,5,12
"21877","Ryelle","F",18,17,35
"21878","Ryelynn","F",15,13,28
"21879","Ryen","F",35,33,68
"21880","Ryen","M",23,29,52
"21881","Ryenn","F",14,10,24
"21882","Ryer","M",8,9,17
"21883","Ryett","M",24,33,57
"21884","Ryia","F",5,5,10
"21885","Ryiah","F",8,6,14
"21886","Ryian","F",10,10,20
"21887","Ryilee","F",10,6,16
"21888","Ryin","F",5,6,11
"21889","Rykan","M",6,6,12
"21890","Rykar","M",9,6,15
"21891","Ryken","M",41,41,82
"21892","Ryker","F",49,43,92
"21893","Ryker","M",2758,2779,5537
"21894","Rykker","M",13,10,23
"21895","Ryla","F",25,42,67
"21896","Rylah","F",13,19,32
"21897","Rylan","F",316,371,687
"21898","Rylan","M",1550,1389,2939
"21899","Ryland","F",46,51,97
"21900","Ryland","M",593,592,1185
"21901","Rylann","F",23,39,62
"21902","Ryle","M",5,16,21
"21903","Rylea","F",33,39,72
"21904","Rylee","F",2678,2947,5625
"21905","Rylee","M",173,165,338
"21906","Ryleeann","F",7,8,15
"21907","Rylei","F",72,78,150
"21908","Rylei","M",6,5,11
"21909","Ryleigh","F",1655,1877,3532
"21910","Ryleigh","M",21,10,31
"21911","Rylen","F",59,51,110
"21912","Rylen","M",185,176,361
"21913","Rylend","M",7,6,13
"21914","Ryler","M",27,28,55
"21915","Ryley","F",84,97,181
"21916","Ryley","M",93,73,166
"21917","Ryli","F",24,25,49
"21918","Rylie","F",844,1003,1847
"21919","Rylie","M",21,31,52
"21920","Ryliee","F",8,14,22
"21921","Ryliegh","F",15,22,37
"21922","Rylin","F",94,98,192
"21923","Rylin","M",38,45,83
"21924","Rylinn","F",37,37,74
"21925","Rylon","M",15,23,38
"21926","Rylyn","F",29,24,53
"21927","Rylyn","M",8,10,18
"21928","Rylynn","F",185,207,392
"21929","Rylynn","M",6,9,15
"21930","Rylynne","F",13,6,19
"21931","Ryman","M",15,12,27
"21932","Ryn","F",10,14,24
"21933","Ryna","F",5,8,13
"21934","Ryne","M",34,57,91
"21935","Rynlee","F",11,17,28
"21936","Rynn","F",27,13,40
"21937","Ryo","M",17,16,33
"21938","Ryon","M",25,18,43
"21939","Ryot","M",23,14,37
"21940","Ryota","M",5,5,10
"21941","Ryott","M",9,14,23
"21942","Ryson","M",12,15,27
"21943","Ryu","M",56,72,128
"21944","Ryuu","M",9,6,15
"21945","Ryver","F",22,21,43
"21946","Ryver","M",31,33,64
"21947","Ryze","M",5,6,11
"21948","Ryzen","M",11,19,30
"21949","Saabir","M",8,10,18
"21950","Saachi","F",28,15,43
"21951","Saad","M",77,76,153
"21952","Saadia","F",12,7,19
"21953","Saadiq","M",10,14,24
"21954","Saafir","M",11,13,24
"21955","Saahil","M",12,6,18
"21956","Saahir","M",13,8,21
"21957","Saamiya","F",5,5,10
"21958","Saanvi","F",234,206,440
"21959","Saanvika","F",15,13,28
"21960","Saara","F",12,16,28
"21961","Saarth","M",9,5,14
"21962","Saathvik","M",14,22,36
"21963","Saatvik","M",19,24,43
"21964","Saavi","F",15,11,26
"21965","Saaya","F",12,8,20
"21966","Saba","F",27,34,61
"21967","Sabah","F",9,13,22
"21968","Sabastian","M",94,80,174
"21969","Sabeen","F",6,6,12
"21970","Sabela","F",6,5,11
"21971","Sabella","F",71,83,154
"21972","Saber","M",8,12,20
"21973","Sabian","M",17,15,32
"21974","Sabien","M",5,8,13
"21975","Sabiha","F",9,16,25
"21976","Sabin","M",17,15,32
"21977","Sabina","F",94,106,200
"21978","Sabine","F",95,75,170
"21979","Sabino","M",14,11,25
"21980","Sabir","M",35,31,66
"21981","Sabirin","F",12,11,23
"21982","Sable","F",16,21,37
"21983","Sabra","F",8,6,14
"21984","Sabreen","F",14,23,37
"21985","Sabreena","F",7,6,13
"21986","Sabri","M",7,11,18
"21987","Sabria","F",10,15,25
"21988","Sabrie","F",5,6,11
"21989","Sabriel","F",13,8,21
"21990","Sabrin","F",19,16,35
"21991","Sabrina","F",919,874,1793
"21992","Sabriya","F",10,8,18
"21993","Sabryna","F",9,8,17
"21994","Sacha","F",12,5,17
"21995","Sacha","M",13,21,34
"21996","Sachi","F",29,16,45
"21997","Sachin","M",35,37,72
"21998","Sada","F",11,7,18
"21999","Sadaf","F",13,10,23
"22000","Sadan","F",6,11,17
"22001","Saddie","F",11,12,23
"22002","Sade","F",69,49,118
"22003","Sadee","F",27,27,54
"22004","Sadeem","F",5,5,10
"22005","Sadeen","F",5,8,13
"22006","Sadey","F",13,9,22
"22007","Sadhana","F",10,11,21
"22008","Sadi","F",19,18,37
"22009","Sadia","F",24,24,48
"22010","Sadie","F",4741,4264,9005
"22011","Sadieann","F",6,6,12
"22012","Sadiemae","F",6,12,18
"22013","Sadiq","M",16,25,41
"22014","Sadiyah","F",6,8,14
"22015","Sadler","M",9,11,20
"22016","Sadye","F",9,12,21
"22017","Saeed","M",59,44,103
"22018","Sael","M",7,11,18
"22019","Saelah","F",5,5,10
"22020","Saelor","F",6,5,11
"22021","Saesha","F",12,9,21
"22022","Safa","F",104,102,206
"22023","Safaa","F",27,34,61
"22024","Safal","M",7,14,21
"22025","Safari","F",22,15,37
"22026","Saffron","F",22,30,52
"22027","Safi","M",5,10,15
"22028","Safia","F",61,55,116
"22029","Safia","F",61,6,67
"22030","Safina","F",14,24,38
"22031","Safir","M",5,7,12
"22032","Safira","F",12,13,25
"22033","Safiya","F",68,87,155
"22034","Safiyah","F",29,32,61
"22035","Safwaan","M",5,12,17
"22036","Safwan","M",34,40,74
"22037","Saga","F",6,9,15
"22038","Sagal","F",9,12,21
"22039","Sagan","F",24,26,50
"22040","Sagan","M",56,51,107
"22041","Sagar","M",8,6,14
"22042","Sage","F",882,928,1810
"22043","Sage","M",401,526,927
"22044","Sahaana","F",8,8,16
"22045","Sahaj","M",22,16,38
"22046","Sahal","M",5,10,15
"22047","Sahalie","F",7,8,15
"22048","Sahana","F",120,115,235
"22049","Sahar","F",55,57,112
"22050","Sahara","F",120,102,222
"22051","Sahari","F",11,9,20
"22052","Saharsh","M",27,37,64
"22053","Sahas","M",13,23,36
"22054","Sahasra","F",77,95,172
"22055","Sahej","F",6,6,12
"22056","Sahel","M",5,7,12
"22057","Sahib","F",5,5,10
"22058","Sahib","M",41,32,73
"22059","Sahiba","F",10,8,18
"22060","Sahid","M",13,12,25
"22061","Sahil","M",74,69,143
"22062","Sahily","F",11,11,22
"22063","Sahir","M",47,52,99
"22064","Sahira","F",11,12,23
"22065","Sahmir","M",7,13,20
"22066","Sahory","F",9,6,15
"22067","Sahra","F",18,20,38
"22068","Sai","F",9,11,20
"22069","Sai","M",52,48,100
"22070","Saia","F",6,18,24
"22071","Said","M",82,6,88
"22072","Said","M",82,83,165
"22073","Saida","F",24,18,42
"22074","Saidah","F",6,5,11
"22075","Saidee","F",8,13,21
"22076","Saidy","F",7,9,16
"22077","Saif","M",104,82,186
"22078","Saifan","M",20,21,41
"22079","Saige","F",397,481,878
"22080","Saige","M",20,33,53
"22081","Saila","F",11,9,20
"22082","Sailer","F",6,7,13
"22083","Sailor","F",237,242,479
"22084","Sailor","M",42,48,90
"22085","Saim","M",11,9,20
"22086","Saima","F",9,9,18
"22087","Saina","F",34,24,58
"22088","Saint","M",37,115,152
"22089","Saira","F",72,85,157
"22090","Saish","M",5,8,13
"22091","Saisha","F",30,32,62
"22092","Saiya","F",18,15,33
"22093","Saja","F",37,33,70
"22094","Sajad","M",7,6,13
"22095","Sajan","M",11,10,21
"22096","Sajid","M",16,24,40
"22097","Sajjad","M",7,8,15
"22098","Sakai","M",5,6,11
"22099","Sakari","F",19,14,33
"22100","Sakari","M",10,14,24
"22101","Sakariye","M",5,5,10
"22102","Sakeenah","F",5,5,10
"22103","Saketh","M",24,21,45
"22104","Saki","F",8,5,13
"22105","Sakina","F",34,29,63
"22106","Sakinah","F",12,10,22
"22107","Saksham","M",8,7,15
"22108","Sakshi","F",6,9,15
"22109","Sakura","F",67,60,127
"22110","Salaar","M",7,7,14
"22111","Salah","M",29,29,58
"22112","Salahuddin","M",9,7,16
"22113","Salam","F",7,6,13
"22114","Salam","M",5,6,11
"22115","Salar","M",6,6,12
"22116","Salayah","F",7,11,18
"22117","Saleah","F",16,8,24
"22118","Saleem","M",42,43,85
"22119","Saleen","F",41,29,70
"22120","Saleena","F",8,17,25
"22121","Saleh","M",56,75,131
"22122","Saleha","F",6,6,12
"22123","Salem","F",162,184,346
"22124","Salem","M",139,147,286
"22125","Salena","F",31,25,56
"22126","Salia","F",7,8,15
"22127","Salih","M",25,17,42
"22128","Saliha","F",9,16,25
"22129","Salim","M",51,55,106
"22130","Salima","F",14,8,22
"22131","Salimata","F",8,5,13
"22132","Salina","F",40,34,74
"22133","Salinger","M",5,5,10
"22134","Saliou","M",5,6,11
"22135","Saliyah","F",26,27,53
"22136","Sallie","F",25,29,54
"22137","Sally","F",221,210,431
"22138","Salma","F",351,385,736
"22139","Salmaan","M",17,10,27
"22140","Salman","M",143,142,285
"22141","Saloma","F",13,15,28
"22142","Salome","F",124,120,244
"22143","Salomon","M",69,70,139
"22144","Salsabeel","F",5,7,12
"22145","Salsabil","F",10,6,16
"22146","Salvador","M",421,455,876
"22147","Salvatore","M",215,231,446
"22148","Salwa","F",37,32,69
"22149","Sam","F",12,17,29
"22150","Sam","M",519,474,993
"22151","Sama","F",63,84,147
"22152","Samaa","F",13,8,21
"22153","Samaad","M",6,7,13
"22154","Samad","M",23,14,37
"22155","Samadhi","F",9,6,15
"22156","Samael","M",11,15,26
"22157","Samah","F",6,15,21
"22158","Samai","F",7,10,17
"22159","Samaira","F",78,80,158
"22160","Samaiya","F",13,19,32
"22161","Samaiyah","F",7,6,13
"22162","Samaj","M",21,15,36
"22163","Saman","M",7,5,12
"22164","Samanda","F",5,5,10
"22165","Samani","F",5,7,12
"22166","Samanta","F",27,26,53
"22167","Samantha","F",5331,4924,10255
"22168","Samantha","M",7,5,12
"22169","Samanvi","F",27,26,53
"22170","Samanvitha","F",11,10,21
"22171","Samanyu","M",16,9,25
"22172","Samar","F",28,31,59
"22173","Samar","M",62,67,129
"22174","Samara","F",448,663,1111
"22175","Samarah","F",55,81,136
"22176","Samari","F",35,37,72
"22177","Samari","M",16,22,38
"22178","Samaria","F",92,60,152
"22179","Samariah","F",9,6,15
"22180","Samarion","M",11,14,25
"22181","Samarra","F",7,10,17
"22182","Samarth","M",84,80,164
"22183","Samay","F",5,5,10
"22184","Samay","M",9,17,26
"22185","Samaya","F",117,123,240
"22186","Samayah","F",22,26,48
"22187","Samayra","F",9,13,22
"22188","Samba","M",8,7,15
"22189","Sameeha","F",23,17,40
"22190","Sameer","M",78,66,144
"22191","Sameera","F",32,38,70
"22192","Samera","F",10,17,27
"22193","Samhita","F",17,13,30
"22194","Samhitha","F",13,15,28
"22195","Sami","F",14,22,36
"22196","Sami","M",168,164,332
"22197","Samia","F",119,126,245
"22198","Samiah","F",62,60,122
"22199","Samiha","F",13,12,25
"22200","Samik","M",19,16,35
"22201","Samika","F",11,8,19
"22202","Samiksha","F",6,7,13
"22203","Samil","M",8,10,18
"22204","Samina","F",21,21,42
"22205","Samir","M",331,301,632
"22206","Samira","F",225,238,463
"22207","Samirah","F",55,50,105
"22208","Samiya","F",179,138,317
"22209","Samiyah","F",252,254,506
"22210","Sammantha","F",11,7,18
"22211","Sammi","F",29,26,55
"22212","Sammie","F",34,30,64
"22213","Sammie","M",24,24,48
"22214","Sammuel","M",25,24,49
"22215","Sammy","F",18,21,39
"22216","Sammy","M",126,128,254
"22217","Samone","F",21,17,38
"22218","Samora","F",28,27,55
"22219","Samorah","F",8,5,13
"22220","Sampson","M",56,50,106
"22221","Samraat","M",7,6,13
"22222","Samrat","M",5,7,12
"22223","Samreen","F",18,14,32
"22224","Samreet","F",7,12,19
"22225","Samriddhi","F",11,9,20
"22226","Samridh","M",7,8,15
"22227","Samson","M",430,476,906
"22228","Samual","M",37,31,68
"22229","Samuel","F",12,15,27
"22230","Samuel","M",10832,10492,21324
"22231","Samus","F",7,9,16
"22232","Samvel","M",9,6,15
"22233","Samwise","M",13,10,23
"22234","Samy","M",18,31,49
"22235","Samya","F",58,65,123
"22236","Samyah","F",31,27,58
"22237","Samyar","M",7,11,18
"22238","Samyia","F",16,11,27
"22239","Samyiah","F",9,10,19
"22240","Samyra","F",30,36,66
"22241","Samyrah","F",15,8,23
"22242","Samyukta","F",9,11,20
"22243","Samyuktha","F",8,8,16
"22244","San","F",5,5,10
"22245","San","M",8,5,13
"22246","Sana","F",128,121,249
"22247","Sanaa","F",199,215,414
"22248","Sanad","M",24,27,51
"22249","Sanae","F",5,9,14
"22250","Sanah","F",19,16,35
"22251","Sanai","F",154,161,315
"22252","Sanaii","F",21,11,32
"22253","Sanam","F",18,7,25
"22254","Sanari","F",12,21,33
"22255","Sanav","M",21,11,32
"22256","Sanay","M",9,13,22
"22257","Sanaya","F",113,135,248
"22258","Sanayah","F",13,8,21
"22259","Sanchez","M",10,10,20
"22260","Sander","M",22,30,52
"22261","Sanders","M",12,23,35
"22262","Sandi","F",5,7,12
"22263","Sandor","M",10,11,21
"22264","Sandra","F",337,318,655
"22265","Sandrine","F",6,6,12
"22266","Sandro","M",31,25,56
"22267","Sandy","F",106,86,192
"22268","Sandy","M",9,7,16
"22269","Sanford","M",13,13,26
"22270","Sang","M",5,10,15
"22271","Sani","F",9,14,23
"22272","Sani","M",5,8,13
"22273","Sania","F",49,44,93
"22274","Saniah","F",27,5,32
"22275","Saniah","F",27,32,59
"22276","Sanii","F",7,10,17
"22277","Sanika","F",12,15,27
"22278","Saniya","F",176,191,367
"22279","Saniyah","F",291,233,524
"22280","Sanjana","F",51,31,82
"22281","Sanjay","M",76,44,120
"22282","Sanjeev","M",8,12,20
"22283","Sanjith","M",6,11,17
"22284","Sanna","F",7,13,20
"22285","Sanora","F",6,6,12
"22286","Sansa","F",20,26,46
"22287","Santa","F",11,10,21
"22288","Santana","F",119,111,230
"22289","Santana","M",255,262,517
"22290","Santanna","F",9,10,19
"22291","Santhiago","M",28,29,57
"22292","Santi","M",10,16,26
"22293","Santiago","M",3214,3700,6914
"22294","Santiana","F",5,5,10
"22295","Santiel","M",7,8,15
"22296","Santina","F",8,13,21
"22297","Santino","M",447,435,882
"22298","Santo","M",7,21,28
"22299","Santonio","M",23,19,42
"22300","Santos","M",235,214,449
"22301","Sanvi","F",91,75,166
"22302","Sanvika","F",22,14,36
"22303","Sanvitha","F",7,7,14
"22304","Sanya","F",42,37,79
"22305","Sanyah","F",12,11,23
"22306","Sanyiah","F",8,6,14
"22307","Sanyla","F",9,15,24
"22308","Saoirse","F",159,271,430
"22309","Saori","F",33,36,69
"22310","Saphia","F",7,5,12
"22311","Saphira","F",130,115,245
"22312","Saphire","F",20,21,41
"22313","Saphyra","F",7,6,13
"22314","Saphyre","F",11,5,16
"22315","Sapphira","F",45,50,95
"22316","Sapphire","F",147,165,312
"22317","Saquan","M",7,6,13
"22318","Sara","F",1971,2024,3995
"22319","Sarabella","F",12,7,19
"22320","Sarabeth","F",14,16,30
"22321","Sarabi","F",12,17,29
"22322","Sarae","F",11,9,20
"22323","Sarafina","F",18,24,42
"22324","Sarah","F",4507,4378,8885
"22325","Sarah","M",10,8,18
"22326","Sarahann","F",8,11,19
"22327","Sarahgrace","F",10,9,19
"22328","Sarahi","F",301,231,532
"22329","Sarahjane","F",7,6,13
"22330","Sarahy","F",30,24,54
"22331","Sarai","F",719,641,1360
"22332","Saraia","F",7,5,12
"22333","Saraiah","F",17,11,28
"22334","Saraih","F",12,7,19
"22335","Saraii","F",6,6,12
"22336","Saraiya","F",8,10,18
"22337","Saraiyah","F",7,5,12
"22338","Sarajane","F",5,8,13
"22339","Saralyn","F",16,9,25
"22340","Saralynn","F",7,11,18
"22341","Sarang","F",6,6,12
"22342","Saranya","F",11,6,17
"22343","Saraphina","F",6,9,15
"22344","Saray","F",50,38,88
"22345","Saraya","F",62,48,110
"22346","Sarayah","F",16,43,59
"22347","Sarayu","F",36,31,67
"22348","Sare","F",9,10,19
"22349","Sareen","F",11,8,19
"22350","Sareena","F",6,14,20
"22351","Sarena","F",20,19,39
"22352","Sarenity","F",38,34,72
"22353","Sareya","F",5,5,10
"22354","Sargun","F",12,15,27
"22355","Sari","F",29,22,51
"22356","Sari","M",5,7,12
"22357","Saria","F",33,38,71
"22358","Sariah","F",313,322,635
"22359","Sariel","M",8,7,15
"22360","Sarika","F",6,8,14
"22361","Sarim","M",18,16,34
"22362","Sarina","F",176,126,302
"22363","Sarita","F",19,16,35
"22364","Sariya","F",81,79,160
"22365","Sariyah","F",272,297,569
"22366","Sarkis","M",16,10,26
"22367","Saron","F",43,37,80
"22368","Sarra","F",12,5,17
"22369","Sarrah","F",6,7,13
"22370","Sarrinah","F",11,9,20
"22371","Sartaj","M",13,8,21
"22372","Sarthak","M",21,14,35
"22373","Sarvesh","M",12,12,24
"22374","Sarya","F",8,11,19
"22375","Saryah","F",33,17,50
"22376","Saryiah","F",16,9,25
"22377","Saryn","F",8,6,14
"22378","Sascha","F",16,9,25
"22379","Sasha","F",576,581,1157
"22380","Sasha","M",36,25,61
"22381","Saskia","F",19,27,46
"22382","Satcha","F",7,9,16
"22383","Sathvik","M",36,22,58
"22384","Sativa","F",16,12,28
"22385","Satori","F",16,10,26
"22386","Satvik","M",19,27,46
"22387","Satya","F",18,13,31
"22388","Satya","M",18,16,34
"22389","Saud","M",18,39,57
"22390","Saudia","F",5,8,13
"22391","Saul","M",591,555,1146
"22392","Saulo","M",14,22,36
"22393","Saumya","F",5,5,10
"22394","Saundra","F",5,7,12
"22395","Saurav","M",8,8,16
"22396","Sava","M",6,8,14
"22397","Savage","M",7,8,15
"22398","Savana","F",76,63,139
"22399","Savanah","F",123,115,238
"22400","Savanna","F",628,570,1198
"22401","Savannah","F",5437,5336,10773
"22402","Savant","M",7,5,12
"22403","Savaya","F",8,12,20
"22404","Savayah","F",15,13,28
"22405","Saveah","F",14,17,31
"22406","Saveena","F",7,6,13
"22407","Savera","F",6,7,13
"22408","Saverio","M",14,17,31
"22409","Savi","F",18,17,35
"22410","Savian","M",9,7,16
"22411","Savien","M",5,7,12
"22412","Savina","F",25,29,54
"22413","Savino","M",9,15,24
"22414","Savio","M",10,10,20
"22415","Savion","M",114,93,207
"22416","Savior","M",27,15,42
"22417","Savir","M",10,13,23
"22418","Savon","M",18,22,40
"22419","Savoy","M",6,6,12
"22420","Savreen","F",10,5,15
"22421","Savva","M",9,12,21
"22422","Savvas","M",6,5,11
"22423","Savvy","F",22,29,51
"22424","Saw","M",31,26,57
"22425","Sawda","F",7,6,13
"22426","Sawyer","F",1219,1272,2491
"22427","Sawyer","M",4261,4213,8474
"22428","Saxon","F",5,6,11
"22429","Saxon","M",42,48,90
"22430","Saxton","M",28,28,56
"22431","Say","M",6,5,11
"22432","Saya","F",72,63,135
"22433","Sayan","M",14,13,27
"22434","Sayana","F",8,8,16
"22435","Sayda","F",6,9,15
"22436","Sayde","F",29,15,44
"22437","Saydee","F",86,66,152
"22438","Saydi","F",14,11,25
"22439","Saydie","F",19,24,43
"22440","Sayed","M",16,24,40
"22441","Sayer","M",16,14,30
"22442","Sayge","F",16,24,40
"22443","Sayid","M",11,16,27
"22444","Sayla","F",23,28,51
"22445","Saylah","F",20,12,32
"22446","Saylem","F",7,9,16
"22447","Sayler","F",43,34,77
"22448","Sayler","M",5,9,14
"22449","Saylor","F",478,727,1205
"22450","Saylor","M",37,33,70
"22451","Sayra","F",17,20,37
"22452","Sayuri","F",54,51,105
"22453","Sayvion","M",7,10,17
"22454","Scarlet","F",868,862,1730
"22455","Scarleth","F",29,36,65
"22456","Scarlett","F",7121,7680,14801
"22457","Scarlette","F",361,411,772
"22458","Scarlettrose","F",12,10,22
"22459","Scarlotte","F",6,5,11
"22460","Schneider","M",12,15,27
"22461","Schneur","M",6,9,15
"22462","Schuyler","F",18,22,40
"22463","Schuyler","M",26,25,51
"22464","Schyler","M",6,6,12
"22465","Scot","M",10,8,18
"22466","Scotland","F",30,40,70
"22467","Scotland","M",11,9,20
"22468","Scotlyn","F",64,56,120
"22469","Scotlynn","F",26,31,57
"22470","Scott","M",662,655,1317
"22471","Scotti","F",13,13,26
"22472","Scottie","F",44,53,97
"22473","Scottie","M",18,27,45
"22474","Scottlyn","F",36,28,64
"22475","Scottlynn","F",15,12,27
"22476","Scotty","F",7,6,13
"22477","Scotty","M",39,36,75
"22478","Scout","F",235,230,465
"22479","Scout","M",67,83,150
"22480","Seager","M",5,7,12
"22481","Seamus","M",221,217,438
"22482","Sean","F",6,6,12
"22483","Sean","M",1882,1657,3539
"22484","Seana","F",10,9,19
"22485","Seanna","F",28,26,54
"22486","Seba","F",12,7,19
"22487","Sebashtian","M",8,8,16
"22488","Sebastain","M",16,13,29
"22489","Sebastiaan","M",7,5,12
"22490","Sebastian","F",20,15,35
"22491","Sebastian","M",9601,10249,19850
"22492","Sebastiana","F",5,10,15
"22493","Sebastiano","M",19,16,35
"22494","Sebastien","M",128,117,245
"22495","Sebastion","M",19,9,28
"22496","Sebrina","F",10,8,18
"22497","Secilia","F",9,10,19
"22498","Secret","F",10,13,23
"22499","Sedona","F",69,64,133
"22500","Sedra","F",11,16,27
"22501","Sedric","M",6,8,14
"22502","Sedrick","M",27,17,44
"22503","Seela","F",7,9,16
"22504","Seeley","F",15,15,30
"22505","Seeley","M",37,40,77
"22506","Seema","F",13,9,22
"22507","Seerat","F",33,32,65
"22508","Sefora","F",17,12,29
"22509","Seger","M",10,6,16
"22510","Sehaj","F",20,20,40
"22511","Sehaj","M",14,16,30
"22512","Seham","F",5,7,12
"22513","Sehej","F",7,5,12
"22514","Seher","F",12,6,18
"22515","Seif","M",14,12,26
"22516","Seiji","M",11,7,18
"22517","Sejal","F",15,18,33
"22518","Sekai","M",5,9,14
"22519","Sekou","M",19,24,43
"22520","Sela","F",29,22,51
"22521","Selah","F",682,672,1354
"22522","Seleah","F",5,6,11
"22523","Seleem","M",8,7,15
"22524","Selen","F",6,5,11
"22525","Selena","F",1009,1119,2128
"22526","Selene","F",214,202,416
"22527","Selenia","F",12,11,23
"22528","Seleste","F",13,12,25
"22529","Selia","F",9,10,19
"22530","Selim","M",56,62,118
"22531","Selima","F",5,5,10
"22532","Selin","F",33,32,65
"22533","Selina","F",222,218,440
"22534","Seline","F",8,17,25
"22535","Selma","F",88,95,183
"22536","Selman","M",6,5,11
"22537","Selvin","M",43,30,73
"22538","Selwyn","M",8,6,14
"22539","Sema","F",5,10,15
"22540","Semaj","F",57,55,112
"22541","Semaj","M",199,190,389
"22542","Semaya","F",6,5,11
"22543","Semir","M",10,11,21
"22544","Semira","F",21,24,45
"22545","Semiyah","F",13,9,22
"22546","Sena","F",47,46,93
"22547","Sena","M",9,9,18
"22548","Senai","M",10,6,16
"22549","Senay","M",9,15,24
"22550","Senaya","F",8,5,13
"22551","Sencere","M",9,7,16
"22552","Sender","M",13,6,19
"22553","Seneca","F",32,33,65
"22554","Seneca","M",18,29,47
"22555","Senia","F",6,7,13
"22556","Seniya","F",5,5,10
"22557","Seniyah","F",5,11,16
"22558","Senna","F",39,26,65
"22559","Sephira","F",11,9,20
"22560","Sephora","F",58,40,98
"22561","September","F",29,22,51
"22562","Sequoia","F",73,61,134
"22563","Sequoia","M",13,13,26
"22564","Sera","F",33,24,57
"22565","Serafin","M",19,16,35
"22566","Serafina","F",134,117,251
"22567","Serah","F",27,33,60
"22568","Seraiah","F",8,11,19
"22569","Seraj","M",7,8,15
"22570","Serana","F",6,10,16
"22571","Seraphina","F",203,209,412
"22572","Seraphine","F",25,40,65
"22573","Seras","F",5,8,13
"22574","Seraya","F",7,7,14
"22575","Serayah","F",19,51,70
"22576","Sereen","F",14,25,39
"22577","Seren","F",46,62,108
"22578","Serena","F",778,716,1494
"22579","Serene","F",71,77,148
"22580","Serenidy","F",8,9,17
"22581","Serenitee","F",16,17,33
"22582","Sereniti","F",45,45,90
"22583","Serenitie","F",14,9,23
"22584","Serenity","F",3966,3789,7755
"22585","Serge","M",6,16,22
"22586","Sergei","M",5,8,13
"22587","Sergey","M",14,16,30
"22588","Sergio","M",1040,1038,2078
"22589","Seriah","F",13,13,26
"22590","Serigne","M",10,9,19
"22591","Serin","F",7,5,12
"22592","Serina","F",62,57,119
"22593","Serinity","F",50,45,95
"22594","Seriyah","F",24,24,48
"22595","Serra","F",17,18,35
"22596","Servando","M",28,28,56
"22597","Seryna","F",7,5,12
"22598","Setareh","F",5,29,34
"22599","Setayesh","F",7,12,19
"22600","Seth","M",1339,1147,2486
"22601","Sevan","M",6,9,15
"22602","Sevannah","F",5,6,11
"22603","Sevastian","M",20,14,34
"22604","Seven","F",36,41,77
"22605","Seven","M",67,91,158
"22606","Severiano","M",9,11,20
"22607","Severin","M",26,10,36
"22608","Severo","M",9,8,17
"22609","Severus","M",7,32,39
"22610","Severyn","M",5,5,10
"22611","Sevi","F",5,8,13
"22612","Sevin","M",13,15,28
"22613","Sevyn","F",81,86,167
"22614","Sevyn","M",39,50,89
"22615","Seydina","M",6,5,11
"22616","Seylah","F",11,8,19
"22617","Seynabou","F",5,5,10
"22618","Seyon","M",9,14,23
"22619","Shaan","M",90,102,192
"22620","Shaanvi","F",5,7,12
"22621","Shaarav","M",9,7,16
"22622","Shabazz","M",5,7,12
"22623","Shad","M",26,15,41
"22624","Shaddai","F",9,11,20
"22625","Shaddai","M",7,5,12
"22626","Shade","M",22,14,36
"22627","Shaden","F",10,8,18
"22628","Shaden","M",8,6,14
"22629","Shadia","F",12,13,25
"22630","Shadow","F",10,8,18
"22631","Shadow","M",11,7,18
"22632","Shadrach","M",17,9,26
"22633","Shae","F",128,99,227
"22634","Shae","M",14,14,28
"22635","Shaelan","F",5,6,11
"22636","Shaelee","F",6,10,16
"22637","Shaelyn","F",78,60,138
"22638","Shaelynn","F",57,42,99
"22639","Shafin","M",6,5,11
"22640","Shah","M",11,10,21
"22641","Shahad","F",14,22,36
"22642","Shahan","M",14,12,26
"22643","Shahana","F",8,6,14
"22644","Shahd","F",28,27,55
"22645","Shaheed","M",13,13,26
"22646","Shaheem","M",19,16,35
"22647","Shaheen","M",11,9,20
"22648","Shaheer","M",18,10,28
"22649","Shahid","M",14,11,25
"22650","Shahin","M",8,7,15
"22651","Shahina","F",8,5,13
"22652","Shahir","M",5,8,13
"22653","Shahzaib","M",5,6,11
"22654","Shahzain","M",12,5,17
"22655","Shahzoda","F",6,5,11
"22656","Shai","F",31,29,60
"22657","Shai","M",50,50,100
"22658","Shaila","F",73,66,139
"22659","Shailee","F",15,10,25
"22660","Shailen","M",6,6,12
"22661","Shailene","F",25,22,47
"22662","Shailey","F",15,11,26
"22663","Shaily","F",5,9,14
"22664","Shailyn","F",18,8,26
"22665","Shailynn","F",15,8,23
"22666","Shaima","F",16,17,33
"22667","Shaina","F",78,78,156
"22668","Shaindel","F",25,24,49
"22669","Shaindy","F",65,72,137
"22670","Shaine","M",15,12,27
"22671","Shaira","F",23,19,42
"22672","Shaivi","F",8,6,14
"22673","Shaka","M",5,11,16
"22674","Shakai","M",5,7,12
"22675","Shakayla","F",19,15,34
"22676","Shakeem","M",11,6,17
"22677","Shakir","M",16,17,33
"22678","Shakira","F",56,27,83
"22679","Shakiya","F",8,7,15
"22680","Shakthi","F",13,6,19
"22681","Shakur","M",32,43,75
"22682","Shalaya","F",11,12,23
"22683","Shalayah","F",7,5,12
"22684","Shaleah","F",15,8,23
"22685","Shaleigh","F",7,8,15
"22686","Shalev","M",7,7,14
"22687","Shaliyah","F",13,11,24
"22688","Shalom","F",49,42,91
"22689","Shalom","M",91,75,166
"22690","Shalyn","F",12,8,20
"22691","Shalynn","F",21,11,32
"22692","Sham","F",19,16,35
"22693","Shama","F",5,7,12
"22694","Shamar","M",120,91,211
"22695","Shamara","F",5,11,16
"22696","Shamari","F",17,14,31
"22697","Shamari","M",19,22,41
"22698","Shamarion","M",5,5,10
"22699","Shamaya","F",14,9,23
"22700","Shambhavi","F",5,11,16
"22701","Shameer","M",5,7,12
"22702","Shamel","M",13,11,24
"22703","Shamia","F",17,5,22
"22704","Shamiah","F",13,6,19
"22705","Shamir","M",43,49,92
"22706","Shamira","F",21,13,34
"22707","Shamiya","F",23,20,43
"22708","Shamiyah","F",28,24,52
"22709","Shamon","M",8,5,13
"22710","Shams","F",14,12,26
"22711","Shamsa","F",7,8,15
"22712","Shamus","M",19,24,43
"22713","Shamya","F",24,28,52
"22714","Shamyra","F",9,6,15
"22715","Shan","M",9,27,36
"22716","Shana","F",37,20,57
"22717","Shanae","F",8,7,15
"22718","Shanaya","F",171,234,405
"22719","Shandon","M",5,8,13
"22720","Shane","F",17,17,34
"22721","Shane","M",1210,1058,2268
"22722","Shanel","F",16,29,45
"22723","Shanell","F",41,35,76
"22724","Shanelle","F",53,43,96
"22725","Shani","F",28,16,44
"22726","Shania","F",129,126,255
"22727","Shaniah","F",22,18,40
"22728","Shanice","F",29,27,56
"22729","Shaniece","F",6,7,13
"22730","Shaniya","F",104,90,194
"22731","Shaniyah","F",84,55,139
"22732","Shanley","F",11,7,18
"22733","Shanna","F",17,14,31
"22734","Shannel","F",11,8,19
"22735","Shannon","F",249,193,442
"22736","Shannon","M",82,78,160
"22737","Shant","M",12,11,23
"22738","Shantal","F",20,18,38
"22739","Shantel","F",19,28,47
"22740","Shantell","F",18,11,29
"22741","Shantelle","F",12,11,23
"22742","Shanti","F",33,35,68
"22743","Shanty","F",28,11,39
"22744","Shanvi","F",30,32,62
"22745","Shanvika","F",7,9,16
"22746","Shanya","F",15,24,39
"22747","Shanyah","F",6,5,11
"22748","Shanyia","F",8,7,15
"22749","Shanyla","F",5,12,17
"22750","Shanzay","F",17,14,31
"22751","Shaquan","M",16,11,27
"22752","Shaquille","M",55,53,108
"22753","Sharae","F",7,6,13
"22754","Sharanya","F",23,12,35
"22755","Sharbel","M",13,22,35
"22756","Shareef","M",13,14,27
"22757","Shari","F",11,9,20
"22758","Shariah","F",22,19,41
"22759","Sharif","M",24,28,52
"22760","Shariya","F",14,12,26
"22761","Shariyah","F",19,13,32
"22762","Sharla","F",8,11,19
"22763","Sharleen","F",11,12,23
"22764","Sharlene","F",23,29,52
"22765","Sharlette","F",7,10,17
"22766","Sharlotte","F",13,21,34
"22767","Sharlyn","F",9,6,15
"22768","Sharmarke","M",5,12,17
"22769","Sharod","M",19,15,34
"22770","Sharon","F",275,295,570
"22771","Sharon","M",6,8,14
"22772","Sharrod","M",5,5,10
"22773","Sharvi","F",10,9,19
"22774","Sharvil","M",15,16,31
"22775","Shasta","F",15,8,23
"22776","Shatha","F",6,11,17
"22777","Shaul","M",16,26,42
"22778","Shaun","M",308,241,549
"22779","Shauna","F",29,23,52
"22780","Shaunak","M",6,16,22
"22781","Shaurya","M",102,87,189
"22782","Shavar","M",5,6,11
"22783","Shavon","F",8,5,13
"22784","Shaw","M",31,33,64
"22785","Shawn","F",8,13,21
"22786","Shawn","M",959,939,1898
"22787","Shawna","F",43,41,84
"22788","Shawnee","F",8,11,19
"22789","Shay","F",172,170,342
"22790","Shay","M",60,86,146
"22791","Shaya","F",21,19,40
"22792","Shaya","M",53,78,131
"22793","Shayaan","M",33,48,81
"22794","Shayan","M",74,64,138
"22795","Shayana","F",7,5,12
"22796","Shayanna","F",5,5,10
"22797","Shayda","F",6,5,11
"22798","Shayden","F",8,8,16
"22799","Shayden","M",21,24,45
"22800","Shaye","F",30,22,52
"22801","Shaye","M",14,5,19
"22802","Shayla","F",349,268,617
"22803","Shaylah","F",13,14,27
"22804","Shaylee","F",170,125,295
"22805","Shayleen","F",8,10,18
"22806","Shayleigh","F",33,23,56
"22807","Shaylen","F",15,7,22
"22808","Shaylene","F",19,9,28
"22809","Shayli","F",6,11,17
"22810","Shaylie","F",18,12,30
"22811","Shaylin","F",30,27,57
"22812","Shaylyn","F",33,14,47
"22813","Shaylynn","F",45,50,95
"22814","Shayma","F",8,5,13
"22815","Shaymus","M",7,7,14
"22816","Shayna","F",121,109,230
"22817","Shayne","F",40,35,75
"22818","Shayne","M",89,79,168
"22819","Shayra","F",10,5,15
"22820","Shea","F",189,233,422
"22821","Shea","M",100,99,199
"22822","Shealyn","F",11,12,23
"22823","Shealynn","F",20,13,33
"22824","Sheamus","M",22,22,44
"22825","Shedrick","M",7,13,20
"22826","Sheena","F",28,26,54
"22827","Sheikh","M",17,14,31
"22828","Sheila","F",124,113,237
"22829","Sheily","F",22,17,39
"22830","Shekinah","F",39,34,73
"22831","Shelbee","F",8,6,14
"22832","Shelbi","F",20,17,37
"22833","Shelbie","F",36,31,67
"22834","Shelby","F",1072,978,2050
"22835","Shelby","M",32,36,68
"22836","Sheldon","M",139,131,270
"22837","Shelia","F",11,11,22
"22838","Shellby","F",10,5,15
"22839","Shelley","F",13,17,30
"22840","Shelly","F",44,36,80
"22841","Shelsey","F",5,5,10
"22842","Shelsy","F",14,5,19
"22843","Shelton","M",62,40,102
"22844","Shem","M",17,10,27
"22845","Shemar","M",48,30,78
"22846","Shemuel","M",9,8,17
"22847","Shenouda","M",10,7,17
"22848","Shep","M",9,8,17
"22849","Shepard","M",115,189,304
"22850","Shepherd","M",174,259,433
"22851","Sheppard","M",14,23,37
"22852","Sheri","F",9,7,16
"22853","Sheridan","F",34,36,70
"22854","Sherif","M",5,6,11
"22855","Sherilyn","F",10,7,17
"22856","Sherley","F",5,6,11
"22857","Sherlin","F",20,7,27
"22858","Sherlock","M",9,8,17
"22859","Sherly","F",11,15,26
"22860","Sherlyn","F",222,226,448
"22861","Sherman","M",42,46,88
"22862","Sherri","F",13,16,29
"22863","Sherrie","F",10,11,21
"22864","Sherrod","M",15,16,31
"22865","Sherry","F",78,51,129
"22866","Sherwin","M",14,16,30
"22867","Sherwood","M",5,9,14
"22868","Sheryl","F",17,30,47
"22869","Shevy","F",18,17,35
"22870","Sheyenne","F",8,6,14
"22871","Sheyla","F",87,94,181
"22872","Sheyli","F",8,9,17
"22873","Sheylin","F",11,5,16
"22874","Sheza","F",9,8,17
"22875","Shia","F",27,33,60
"22876","Shia","M",72,71,143
"22877","Shiann","F",16,10,26
"22878","Shianna","F",5,5,10
"22879","Shianne","F",30,32,62
"22880","Shifa","F",13,14,27
"22881","Shifra","F",31,40,71
"22882","Shihab","M",5,7,12
"22883","Shila","F",6,6,12
"22884","Shilah","F",26,10,36
"22885","Shilo","F",20,18,38
"22886","Shilo","M",13,16,29
"22887","Shiloh","F",481,488,969
"22888","Shiloh","M",245,250,495
"22889","Shimon","M",166,173,339
"22890","Shimshon","M",13,12,25
"22891","Shine","F",7,11,18
"22892","Shine","M",7,12,19
"22893","Shiori","F",7,10,17
"22894","Shira","F",75,88,163
"22895","Shireen","F",8,13,21
"22896","Shirel","F",7,9,16
"22897","Shirin","F",23,14,37
"22898","Shirley","F",181,168,349
"22899","Shiv","M",73,82,155
"22900","Shiva","M",7,13,20
"22901","Shivaan","M",8,24,32
"22902","Shivam","M",47,29,76
"22903","Shivani","F",39,44,83
"22904","Shivank","M",6,12,18
"22905","Shivansh","M",42,57,99
"22906","Shiven","M",18,20,38
"22907","Shivin","M",7,8,15
"22908","Shloime","M",27,19,46
"22909","Shloimy","M",20,32,52
"22910","Shlok","M",65,72,137
"22911","Shloka","F",19,21,40
"22912","Shloma","M",26,12,38
"22913","Shlome","M",30,25,55
"22914","Shlomo","M",173,165,338
"22915","Shlomy","M",5,5,10
"22916","Shmiel","M",44,41,85
"22917","Shmuel","M",199,191,390
"22918","Shneur","M",25,16,41
"22919","Sho","M",13,9,22
"22920","Shoaib","M",5,9,14
"22921","Sholom","M",40,39,79
"22922","Shomari","M",11,6,17
"22923","Shon","M",15,15,30
"22924","Shona","F",7,5,12
"22925","Shoni","F",6,6,12
"22926","Shooter","M",12,11,23
"22927","Shoshana","F",112,102,214
"22928","Shoshanna","F",19,24,43
"22929","Shota","M",13,8,21
"22930","Shourya","M",48,45,93
"22931","Shraddha","F",16,10,26
"22932","Shraga","M",23,31,54
"22933","Shravan","M",16,20,36
"22934","Shravya","F",16,9,25
"22935","Shray","M",8,10,18
"22936","Shree","F",19,26,45
"22937","Shreeja","F",7,8,15
"22938","Shreenika","F",6,8,14
"22939","Shreeya","F",22,21,43
"22940","Shreshta","F",10,7,17
"22941","Shresta","F",6,10,16
"22942","Shrey","M",28,32,60
"22943","Shreya","F",168,140,308
"22944","Shreyan","M",40,37,77
"22945","Shreyansh","M",21,31,52
"22946","Shreyas","M",43,32,75
"22947","Shrihaan","M",9,11,20
"22948","Shrihan","M",31,23,54
"22949","Shrinika","F",10,23,33
"22950","Shriram","M",5,5,10
"22951","Shristi","F",15,10,25
"22952","Shrita","F",6,5,11
"22953","Shritha","F",6,5,11
"22954","Shriya","F",73,69,142
"22955","Shriyan","M",28,28,56
"22956","Shriyansh","M",6,6,12
"22957","Shruthi","F",12,12,24
"22958","Shruti","F",23,18,41
"22959","Shterna","F",15,7,22
"22960","Shuaib","M",15,9,24
"22961","Shuayb","M",8,7,15
"22962","Shubh","M",10,13,23
"22963","Shubham","M",10,11,21
"22964","Shukri","F",14,11,25
"22965","Shulamis","F",9,13,22
"22966","Shulem","M",48,52,100
"22967","Shy","F",8,7,15
"22968","Shya","F",5,8,13
"22969","Shyam","M",8,10,18
"22970","Shyann","F",76,69,145
"22971","Shyanna","F",27,22,49
"22972","Shyanne","F",140,101,241
"22973","Shyheim","M",8,5,13
"22974","Shyla","F",158,112,270
"22975","Shylah","F",48,55,103
"22976","Shylee","F",23,13,36
"22977","Shylie","F",6,6,12
"22978","Shylo","F",14,15,29
"22979","Shyloh","F",17,11,28
"22980","Shylynn","F",15,19,34
"22981","Shyne","M",10,10,20
"22982","Shyonna","F",6,7,13
"22983","Shyra","F",6,9,15
"22984","Sia","F",131,126,257
"22985","Siah","F",16,6,22
"22986","Siah","M",21,14,35
"22987","Siahna","F",6,14,20
"22988","Sian","F",12,11,23
"22989","Siana","F",36,31,67
"22990","Siani","F",13,5,18
"22991","Sianna","F",51,46,97
"22992","Siaosi","M",13,7,20
"22993","Siara","F",22,25,47
"22994","Siarra","F",9,5,14
"22995","Sibel","F",8,8,16
"22996","Sibella","F",6,7,13
"22997","Sibley","F",8,8,16
"22998","Sibyl","F",12,19,31
"22999","Sicilia","F",12,11,23
"23000","Sicily","F",57,36,93
"23001","Sid","M",18,16,34
"23002","Siddalee","F",10,11,21
"23003","Siddarth","M",10,12,22
"23004","Siddh","M",10,6,16
"23005","Siddhant","M",26,22,48
"23006","Siddhanth","M",9,5,14
"23007","Siddharth","M",130,129,259
"23008","Siddhartha","M",33,25,58
"23009","Siddhi","F",10,17,27
"23010","Sidharth","M",34,28,62
"23011","Sidnee","F",8,7,15
"23012","Sidney","F",268,258,526
"23013","Sidney","M",180,196,376
"23014","Sidra","F",35,44,79
"23015","Sidrah","F",11,17,28
"23016","Sieanna","F",9,7,16
"23017","Siena","F",445,475,920
"23018","Sienna","F",1436,1365,2801
"23019","Siennah","F",7,5,12
"23020","Sierra","F",790,757,1547
"23021","Sierrah","F",17,7,24
"23022","Sigmund","M",8,10,18
"23023","Signe","F",24,21,45
"23024","Sigrid","F",25,15,40
"23025","Sigurd","M",6,6,12
"23026","Siham","F",48,46,94
"23027","Sila","F",22,22,44
"23028","Silas","F",9,9,18
"23029","Silas","M",3173,3385,6558
"23030","Siler","M",11,10,21
"23031","Silje","F",6,7,13
"23032","Silus","M",15,12,27
"23033","Silva","F",6,6,12
"23034","Silvan","M",6,8,14
"23035","Silvana","F",58,50,108
"23036","Silvanna","F",5,8,13
"23037","Silvano","M",26,14,40
"23038","Silver","F",40,50,90
"23039","Silver","M",9,12,21
"23040","Silverio","M",7,14,21
"23041","Silvestre","M",24,22,46
"23042","Silvia","F",169,169,338
"23043","Silvie","F",7,5,12
"23044","Silvino","M",6,7,13
"23045","Silvio","M",21,28,49
"23046","Sima","F",54,46,100
"23047","Simar","F",14,8,22
"23048","Simara","F",9,6,15
"23049","Simaya","F",5,9,14
"23050","Simcha","M",67,56,123
"23051","Simeon","M",203,199,402
"23052","Simi","F",16,15,31
"23053","Similoluwa","F",5,6,11
"23054","Simiya","F",7,5,12
"23055","Simon","M",1640,1544,3184
"23056","Simona","F",56,58,114
"23057","Simone","F",340,373,713
"23058","Simone","M",8,9,17
"23059","Simonne","F",6,8,14
"23060","Simra","F",23,15,38
"23061","Simrah","F",9,11,20
"23062","Simran","F",71,68,139
"23063","Simrat","F",13,8,21
"23064","Simrin","F",7,6,13
"23065","Sina","F",11,20,31
"23066","Sina","M",7,10,17
"23067","Sinai","F",83,79,162
"23068","Sinan","M",15,10,25
"23069","Sincere","F",55,39,94
"23070","Sincere","M",424,405,829
"23071","Sincerity","F",7,5,12
"23072","Sinclair","F",17,9,26
"23073","Sinclair","M",10,12,22
"23074","Sindy","F",21,11,32
"23075","Sinead","F",10,7,17
"23076","Siniyah","F",7,9,16
"23077","Siobhan","F",56,52,108
"23078","Sion","M",22,18,40
"23079","Siona","F",14,13,27
"23080","Sione","M",29,24,53
"23081","Sir","M",55,50,105
"23082","Sira","F",7,15,22
"23083","Siraj","M",17,27,44
"23084","Sircharles","M",5,5,10
"23085","Sire","M",79,97,176
"23086","Sireen","F",18,15,33
"23087","Sirena","F",44,55,99
"23088","Sirenity","F",8,15,23
"23089","Siri","F",25,24,49
"23090","Siriah","F",6,7,13
"23091","Sirinity","F",5,9,14
"23092","Sirius","M",40,39,79
"23093","Siriyah","F",5,7,12
"23094","Sirr","M",9,6,15
"23095","Sirus","M",8,10,18
"23096","Sisira","F",7,7,14
"23097","Sita","F",9,9,18
"23098","Sitara","F",21,30,51
"23099","Sivan","F",14,11,25
"23100","Sixto","M",13,17,30
"23101","Siya","F",119,163,282
"23102","Siyah","F",22,26,48
"23103","Siyah","M",7,6,13
"23104","Siyana","F",8,11,19
"23105","Siyon","M",8,7,15
"23106","Siyona","F",16,14,30
"23107","Skai","F",57,77,134
"23108","Skailar","F",7,5,12
"23109","Skanda","M",7,15,22
"23110","Skarlet","F",26,24,50
"23111","Skarleth","F",13,8,21
"23112","Skarlett","F",79,86,165
"23113","Skarlette","F",17,26,43
"23114","Ski","F",8,5,13
"23115","Skii","F",6,10,16
"23116","Skilar","F",26,31,57
"23117","Skilyn","F",5,5,10
"23118","Skilynn","F",13,17,30
"23119","Sky","F",367,362,729
"23120","Sky","M",83,85,168
"23121","Skya","F",7,6,13
"23122","Skyah","F",5,11,16
"23123","Skyann","F",7,5,12
"23124","Skyanna","F",6,6,12
"23125","Skyden","M",5,8,13
"23126","Skye","F",855,788,1643
"23127","Skye","M",59,69,128
"23128","Skyelar","F",28,27,55
"23129","Skyelyn","F",6,7,13
"23130","Skyelynn","F",16,22,38
"23131","Skyla","F",557,561,1118
"23132","Skylah","F",171,178,349
"23133","Skylan","F",28,34,62
"23134","Skylan","M",23,20,43
"23135","Skyland","F",5,6,11
"23136","Skylar","F",5271,5099,10370
"23137","Skylar","M",351,317,668
"23138","Skylarr","F",12,14,26
"23139","Skylee","F",125,114,239
"23140","Skyleen","F",7,6,13
"23141","Skylei","F",5,5,10
"23142","Skyleigh","F",40,38,78
"23143","Skylen","F",12,11,23
"23144","Skyler","F",1114,905,2019
"23145","Skyler","M",909,762,1671
"23146","Skylette","F",7,8,15
"23147","Skyley","F",6,6,12
"23148","Skylie","F",38,38,76
"23149","Skylin","F",75,58,133
"23150","Skylin","M",10,7,17
"23151","Skylinn","F",15,12,27
"23152","Skyllar","F",8,8,16
"23153","Skylor","F",14,10,24
"23154","Skylor","M",18,12,30
"23155","Skylyn","F",61,49,110
"23156","Skylynn","F",188,176,364
"23157","Skylynne","F",11,10,21
"23158","Skyrah","F",11,21,32
"23159","Slade","M",157,187,344
"23160","Sladen","M",6,7,13
"23161","Slate","M",34,43,77
"23162","Slater","M",49,55,104
"23163","Slayde","M",14,18,32
"23164","Slayden","M",15,15,30
"23165","Slayter","M",8,12,20
"23166","Slayton","M",14,22,36
"23167","Slevin","M",6,5,11
"23168","Sloan","F",405,514,919
"23169","Sloan","M",55,73,128
"23170","Sloane","F",998,1184,2182
"23171","Sloka","F",15,23,38
"23172","Smaran","M",16,7,23
"23173","Smayan","M",9,9,18
"23174","Smera","F",7,8,15
"23175","Smith","F",11,12,23
"23176","Smith","M",154,162,316
"23177","Smrithi","F",6,7,13
"23178","Smriti","F",14,13,27
"23179","Snayder","M",9,7,16
"23180","Sneha","F",20,18,38
"23181","Sneijder","M",18,8,26
"23182","Sneyder","M",12,11,23
"23183","Snigdha","F",8,7,15
"23184","Snow","F",59,55,114
"23185","Snyder","M",21,13,34
"23186","Socorro","F",8,6,14
"23187","Soffia","F",12,6,18
"23188","Sofi","F",33,28,61
"23189","Sofia","F",9681,9134,18815
"23190","Sofia","M",9,8,17
"23191","Sofiagrace","F",5,6,11
"23192","Sofiah","F",20,14,34
"23193","Sofie","F",172,191,363
"23194","Sofija","F",21,15,36
"23195","Sofiya","F",49,53,102
"23196","Sofya","F",11,10,21
"23197","Soha","F",37,26,63
"23198","Sohaib","M",5,9,14
"23199","Sohail","M",7,13,20
"23200","Soham","M",32,36,68
"23201","Sohan","M",25,34,59
"23202","Sohana","F",11,11,22
"23203","Sohum","M",30,22,52
"23204","Sojourner","F",5,6,11
"23205","Sokhna","F",9,14,23
"23206","Sol","F",87,91,178
"23207","Sol","M",48,59,107
"23208","Solace","F",16,8,24
"23209","Solace","M",7,10,17
"23210","Solan","M",12,6,18
"23211","Solana","F",66,44,110
"23212","Solange","F",35,32,67
"23213","Solara","F",31,35,66
"23214","Sole","F",9,13,22
"23215","Soledad","F",29,27,56
"23216","Solei","F",24,20,44
"23217","Soleil","F",113,137,250
"23218","Solene","F",8,31,39
"23219","Soley","F",6,9,15
"23220","Soliana","F",54,44,98
"23221","Soliman","M",9,5,14
"23222","Solimar","F",5,12,17
"23223","Soliyana","F",15,13,28
"23224","Solo","M",7,5,12
"23225","Soloman","M",15,16,31
"23226","Solomia","F",18,19,37
"23227","Solomiya","F",11,9,20
"23228","Solomon","M",866,890,1756
"23229","Solon","M",8,8,16
"23230","Solveig","F",21,22,43
"23231","Solyana","F",7,7,14
"23232","Solymar","F",6,7,13
"23233","Soma","M",9,9,18
"23234","Somaya","F",35,30,65
"23235","Somer","F",9,8,17
"23236","Sommer","F",34,16,50
"23237","Somtochukwu","M",9,5,14
"23238","Sona","F",23,27,50
"23239","Sonakshi","F",5,6,11
"23240","Sonali","F",17,23,40
"23241","Sonam","F",16,19,35
"23242","Sonaya","F",5,5,10
"23243","Sondos","F",7,8,15
"23244","Sondra","F",6,7,13
"23245","Sonia","F",245,259,504
"23246","Soniah","F",5,5,10
"23247","Soniya","F",14,13,27
"23248","Soniyah","F",9,5,14
"23249","Sonja","F",85,91,176
"23250","Sonnet","F",12,9,21
"23251","Sonni","F",10,14,24
"23252","Sonnie","F",11,12,23
"23253","Sonnie","M",6,9,15
"23254","Sonny","F",26,18,44
"23255","Sonny","M",274,266,540
"23256","Sonoma","F",14,10,24
"23257","Sonora","F",37,43,80
"23258","Sonya","F",164,133,297
"23259","Sookie","F",8,5,13
"23260","Sophea","F",7,19,26
"23261","Sophee","F",11,18,29
"23262","Sophi","F",17,16,33
"23263","Sophia","F",17381,16070,33451
"23264","Sophia","M",14,17,31
"23265","Sophiagrace","F",21,14,35
"23266","Sophiah","F",23,9,32
"23267","Sophiamarie","F",9,12,21
"23268","Sophiana","F",6,12,18
"23269","Sophiarose","F",13,12,25
"23270","Sophie","F",2931,2851,5782
"23271","Sophiea","F",8,6,14
"23272","Sophina","F",19,14,33
"23273","Sophira","F",7,7,14
"23274","Sophiya","F",15,20,35
"23275","Sophonie","F",5,5,10
"23276","Sophronia","F",6,7,13
"23277","Sophy","F",15,18,33
"23278","Sophya","F",38,37,75
"23279","Sora","F",53,48,101
"23280","Sora","M",31,24,55
"23281","Soraiya","F",14,7,21
"23282","Soraya","F",200,197,397
"23283","Sorayah","F",9,14,23
"23284","Sorcha","F",7,9,16
"23285","Soren","F",34,31,65
"23286","Soren","M",486,494,980
"23287","Soriah","F",15,19,34
"23288","Sorin","M",18,21,39
"23289","Soriya","F",15,15,30
"23290","Soriyah","F",8,5,13
"23291","Sorren","M",5,11,16
"23292","Sosa","M",5,6,11
"23293","Sosefina","F",6,7,13
"23294","Sota","M",22,15,37
"23295","Soul","F",9,9,18
"23296","Soul","M",9,10,19
"23297","Souleymane","M",10,14,24
"23298","Southern","F",9,6,15
"23299","Sovereign","M",7,9,16
"23300","Sparkle","F",6,6,12
"23301","Sparrow","F",55,64,119
"23302","Sparrow","M",8,9,17
"23303","Sparsh","M",6,21,27
"23304","Spence","M",7,9,16
"23305","Spencer","F",238,244,482
"23306","Spencer","M",1429,1357,2786
"23307","Spirit","F",30,19,49
"23308","Spring","F",22,15,37
"23309","Spruha","F",10,10,20
"23310","Sravya","F",5,5,10
"23311","Sreeja","F",9,6,15
"23312","Sreenidhi","F",5,5,10
"23313","Sreenika","F",8,7,15
"23314","Sreshta","F",15,16,31
"23315","Sreya","F",9,8,17
"23316","Srihaan","M",11,11,22
"23317","Srihan","M",23,43,66
"23318","Srihari","M",10,5,15
"23319","Srihith","M",5,6,11
"23320","Srihitha","F",9,6,15
"23321","Srija","F",8,5,13
"23322","Srijan","M",9,6,15
"23323","Srikar","M",14,8,22
"23324","Sriman","M",10,7,17
"23325","Srinidhi","F",19,12,31
"23326","Srinika","F",43,27,70
"23327","Srinivas","M",5,5,10
"23328","Sriram","M",24,25,49
"23329","Sristi","F",6,5,11
"23330","Sritha","F",16,13,29
"23331","Sriya","F",16,25,41
"23332","Sriyan","M",23,38,61
"23333","Sriyansh","M",9,12,21
"23334","Sruly","M",9,6,15
"23335","Sruthi","F",7,5,12
"23336","Stacey","F",101,119,220
"23337","Stacey","M",16,18,34
"23338","Staci","F",8,9,17
"23339","Stacia","F",14,11,25
"23340","Stacie","F",31,23,54
"23341","Stacy","F",205,204,409
"23342","Stacy","M",27,24,51
"23343","Stafford","M",14,12,26
"23344","Staley","F",8,12,20
"23345","Stalin","M",6,5,11
"23346","Stan","M",13,15,28
"23347","Stanford","M",18,12,30
"23348","Stanislav","M",12,12,24
"23349","Stanlee","M",10,5,15
"23350","Stanley","M",363,364,727
"23351","Stanton","M",28,43,71
"23352","Star","F",92,91,183
"23353","Star","M",5,5,10
"23354","Stark","M",16,18,34
"23355","Starla","F",50,38,88
"23356","Starlet","F",15,12,27
"23357","Starlett","F",15,10,25
"23358","Starlette","F",6,10,16
"23359","Starling","F",12,5,17
"23360","Starlyn","F",10,7,17
"23361","Starlynn","F",19,16,35
"23362","Starr","F",73,55,128
"23363","Stasia","F",8,9,17
"23364","Stassi","F",26,27,53
"23365","Statham","M",5,6,11
"23366","Stavros","M",21,16,37
"23367","Stedman","M",6,8,14
"23368","Steel","M",33,52,85
"23369","Steele","F",11,7,18
"23370","Steele","M",100,134,234
"23371","Stefan","M",291,263,554
"23372","Stefani","F",31,24,55
"23373","Stefania","F",46,49,95
"23374","Stefanie","F",49,47,96
"23375","Stefanny","F",6,7,13
"23376","Stefano","M",51,61,112
"23377","Stefanos","M",15,11,26
"23378","Stefany","F",96,77,173
"23379","Stefen","M",22,17,39
"23380","Steffan","M",14,17,31
"23381","Steffen","M",14,12,26
"23382","Steffon","M",6,8,14
"23383","Stefon","M",13,18,31
"23384","Steisy","F",6,6,12
"23385","Stela","F",10,11,21
"23386","Stella","F",4786,4912,9698
"23387","Stellah","F",14,12,26
"23388","Stellaluna","F",5,8,13
"23389","Stellan","M",92,77,169
"23390","Stellar","F",6,6,12
"23391","Stellarose","F",12,13,25
"23392","Stepan","M",9,13,22
"23393","Stephan","M",166,174,340
"23394","Stephani","F",17,13,30
"23395","Stephania","F",30,25,55
"23396","Stephanie","F",1558,1366,2924
"23397","Stephano","M",14,13,27
"23398","Stephany","F",155,111,266
"23399","Stephen","M",1485,1367,2852
"23400","Stephenie","F",7,17,24
"23401","Stephon","M",107,111,218
"23402","Sterlin","M",10,5,15
"23403","Sterling","F",84,132,216
"23404","Sterling","M",593,661,1254
"23405","Stetson","M",306,344,650
"23406","Stevan","M",28,26,54
"23407","Steve","M",224,205,429
"23408","Stevee","F",6,9,15
"23409","Steven","M",2698,2381,5079
"23410","Stevens","M",5,6,11
"23411","Stevenson","M",14,13,27
"23412","Stevi","F",21,18,39
"23413","Stevie","F",273,343,616
"23414","Stevie","M",36,34,70
"23415","Stevon","M",7,5,12
"23416","Stewart","M",54,32,86
"23417","Stihl","M",12,8,20
"23418","Stiles","M",44,59,103
"23419","Stirling","M",24,21,45
"23420","Stiven","M",9,12,21
"23421","Stockton","M",54,59,113
"23422","Stokely","M",11,9,20
"23423","Stone","F",7,8,15
"23424","Stone","M",156,177,333
"23425","Stoney","F",5,5,10
"23426","Stoney","M",10,14,24
"23427","Stori","F",28,25,53
"23428","Storie","F",22,22,44
"23429","Storm","F",76,85,161
"23430","Storm","M",63,88,151
"23431","Stormee","F",5,10,15
"23432","Stormi","F",34,30,64
"23433","Stormie","F",68,79,147
"23434","Stormy","F",125,125,250
"23435","Stormy","M",7,9,16
"23436","Story","F",68,68,136
"23437","Stran","M",6,6,12
"23438","Stratton","M",52,44,96
"23439","Strider","M",22,19,41
"23440","Striker","M",7,8,15
"23441","Stryder","M",43,33,76
"23442","Stryker","M",104,86,190
"23443","Stuart","M",84,59,143
"23444","Stuti","F",10,10,20
"23445","Styles","M",23,26,49
"23446","Su","F",15,10,25
"23447","Sua","F",6,11,17
"23448","Suad","F",10,6,16
"23449","Subhan","M",35,43,78
"23450","Success","F",9,7,16
"23451","Success","M",5,7,12
"23452","Sudais","M",42,33,75
"23453","Sudeys","M",5,8,13
"23454","Sudiksha","F",5,5,10
"23455","Sue","F",13,12,25
"23456","Sueann","F",5,5,10
"23457","Suetta","F",5,5,10
"23458","Sufian","M",13,11,24
"23459","Sufyaan","M",9,8,17
"23460","Sufyan","M",29,17,46
"23461","Sugey","F",9,5,14
"23462","Suha","F",9,8,17
"23463","Suhaan","M",13,13,26
"23464","Suhaas","M",7,5,12
"23465","Suhaib","M",26,32,58
"23466","Suhail","M",13,19,32
"23467","Suhaila","F",14,8,22
"23468","Suhailah","F",9,7,16
"23469","Suhan","M",10,8,18
"23470","Suhana","F",22,32,54
"23471","Suhani","F",41,28,69
"23472","Suhas","M",9,12,21
"23473","Suhavi","F",7,10,17
"23474","Suhayb","M",17,23,40
"23475","Suhayla","F",26,27,53
"23476","Suhaylah","F",25,21,46
"23477","Suhey","F",6,7,13
"23478","Suheyla","F",11,9,20
"23479","Sui","F",10,12,22
"23480","Sujay","M",5,5,10
"23481","Sujey","F",14,7,21
"23482","Sukaina","F",8,12,20
"23483","Sukayna","F",5,6,11
"23484","Sukhman","F",5,6,11
"23485","Sukhmani","F",11,16,27
"23486","Suki","F",11,14,25
"23487","Sula","F",10,6,16
"23488","Sulaiman","M",68,77,145
"23489","Sulamita","F",7,5,12
"23490","Sulayman","M",23,36,59
"23491","Suleiman","M",46,43,89
"23492","Sulema","F",15,9,24
"23493","Suleman","M",7,15,22
"23494","Suleyman","M",12,20,32
"23495","Suliman","M",13,12,25
"23496","Sullivan","F",70,80,150
"23497","Sullivan","M",663,777,1440
"23498","Sully","M",17,21,38
"23499","Sultan","M",69,97,166
"23500","Sultana","F",9,10,19
"23501","Sumaiya","F",25,14,39
"23502","Sumaiyah","F",9,7,16
"23503","Sumaya","F",105,109,214
"23504","Sumayah","F",15,10,25
"23505","Sumedh","M",6,9,15
"23506","Sumedha","F",5,5,10
"23507","Sumer","F",8,6,14
"23508","Sumeya","F",14,11,25
"23509","Sumire","F",9,8,17
"23510","Summer","F",1678,1590,3268
"23511","Summer","M",8,6,14
"23512","Summerlyn","F",8,8,16
"23513","Summerlynn","F",6,6,12
"23514","Summerrose","F",7,7,14
"23515","Summit","F",10,11,21
"23516","Summit","M",42,41,83
"23517","Sumner","M",16,10,26
"23518","Sun","M",8,10,18
"23519","Sundai","F",7,5,12
"23520","Sunday","F",26,34,60
"23521","Sundus","F",29,23,52
"23522","Sunil","M",6,6,12
"23523","Sunjai","F",27,14,41
"23524","Sunni","F",38,29,67
"23525","Sunnie","F",44,31,75
"23526","Sunniva","F",10,9,19
"23527","Sunny","F",218,209,427
"23528","Sunny","M",72,71,143
"23529","Sunshine","F",57,50,107
"23530","Supreme","M",11,19,30
"23531","Supriya","F",8,6,14
"23532","Sura","F",23,18,41
"23533","Surah","F",26,11,37
"23534","Suraiya","F",16,8,24
"23535","Suraj","M",16,16,32
"23536","Suraya","F",32,21,53
"23537","Suren","M",9,8,17
"23538","Suri","F",150,131,281
"23539","Suriah","F",7,5,12
"23540","Surina","F",11,14,25
"23541","Suriya","F",9,10,19
"23542","Suriyah","F",9,10,19
"23543","Surveen","F",5,10,15
"23544","Sury","F",63,60,123
"23545","Surya","F",10,8,18
"23546","Surya","M",51,49,100
"23547","Suryansh","M",8,6,14
"23548","Susan","F",293,296,589
"23549","Susana","F",124,113,237
"23550","Susanna","F",195,191,386
"23551","Susannah","F",81,93,174
"23552","Susie","F",94,83,177
"23553","Susy","F",5,9,14
"23554","Sutter","F",8,5,13
"23555","Sutter","M",41,44,85
"23556","Sutton","F",423,430,853
"23557","Sutton","M",217,245,462
"23558","Suttyn","F",14,17,31
"23559","Suvan","M",7,8,15
"23560","Suvi","F",14,11,25
"23561","Suvir","M",6,9,15
"23562","Suyash","M",7,6,13
"23563","Suzan","F",10,7,17
"23564","Suzana","F",9,14,23
"23565","Suzanna","F",62,59,121
"23566","Suzannah","F",17,21,38
"23567","Suzanne","F",77,67,144
"23568","Suzette","F",49,39,88
"23569","Suzi","F",6,6,12
"23570","Suzie","F",26,31,57
"23571","Suzy","F",17,20,37
"23572","Svara","F",6,6,12
"23573","Svea","F",30,41,71
"23574","Sven","M",58,36,94
"23575","Svetlana","F",26,20,46
"23576","Swara","F",78,70,148
"23577","Sway","F",9,6,15
"23578","Swayze","F",46,47,93
"23579","Swayze","M",16,13,29
"23580","Swayzee","F",20,18,38
"23581","Swayzie","F",16,18,34
"23582","Sweden","F",8,5,13
"23583","Sy","M",10,15,25
"23584","Sya","F",6,5,11
"23585","Syah","F",5,9,14
"23586","Syair","M",10,15,25
"23587","Syaire","M",15,24,39
"23588","Sybella","F",13,11,24
"23589","Sybil","F",90,105,195
"23590","Syd","M",8,5,13
"23591","Sydnee","F",95,105,200
"23592","Sydnei","F",14,12,26
"23593","Sydney","F",2653,2309,4962
"23594","Sydney","M",49,46,95
"23595","Sydni","F",42,40,82
"23596","Sydnie","F",33,35,68
"23597","Syed","M",160,157,317
"23598","Syeda","F",54,61,115
"23599","Syenna","F",5,8,13
"23600","Syhir","M",6,5,11
"23601","Syier","M",8,5,13
"23602","Syire","M",5,8,13
"23603","Syla","F",10,10,20
"23604","Sylar","F",6,6,12
"23605","Sylar","M",54,67,121
"23606","Sylas","M",437,409,846
"23607","Syleena","F",7,5,12
"23608","Syler","M",34,30,64
"23609","Sylis","M",61,74,135
"23610","Sylus","M",62,70,132
"23611","Sylvan","M",25,42,67
"23612","Sylvana","F",19,15,34
"23613","Sylvanna","F",7,11,18
"23614","Sylver","F",7,9,16
"23615","Sylvester","M",73,66,139
"23616","Sylvi","F",17,20,37
"23617","Sylvia","F",658,614,1272
"23618","Sylvie","F",214,282,496
"23619","Symiah","F",8,6,14
"23620","Symir","M",18,9,27
"23621","Symon","M",14,11,25
"23622","Symone","F",52,65,117
"23623","Symphani","F",6,5,11
"23624","Symphanie","F",8,5,13
"23625","Symphany","F",11,6,17
"23626","Symphoni","F",14,10,24
"23627","Symphonie","F",9,9,18
"23628","Symphony","F",143,135,278
"23629","Synai","F",6,11,17
"23630","Syncere","F",28,25,53
"23631","Syncere","M",116,116,232
"23632","Syniah","F",20,21,41
"23633","Synthia","F",8,15,23
"23634","Syon","M",16,21,37
"23635","Syra","F",10,10,20
"23636","Syrai","F",11,11,22
"23637","Syre","M",15,15,30
"23638","Syren","F",13,8,21
"23639","Syrena","F",15,17,32
"23640","Syrenity","F",13,11,24
"23641","Syria","F",13,9,22
"23642","Syriah","F",30,31,61
"23643","Syris","M",18,12,30
"23644","Syrus","M",73,70,143
"23645","Szymon","M",14,10,24
"23646","Taaliah","F",9,5,14
"23647","Taaliyah","F",12,10,22
"23648","Taara","F",8,11,19
"23649","Taariq","M",6,6,12
"23650","Taavi","M",20,15,35
"23651","Tabatha","F",26,16,42
"23652","Tabias","M",20,23,43
"23653","Tabitha","F",286,289,575
"23654","Tabor","M",24,19,43
"23655","Tacari","M",8,14,22
"23656","Tad","M",14,18,32
"23657","Tadashi","M",14,13,27
"23658","Taden","M",10,12,22
"23659","Tadeo","M",187,221,408
"23660","Tadhg","M",17,28,45
"23661","Tae","M",9,7,16
"23662","Taeden","M",5,20,25
"23663","Taedyn","M",6,9,15
"23664","Taegan","F",45,50,95
"23665","Taegan","M",14,14,28
"23666","Taelin","M",5,6,11
"23667","Taelor","F",39,26,65
"23668","Taelyn","F",135,115,250
"23669","Taelyn","M",11,11,22
"23670","Taelynn","F",107,98,205
"23671","Taeshawn","M",8,8,16
"23672","Taetum","F",9,9,18
"23673","Taeveon","M",10,7,17
"23674","Taevion","M",24,18,42
"23675","Taevon","M",10,15,25
"23676","Taevyn","M",7,8,15
"23677","Taeya","F",10,8,18
"23678","Tafari","M",22,39,61
"23679","Taft","M",21,22,43
"23680","Tag","M",8,5,13
"23681","Tage","M",14,19,33
"23682","Tagen","M",9,6,15
"23683","Taggart","M",24,23,47
"23684","Taha","M",75,79,154
"23685","Tahani","F",7,25,32
"23686","Tahari","F",11,12,23
"23687","Taheem","M",7,8,15
"23688","Tahir","M",43,46,89
"23689","Tahira","F",22,22,44
"23690","Tahirah","F",14,10,24
"23691","Tahiri","F",10,15,25
"23692","Tahiry","F",50,48,98
"23693","Tahj","F",6,6,12
"23694","Tahj","M",137,125,262
"23695","Tahlia","F",132,138,270
"23696","Tahmeed","M",6,8,14
"23697","Tahmid","M",14,14,28
"23698","Tai","F",16,16,32
"23699","Tai","M",58,58,116
"23700","Taia","F",12,6,18
"23701","Taiden","M",61,56,117
"23702","Taiga","M",19,10,29
"23703","Taige","F",5,6,11
"23704","Taija","F",9,6,15
"23705","Taila","F",14,5,19
"23706","Tailor","F",14,10,24
"23707","Tailyn","F",32,41,73
"23708","Tailynn","F",45,44,89
"23709","Taim","M",43,43,86
"23710","Taimane","F",11,6,17
"23711","Taina","F",22,19,41
"23712","Taisei","M",12,5,17
"23713","Taisha","F",13,10,23
"23714","Taisley","F",15,19,34
"23715","Taison","M",9,6,15
"23716","Tait","M",14,14,28
"23717","Taiten","M",6,5,11
"23718","Taitum","F",18,18,36
"23719","Taiven","M",5,7,12
"23720","Taiwan","M",6,8,14
"23721","Taiwo","M",7,5,12
"23722","Taiya","F",22,10,32
"23723","Taiyo","M",12,14,26
"23724","Taj","F",18,11,29
"23725","Taj","M",200,163,363
"23726","Tajai","M",5,5,10
"23727","Tajh","M",12,11,23
"23728","Taji","M",13,14,27
"23729","Tajuan","M",7,6,13
"23730","Takai","M",15,16,31
"23731","Takara","F",14,12,26
"23732","Takari","M",9,15,24
"23733","Takayla","F",12,13,25
"23734","Takeo","M",9,13,22
"23735","Takeshi","M",10,7,17
"23736","Takiya","F",13,13,26
"23737","Takiyah","F",8,17,25
"23738","Takoda","M",51,40,91
"23739","Takota","M",6,12,18
"23740","Taksh","M",9,8,17
"23741","Takumi","M",9,17,26
"23742","Tal","M",16,11,27
"23743","Tala","F",117,132,249
"23744","Talah","F",8,5,13
"23745","Talaiyah","F",7,5,12
"23746","Talal","M",25,26,51
"23747","Talan","M",77,90,167
"23748","Talasia","F",10,8,18
"23749","Talaya","F",30,29,59
"23750","Talayah","F",48,43,91
"23751","Talayla","F",6,5,11
"23752","Talaysia","F",17,25,42
"23753","Talea","F",17,18,35
"23754","Taleah","F",84,111,195
"23755","Taleen","F",43,63,106
"23756","Taleeya","F",6,7,13
"23757","Taleigh","F",7,6,13
"23758","Taleigha","F",18,12,30
"23759","Talen","M",58,41,99
"23760","Talena","F",8,10,18
"23761","Taleya","F",9,9,18
"23762","Taleyah","F",17,12,29
"23763","Talha","M",31,27,58
"23764","Tali","F",38,35,73
"23765","Talia","F",1119,1052,2171
"23766","Taliah","F",141,117,258
"23767","Taliana","F",19,14,33
"23768","Talianna","F",5,5,10
"23769","Talib","M",25,22,47
"23770","Taliesin","M",5,6,11
"23771","Talin","M",33,32,65
"23772","Talina","F",10,14,24
"23773","Taline","F",12,11,23
"23774","Talion","M",5,6,11
"23775","Talisa","F",11,8,19
"23776","Talise","F",10,8,18
"23777","Talisha","F",13,11,24
"23778","Talitha","F",55,43,98
"23779","Taliya","F",27,40,67
"23780","Taliyah","F",355,350,705
"23781","Tallen","M",24,23,47
"23782","Talley","F",8,8,16
"23783","Tallia","F",7,13,20
"23784","Tallie","F",11,10,21
"23785","Tallon","M",38,29,67
"23786","Tallulah","F",158,150,308
"23787","Tallyn","F",5,5,10
"23788","Tallyn","M",6,6,12
"23789","Talmadge","M",13,7,20
"23790","Talmage","M",23,29,52
"23791","Talon","F",11,10,21
"23792","Talon","M",438,402,840
"23793","Talula","F",14,9,23
"23794","Talulah","F",17,21,38
"23795","Talulla","F",9,9,18
"23796","Talullah","F",7,9,16
"23797","Talya","F",103,90,193
"23798","Talyah","F",17,16,33
"23799","Talyn","F",29,32,61
"23800","Talyn","M",38,27,65
"23801","Talynn","F",31,28,59
"23802","Tam","F",9,11,20
"23803","Tam","M",10,10,20
"23804","Tamani","F",10,5,15
"23805","Tamanna","F",6,6,12
"23806","Tamar","F",82,83,165
"23807","Tamar","M",7,11,18
"23808","Tamara","F",179,150,329
"23809","Tamarah","F",9,8,17
"23810","Tamari","F",30,18,48
"23811","Tamari","M",11,11,22
"23812","Tamarion","M",12,19,31
"23813","Tamaya","F",21,20,41
"23814","Tameem","M",32,22,54
"23815","Tamem","M",6,6,12
"23816","Tamer","M",8,11,19
"23817","Tamera","F",47,55,102
"23818","Tami","F",8,8,16
"23819","Tamia","F",246,230,476
"23820","Tamiah","F",17,25,42
"23821","Tamila","F",5,7,12
"23822","Tamim","M",49,56,105
"23823","Tamina","F",6,6,12
"23824","Tamir","M",61,67,128
"23825","Tamira","F",15,15,30
"23826","Tamiya","F",49,34,83
"23827","Tamiyah","F",40,41,81
"23828","Tammie","F",6,7,13
"23829","Tammy","F",44,62,106
"23830","Tamra","F",10,7,17
"23831","Tamryn","F",14,20,34
"23832","Tamsin","F",22,23,45
"23833","Tamsyn","F",14,15,29
"23834","Tamya","F",46,30,76
"23835","Tamyah","F",10,19,29
"23836","Tamyra","F",15,12,27
"23837","Tamzin","F",7,8,15
"23838","Tamzyn","F",10,8,18
"23839","Tana","F",16,17,33
"23840","Tanasia","F",5,7,12
"23841","Tanay","F",7,6,13
"23842","Tanay","M",26,32,58
"23843","Tanaya","F",23,29,52
"23844","Taner","M",5,5,10
"23845","Tania","F",154,153,307
"23846","Taniah","F",18,15,33
"23847","Tanis","M",9,7,16
"23848","Tanish","M",25,13,38
"23849","Tanisha","F",53,44,97
"23850","Tanishi","F",7,14,21
"23851","Tanishka","F",23,34,57
"23852","Tanishq","M",6,5,11
"23853","Taniya","F",85,62,147
"23854","Taniyah","F",118,95,213
"23855","Tank","M",12,6,18
"23856","Tannen","M",6,6,12
"23857","Tanner","F",69,55,124
"23858","Tanner","M",1710,1595,3305
"23859","Tannon","M",6,6,12
"23860","Tansy","F",6,7,13
"23861","Tanush","M",30,24,54
"23862","Tanveer","M",8,6,14
"23863","Tanvi","F",110,103,213
"23864","Tanvika","F",10,10,20
"23865","Tanvir","M",9,9,18
"23866","Tanya","F",105,92,197
"23867","Tanyah","F",7,5,12
"23868","Tanyia","F",8,6,14
"23869","Tanyla","F",13,13,26
"23870","Tanylah","F",5,7,12
"23871","Tanzila","F",7,6,13
"23872","Tao","M",15,16,31
"23873","Taos","M",15,7,22
"23874","Taquan","M",12,8,20
"23875","Tara","F",301,262,563
"23876","Tarah","F",20,18,38
"23877","Taraj","M",7,5,12
"23878","Taraji","F",230,145,375
"23879","Taralyn","F",6,6,12
"23880","Taralynn","F",15,6,21
"23881","Taran","M",45,31,76
"23882","Taraoluwa","F",18,14,32
"23883","Taras","M",5,6,11
"23884","Tarek","M",46,48,94
"23885","Tarell","M",9,5,14
"23886","Taren","M",10,7,17
"23887","Tareq","M",6,9,15
"23888","Tariah","F",37,42,79
"23889","Tarik","M",51,52,103
"23890","Tariq","M",94,124,218
"23891","Tariyah","F",43,32,75
"23892","Taro","M",7,5,12
"23893","Taron","M",35,33,68
"23894","Tarrance","M",7,9,16
"23895","Tarrell","M",7,7,14
"23896","Tarryn","F",11,11,22
"23897","Tarun","M",24,21,45
"23898","Taryiah","F",5,10,15
"23899","Taryn","F",249,217,466
"23900","Taryn","M",12,12,24
"23901","Tarynn","F",16,11,27
"23902","Taseen","M",6,12,18
"23903","Tasfia","F",7,8,15
"23904","Tasha","F",15,22,37
"23905","Tashaun","M",9,9,18
"23906","Tashawn","M",17,21,38
"23907","Tashi","F",11,12,23
"23908","Tashi","M",6,6,12
"23909","Tasia","F",24,28,52
"23910","Tasmia","F",14,12,26
"23911","Tasneem","F",54,53,107
"23912","Tasnim","F",20,27,47
"23913","Tate","F",31,21,52
"23914","Tate","M",736,687,1423
"23915","Tatelyn","F",6,6,12
"23916","Tatem","F",9,8,17
"23917","Tatem","M",14,8,22
"23918","Taten","M",24,21,45
"23919","Tatiana","F",442,386,828
"23920","Tatianna","F",49,53,102
"23921","Tatiyana","F",14,15,29
"23922","Tatiyanna","F",7,5,12
"23923","Tatum","F",778,765,1543
"23924","Tatum","M",469,413,882
"23925","Tatumn","F",9,5,14
"23926","Tatyana","F",60,64,124
"23927","Tatyanna","F",17,18,35
"23928","Tatym","F",13,9,22
"23929","Taurean","M",24,16,40
"23930","Tauri","F",5,5,10
"23931","Tauriel","F",38,32,70
"23932","Taurus","M",16,11,27
"23933","Tavares","M",17,21,38
"23934","Tavaris","M",24,26,50
"23935","Tavarius","M",9,10,19
"23936","Tavarus","M",8,9,17
"23937","Taven","M",60,44,104
"23938","Taveon","M",10,12,22
"23939","Tavi","F",7,10,17
"23940","Tavi","M",6,7,13
"23941","Tavia","F",16,31,47
"23942","Tavian","M",30,27,57
"23943","Tavien","M",7,11,18
"23944","Tavin","M",58,55,113
"23945","Tavion","M",59,52,111
"23946","Tavis","M",14,8,22
"23947","Tavish","M",15,19,34
"23948","Tavita","M",5,6,11
"23949","Tavius","M",5,7,12
"23950","Tavon","M",53,35,88
"23951","Tavyn","M",6,9,15
"23952","Tawfiq","M",7,6,13
"23953","Taya","F",273,231,504
"23954","Tayah","F",51,34,85
"23955","Tayana","F",21,14,35
"23956","Tayanna","F",13,11,24
"23957","Tayden","M",144,160,304
"23958","Taye","M",7,5,12
"23959","Tayelor","F",5,7,12
"23960","Taygan","F",6,8,14
"23961","Taygen","F",17,9,26
"23962","Taygen","M",7,9,16
"23963","Tayla","F",121,109,230
"23964","Taylah","F",30,30,60
"23965","Taylan","F",11,8,19
"23966","Taylan","M",40,32,72
"23967","Taylar","F",33,32,65
"23968","Taylee","F",94,73,167
"23969","Tayleigh","F",17,21,38
"23970","Taylen","F",59,62,121
"23971","Taylen","M",69,85,154
"23972","Tayler","F",69,74,143
"23973","Tayler","M",27,20,47
"23974","Taylie","F",14,17,31
"23975","Taylin","F",121,83,204
"23976","Taylin","M",20,22,42
"23977","Taylinn","F",11,13,24
"23978","Taylon","M",39,33,72
"23979","Taylor","F",3741,3261,7002
"23980","Taylor","M",656,639,1295
"23981","Taylour","F",13,11,24
"23982","Taylyn","F",39,28,67
"23983","Taylynn","F",81,76,157
"23984","Taym","M",27,33,60
"23985","Tayo","M",9,5,14
"23986","Tayonna","F",13,10,23
"23987","Taysen","M",13,17,30
"23988","Tayshaun","M",16,14,30
"23989","Tayshawn","M",28,15,43
"23990","Taysia","F",8,5,13
"23991","Taysom","M",42,24,66
"23992","Tayson","M",67,32,99
"23993","Tayte","F",5,6,11
"23994","Tayte","M",14,15,29
"23995","Tayten","M",24,13,37
"23996","Tayton","M",35,29,64
"23997","Taytum","F",116,88,204
"23998","Taytum","M",27,13,40
"23999","Tayva","F",6,6,12
"24000","Tayven","M",21,24,45
"24001","Tayveon","M",11,21,32
"24002","Tayvian","M",9,5,14
"24003","Tayvin","M",13,16,29
"24004","Tayvion","M",36,36,72
"24005","Tayvon","M",42,25,67
"24006","Taz","M",10,14,24
"24007","Tea","F",38,29,67
"24008","Teagan","F",1435,2034,3469
"24009","Teagan","M",199,174,373
"24010","Teagann","F",5,5,10
"24011","Teagen","F",36,51,87
"24012","Teagen","M",26,24,50
"24013","Teaghan","F",36,37,73
"24014","Teague","M",49,45,94
"24015","Teagyn","F",13,22,35
"24016","Teagyn","M",5,5,10
"24017","Teah","F",18,10,28
"24018","Teairra","F",11,12,23
"24019","Teal","F",24,17,41
"24020","Teancum","M",9,9,18
"24021","Teanna","F",22,24,46
"24022","Teasia","F",11,5,16
"24023","Ted","M",48,55,103
"24024","Teddi","F",10,11,21
"24025","Teddie","F",10,11,21
"24026","Teddy","F",9,14,23
"24027","Teddy","M",91,84,175
"24028","Tedrick","M",7,9,16
"24029","Teegan","F",119,144,263
"24030","Teegan","M",81,77,158
"24031","Teeghan","F",8,9,17
"24032","Teela","F",5,5,10
"24033","Tegan","F",286,305,591
"24034","Tegan","M",113,84,197
"24035","Teghan","F",15,12,27
"24036","Tehani","F",10,15,25
"24037","Tehila","F",25,27,52
"24038","Tehilla","F",26,21,47
"24039","Tehillah","F",9,17,26
"24040","Tehya","F",28,24,52
"24041","Teia","F",9,14,23
"24042","Teigan","F",87,114,201
"24043","Teigan","M",18,33,51
"24044","Teigen","F",29,73,102
"24045","Teigen","M",9,36,45
"24046","Teighan","F",17,15,32
"24047","Teighlor","F",12,12,24
"24048","Tej","M",26,25,51
"24049","Teja","F",7,5,12
"24050","Tejas","M",51,39,90
"24051","Tejasvi","F",6,6,12
"24052","Tejay","M",7,5,12
"24053","Tekoa","M",7,8,15
"24054","Telia","F",8,9,17
"24055","Teliyah","F",12,6,18
"24056","Teller","M",17,13,30
"24057","Telly","M",10,6,16
"24058","Telvin","M",10,6,16
"24059","Temari","F",8,5,13
"24060","Temesgen","M",9,7,16
"24061","Temidayo","M",6,5,11
"24062","Temiloluwa","F",16,9,25
"24063","Temiloluwa","M",13,8,21
"24064","Temitayo","M",5,8,13
"24065","Temitope","F",6,5,11
"24066","Temperance","F",250,232,482
"24067","Tempest","F",19,24,43
"24068","Temple","F",11,11,22
"24069","Temple","M",5,5,10
"24070","Temprance","F",11,9,20
"24071","Temujin","M",6,7,13
"24072","Temur","M",7,9,16
"24073","Tenaya","F",15,16,31
"24074","Tenlee","F",26,24,50
"24075","Tenleigh","F",15,13,28
"24076","Tenley","F",426,565,991
"24077","Tennessee","F",27,24,51
"24078","Tennessee","M",28,24,52
"24079","Tennyson","F",22,37,59
"24080","Tennyson","M",45,32,77
"24081","Tensley","F",18,25,43
"24082","Tenzin","F",56,51,107
"24083","Tenzin","M",76,86,162
"24084","Teo","M",88,103,191
"24085","Teodor","M",16,26,42
"24086","Teodora","F",10,23,33
"24087","Teodoro","M",31,32,63
"24088","Teofilo","M",5,6,11
"24089","Teoman","M",7,9,16
"24090","Teon","M",15,17,32
"24091","Teona","F",14,10,24
"24092","Teonna","F",8,13,21
"24093","Tera","F",15,13,28
"24094","Terah","F",11,6,17
"24095","Teraji","F",7,6,13
"24096","Terance","M",10,7,17
"24097","Terek","M",10,5,15
"24098","Terell","M",27,26,53
"24099","Terence","M",101,96,197
"24100","Teresa","F",426,435,861
"24101","Teresita","F",9,12,21
"24102","Tereza","F",10,8,18
"24103","Teri","F",14,8,22
"24104","Teriana","F",7,6,13
"24105","Terion","M",6,6,12
"24106","Teriyah","F",9,8,17
"24107","Termaine","M",5,7,12
"24108","Teron","M",7,5,12
"24109","Terra","F",93,95,188
"24110","Terrah","F",8,5,13
"24111","Terran","M",30,22,52
"24112","Terrance","M",376,328,704
"24113","Terrel","M",15,15,30
"24114","Terrell","M",247,227,474
"24115","Terrelle","M",9,5,14
"24116","Terrence","M",276,269,545
"24117","Terrez","M",6,5,11
"24118","Terri","F",42,39,81
"24119","Terriah","F",8,6,14
"24120","Terriana","F",16,16,32
"24121","Terrianna","F",8,7,15
"24122","Terrick","M",15,13,28
"24123","Terrill","M",14,13,27
"24124","Terrion","M",46,50,96
"24125","Terriona","F",8,7,15
"24126","Terrionna","F",6,6,12
"24127","Terriyah","F",12,5,17
"24128","Terron","M",28,22,50
"24129","Terry","F",8,11,19
"24130","Terry","M",386,386,772
"24131","Terryn","F",14,15,29
"24132","Terryon","M",7,9,16
"24133","Teryn","F",19,18,37
"24134","Teryn","M",8,7,15
"24135","Tesla","F",166,161,327
"24136","Tesla","M",5,17,22
"24137","Tess","F",228,216,444
"24138","Tessa","F",1554,1385,2939
"24139","Tessah","F",9,8,17
"24140","Tessie","F",11,19,30
"24141","Tessla","F",16,16,32
"24142","Tesslyn","F",10,6,16
"24143","Teuila","F",6,5,11
"24144","Tevin","M",128,133,261
"24145","Tevita","M",24,31,55
"24146","Tevon","M",14,8,22
"24147","Tevyn","M",6,8,14
"24148","Tex","M",13,9,22
"24149","Texas","M",8,6,14
"24150","Teya","F",21,22,43
"24151","Teyah","F",11,9,20
"24152","Teyana","F",47,50,97
"24153","Teyanna","F",14,32,46
"24154","Teyla","F",15,10,25
"24155","Teylor","F",7,7,14
"24156","Teyon","M",6,5,11
"24157","Teyonna","F",15,9,24
"24158","Thackery","M",8,10,18
"24159","Thad","M",18,12,30
"24160","Thaddaeus","M",16,20,36
"24161","Thaddeus","M",356,409,765
"24162","Thadeo","M",7,6,13
"24163","Thadeus","M",9,12,21
"24164","Thadius","M",7,8,15
"24165","Thai","M",16,13,29
"24166","Thailand","M",9,9,18
"24167","Thaily","F",5,13,18
"24168","Thailyn","F",5,7,12
"24169","Thais","F",35,16,51
"24170","Thaleia","F",10,8,18
"24171","Thalia","F",354,350,704
"24172","Thane","M",58,54,112
"24173","Thang","M",31,44,75
"24174","Thanh","M",7,6,13
"24175","Thania","F",12,18,30
"24176","Thanos","M",12,8,20
"24177","Thanvi","F",9,12,21
"24178","Thanya","F",6,6,12
"24179","Thara","F",7,9,16
"24180","Tharun","M",13,7,20
"24181","Thatcher","M",241,271,512
"24182","Thaxton","M",10,12,22
"24183","Thayer","M",51,44,95
"24184","Thayne","M",21,29,50
"24185","Thea","F",688,1113,1801
"24186","Theadora","F",31,32,63
"24187","Theia","F",75,98,173
"24188","Thelma","F",27,32,59
"24189","Thelonious","M",20,19,39
"24190","Theo","M",764,943,1707
"24191","Theoden","M",19,21,40
"24192","Theodor","M",53,62,115
"24193","Theodora","F",80,106,186
"24194","Theodore","M",4136,4859,8995
"24195","Theodoros","M",12,18,30
"24196","Theon","M",12,16,28
"24197","Theophilus","M",34,48,82
"24198","Theory","F",7,8,15
"24199","Theory","M",7,8,15
"24200","Theresa","F",210,207,417
"24201","Therese","F",63,79,142
"24202","Theron","M",99,81,180
"24203","Theseus","M",44,35,79
"24204","Thia","F",5,14,19
"24205","Thiago","M",1032,1364,2396
"24206","Thian","M",6,6,12
"24207","Thien","M",13,24,37
"24208","Thierno","M",16,9,25
"24209","Thierry","M",21,16,37
"24210","Thomas","F",10,10,20
"24211","Thomas","M",7159,7309,14468
"24212","Thompson","M",56,51,107
"24213","Thomson","M",7,15,22
"24214","Thor","M",118,87,205
"24215","Thora","F",22,21,43
"24216","Thoren","M",24,20,44
"24217","Thorin","M",156,136,292
"24218","Thorn","M",7,9,16
"24219","Thorne","M",7,6,13
"24220","Thornton","M",9,10,19
"24221","Thorsten","M",14,12,26
"24222","Thoryn","M",19,8,27
"24223","Thunder","M",16,10,26
"24224","Thurman","M",11,18,29
"24225","Thurston","M",19,15,34
"24226","Thy","F",5,11,16
"24227","Tia","F",214,166,380
"24228","Tiago","M",159,138,297
"24229","Tiah","F",8,5,13
"24230","Tiam","M",5,6,11
"24231","Tian","M",10,11,21
"24232","Tiana","F",482,474,956
"24233","Tianah","F",6,7,13
"24234","Tiani","F",10,6,16
"24235","Tianna","F",190,174,364
"24236","Tiara","F",112,108,220
"24237","Tiarah","F",6,8,14
"24238","Tiaraoluwa","F",8,9,17
"24239","Tiare","F",9,11,20
"24240","Tiarra","F",9,13,22
"24241","Tiberius","M",109,91,200
"24242","Tidus","M",61,74,135
"24243","Tiegan","F",12,12,24
"24244","Tien","F",13,8,21
"24245","Tien","M",26,8,34
"24246","Tiera","F",8,7,15
"24247","Tiernan","F",5,5,10
"24248","Tiernan","M",46,35,81
"24249","Tierney","F",48,62,110
"24250","Tierra","F",57,57,114
"24251","Tiffani","F",27,15,42
"24252","Tiffanie","F",8,6,14
"24253","Tiffany","F",648,555,1203
"24254","Tiger","M",28,27,55
"24255","Tigerlily","F",14,25,39
"24256","Tighe","M",12,6,18
"24257","Tigran","M",20,16,36
"24258","Tilak","M",5,15,20
"24259","Tilda","F",18,13,31
"24260","Tilden","F",9,9,18
"24261","Tilden","M",20,28,48
"24262","Tilia","F",8,10,18
"24263","Tilian","M",6,7,13
"24264","Tilley","F",7,8,15
"24265","Tillie","F",70,71,141
"24266","Tillman","M",38,35,73
"24267","Tilly","F",82,81,163
"24268","Tilman","M",7,7,14
"24269","Tim","M",61,68,129
"24270","Timara","F",6,7,13
"24271","Timber","F",83,69,152
"24272","Timber","M",40,51,91
"24273","Timberlee","F",7,6,13
"24274","Timberly","F",15,19,34
"24275","Timberlyn","F",10,7,17
"24276","Timberlynn","F",16,16,32
"24277","Timea","F",12,5,17
"24278","Timia","F",25,24,49
"24279","Timiyah","F",14,5,19
"24280","Timmy","M",36,33,69
"24281","Timo","M",8,9,17
"24282","Timofey","M",31,23,54
"24283","Timoteo","M",20,22,42
"24284","Timothee","M",5,6,11
"24285","Timothy","F",5,5,10
"24286","Timothy","M",2777,2639,5416
"24287","Timur","M",42,51,93
"24288","Timya","F",10,5,15
"24289","Tina","F",157,121,278
"24290","Tinlee","F",42,54,96
"24291","Tinleigh","F",29,35,64
"24292","Tinley","F",278,357,635
"24293","Tino","M",18,11,29
"24294","Tinslee","F",22,37,59
"24295","Tinsleigh","F",16,25,41
"24296","Tinsley","F",265,279,544
"24297","Tinzlee","F",7,7,14
"24298","Tinzley","F",15,11,26
"24299","Tion","M",13,13,26
"24300","Tiona","F",9,10,19
"24301","Tionna","F",30,24,54
"24302","Tionne","F",13,5,18
"24303","Tipton","M",9,15,24
"24304","Tirenioluwa","F",5,8,13
"24305","Tirth","M",11,5,16
"24306","Tirza","F",5,7,12
"24307","Tirzah","F",63,56,119
"24308","Tisha","F",12,17,29
"24309","Tison","M",7,12,19
"24310","Titan","M",412,405,817
"24311","Tito","M",25,19,44
"24312","Titus","M",1310,1267,2577
"24313","Tiwatope","F",12,17,29
"24314","Tiya","F",13,19,32
"24315","Tiyana","F",17,16,33
"24316","Tiyanna","F",16,12,28
"24317","Tj","M",35,35,70
"24318","Tlaloc","M",8,9,17
"24319","Toa","M",8,13,21
"24320","Toba","F",14,17,31
"24321","Tobechukwu","M",12,9,21
"24322","Tobenna","M",14,11,25
"24323","Tobey","M",22,12,34
"24324","Tobi","F",14,16,30
"24325","Tobi","M",18,8,26
"24326","Tobiah","M",20,39,59
"24327","Tobias","M",1114,1508,2622
"24328","Tobie","M",10,14,24
"24329","Tobin","F",14,21,35
"24330","Tobin","M",129,118,247
"24331","Toby","F",80,79,159
"24332","Toby","M",369,314,683
"24333","Todd","M",209,185,394
"24334","Toleen","F",14,16,30
"24335","Tolliver","M",5,7,12
"24336","Toluwani","M",6,5,11
"24337","Toluwanimi","F",7,5,12
"24338","Tom","M",68,70,138
"24339","Toma","M",16,11,27
"24340","Tomas","M",341,343,684
"24341","Tomasi","M",6,5,11
"24342","Tomasz","M",5,10,15
"24343","Tomi","F",9,16,25
"24344","Tommaso","M",8,15,23
"24345","Tommi","F",18,14,32
"24346","Tommie","F",26,21,47
"24347","Tommie","M",43,29,72
"24348","Tommy","M",352,320,672
"24349","Tonantzin","F",6,6,12
"24350","Tonatiuh","M",7,8,15
"24351","Toney","M",10,13,23
"24352","Toni","F",177,158,335
"24353","Toni","M",11,10,21
"24354","Tonia","F",7,13,20
"24355","Tonio","M",5,7,12
"24356","Tonny","M",10,8,18
"24357","Tony","M",574,560,1134
"24358","Tonya","F",26,18,44
"24359","Topanga","F",33,25,58
"24360","Topher","M",5,7,12
"24361","Toprak","M",8,7,15
"24362","Tor","M",11,14,25
"24363","Torah","F",18,16,34
"24364","Toran","M",7,6,13
"24365","Torben","M",19,11,30
"24366","Toren","M",36,24,60
"24367","Toretto","M",15,8,23
"24368","Torey","F",7,6,13
"24369","Torey","M",21,24,45
"24370","Tori","F",342,361,703
"24371","Tori","M",9,11,20
"24372","Torian","M",26,34,60
"24373","Toriana","F",12,21,33
"24374","Torianna","F",8,12,20
"24375","Toriano","M",7,6,13
"24376","Toribio","M",7,6,13
"24377","Torie","F",17,13,30
"24378","Torin","F",9,8,17
"24379","Torin","M",137,155,292
"24380","Torrance","F",13,14,27
"24381","Torrance","M",26,44,70
"24382","Torre","M",7,10,17
"24383","Torren","M",20,17,37
"24384","Torrence","M",23,33,56
"24385","Torres","M",12,9,21
"24386","Torrey","F",6,8,14
"24387","Torrey","M",29,20,49
"24388","Torri","F",18,31,49
"24389","Torrian","M",14,17,31
"24390","Torrie","F",21,14,35
"24391","Torrin","F",5,6,11
"24392","Torrin","M",32,22,54
"24393","Torry","M",6,9,15
"24394","Torryn","F",10,9,19
"24395","Torsten","M",31,24,55
"24396","Tory","F",37,35,72
"24397","Tory","M",40,47,87
"24398","Toryn","F",15,10,25
"24399","Toryn","M",28,30,58
"24400","Tosh","M",14,5,19
"24401","Toussaint","M",7,12,19
"24402","Tova","F",70,67,137
"24403","Tovah","F",12,14,26
"24404","Tove","F",8,10,18
"24405","Tovia","M",8,7,15
"24406","Townes","M",57,81,138
"24407","Townsend","M",18,19,37
"24408","Trace","M",287,285,572
"24409","Tracen","M",19,21,40
"24410","Tracer","M",6,7,13
"24411","Tracey","F",23,31,54
"24412","Tracey","M",14,14,28
"24413","Traci","F",16,16,32
"24414","Tracie","F",15,14,29
"24415","Tracker","M",8,5,13
"24416","Tracy","F",83,92,175
"24417","Tracy","M",72,53,125
"24418","Trae","M",53,38,91
"24419","Traeger","M",7,6,13
"24420","Traeson","M",5,7,12
"24421","Traevon","M",5,11,16
"24422","Trai","M",6,6,12
"24423","Traiden","M",8,5,13
"24424","Trajan","M",17,12,29
"24425","Tramaine","M",21,22,43
"24426","Tramel","M",8,8,16
"24427","Tramell","M",9,5,14
"24428","Traniyah","F",5,12,17
"24429","Trany","F",13,16,29
"24430","Trapper","M",28,35,63
"24431","Travell","M",13,11,24
"24432","Traven","M",9,6,15
"24433","Traveon","M",13,10,23
"24434","Travin","M",7,7,14
"24435","Travion","M",41,37,78
"24436","Travious","M",5,6,11
"24437","Travis","M",1396,1297,2693
"24438","Travon","M",67,57,124
"24439","Traxton","M",14,14,28
"24440","Tray","M",7,11,18
"24441","Trayce","M",17,19,36
"24442","Trayden","M",17,14,31
"24443","Traylon","M",13,8,21
"24444","Trayon","M",7,7,14
"24445","Traysen","M",8,6,14
"24446","Trayson","M",22,27,49
"24447","Trayton","M",19,8,27
"24448","Trayveon","M",16,12,28
"24449","Trayvion","M",13,23,36
"24450","Trayvon","M",62,75,137
"24451","Tre","M",74,74,148
"24452","Treasure","F",243,262,505
"24453","Treasure","M",5,5,10
"24454","Treazure","F",14,11,25
"24455","Trebor","M",6,6,12
"24456","Trek","M",9,6,15
"24457","Trell","M",6,7,13
"24458","Trelyn","M",7,6,13
"24459","Tremaine","M",95,73,168
"24460","Tremayne","M",34,27,61
"24461","Tremell","M",6,5,11
"24462","Tremon","M",7,6,13
"24463","Trendon","M",9,7,16
"24464","Trenity","F",27,24,51
"24465","Trent","M",514,408,922
"24466","Trenten","M",46,38,84
"24467","Trentin","M",23,25,48
"24468","Trenton","M",1008,815,1823
"24469","Trentyn","M",18,22,40
"24470","Tres","M",10,6,16
"24471","Tresean","M",14,11,25
"24472","Treshaun","M",19,10,29
"24473","Treshawn","M",22,22,44
"24474","Treshon","M",10,7,17
"24475","Treson","M",5,6,11
"24476","Tressa","F",24,15,39
"24477","Treston","M",17,21,38
"24478","Treva","F",5,7,12
"24479","Trevan","M",6,7,13
"24480","Trevaughn","M",5,6,11
"24481","Trevell","M",10,8,18
"24482","Trevelle","M",7,9,16
"24483","Treven","M",20,14,34
"24484","Treveon","M",18,15,33
"24485","Trever","M",45,33,78
"24486","Trevian","M",5,8,13
"24487","Trevin","M",55,38,93
"24488","Trevion","M",56,37,93
"24489","Trevis","M",9,10,19
"24490","Trevon","M",103,115,218
"24491","Trevonte","M",5,8,13
"24492","Trevor","M",1180,1083,2263
"24493","Trevyn","M",27,12,39
"24494","Trew","M",8,7,15
"24495","Trexton","M",6,5,11
"24496","Trey","M",512,463,975
"24497","Treyce","M",9,9,18
"24498","Treyden","M",18,33,51
"24499","Treydon","M",6,9,15
"24500","Treysen","M",24,5,29
"24501","Treyshawn","M",8,9,17
"24502","Treyson","M",81,84,165
"24503","Treyton","M",63,47,110
"24504","Treyveon","M",9,8,17
"24505","Treyvin","M",5,6,11
"24506","Treyvion","M",11,18,29
"24507","Treyvon","M",76,63,139
"24508","Tri","M",15,13,28
"24509","Triana","F",7,15,22
"24510","Trianna","F",5,7,12
"24511","Trice","M",6,5,11
"24512","Tricia","F",13,10,23
"24513","Trig","M",8,12,20
"24514","Trigg","M",23,23,46
"24515","Trigger","M",18,19,37
"24516","Trillium","F",5,5,10
"24517","Trina","F",36,24,60
"24518","Trindon","M",5,5,10
"24519","Trinidad","F",10,13,23
"24520","Trinidad","M",22,21,43
"24521","Trinidy","F",18,11,29
"24522","Trinitee","F",55,49,104
"24523","Triniti","F",86,76,162
"24524","Trinitie","F",8,6,14
"24525","Trinity","F",2503,2215,4718
"24526","Trinity","M",21,18,39
"24527","Trinley","F",5,5,10
"24528","Trinnity","F",8,11,19
"24529","Trinton","M",15,13,28
"24530","Trip","M",15,12,27
"24531","Tripp","M",365,336,701
"24532","Tripton","M",5,8,13
"24533","Tris","F",14,10,24
"24534","Trish","F",9,5,14
"24535","Trisha","F",99,100,199
"24536","Trishika","F",5,13,18
"24537","Trison","M",9,6,15
"24538","Trista","F",42,28,70
"24539","Tristan","F",79,71,150
"24540","Tristan","M",3902,3607,7509
"24541","Tristen","F",17,24,41
"24542","Tristen","M",430,414,844
"24543","Tristian","F",7,5,12
"24544","Tristian","M",201,227,428
"24545","Tristin","F",24,16,40
"24546","Tristin","M",185,163,348
"24547","Tristine","F",6,6,12
"24548","Triston","M",216,159,375
"24549","Tristyn","F",57,55,112
"24550","Tristyn","M",80,91,171
"24551","Triton","M",89,84,173
"24552","Triumph","M",5,7,12
"24553","Trixie","F",10,14,24
"24554","Troi","F",13,18,31
"24555","Troian","F",5,5,10
"24556","Tron","M",9,6,15
"24557","Trooper","M",15,7,22
"24558","Troy","F",8,5,13
"24559","Troy","M",1197,1100,2297
"24560","Tru","F",49,31,80
"24561","Tru","M",71,80,151
"24562","Trudy","F",23,24,47
"24563","True","F",38,31,69
"24564","True","M",57,44,101
"24565","Truett","M",112,128,240
"24566","Truitt","M",41,44,85
"24567","Truly","F",49,44,93
"24568","Truman","M",211,192,403
"24569","Trust","F",12,7,19
"24570","Trust","M",12,18,30
"24571","Trustin","M",15,16,31
"24572","Truth","F",16,23,39
"24573","Truth","M",50,51,101
"24574","Truxton","M",11,6,17
"24575","Trygve","M",14,12,26
"24576","Trynity","F",9,13,22
"24577","Trypp","M",5,8,13
"24578","Tryson","M",5,5,10
"24579","Trystan","F",11,13,24
"24580","Trystan","M",162,161,323
"24581","Trysten","M",45,40,85
"24582","Trystin","M",17,14,31
"24583","Tryston","M",32,27,59
"24584","Trystyn","M",9,6,15
"24585","Tryton","M",10,9,19
"24586","Tsion","F",15,18,33
"24587","Tuan","M",9,9,18
"24588","Tuck","M",19,22,41
"24589","Tucker","F",14,15,29
"24590","Tucker","M",2225,2290,4515
"24591","Tuesday","F",16,17,33
"24592","Tuff","M",50,33,83
"24593","Tula","F",30,29,59
"24594","Tuleen","F",14,10,24
"24595","Tulip","F",12,8,20
"24596","Tully","M",8,15,23
"24597","Tulsi","F",12,15,27
"24598","Turan","M",7,7,14
"24599","Turki","M",15,11,26
"24600","Turner","F",12,24,36
"24601","Turner","M",232,234,466
"24602","Tuvia","M",17,8,25
"24603","Tvisha","F",15,15,30
"24604","Twila","F",22,24,46
"24605","Twisha","F",10,5,15
"24606","Twyla","F",25,27,52
"24607","Ty","F",9,11,20
"24608","Ty","M",612,534,1146
"24609","Tya","F",11,6,17
"24610","Tyaire","M",9,12,21
"24611","Tyana","F",21,34,55
"24612","Tyann","F",7,9,16
"24613","Tyanna","F",55,54,109
"24614","Tyasia","F",26,40,66
"24615","Tyberius","M",21,20,41
"24616","Tyce","M",87,82,169
"24617","Tycen","M",29,20,49
"24618","Tycho","M",15,18,33
"24619","Tydarius","M",5,6,11
"24620","Tyde","M",8,12,20
"24621","Tyden","M",18,24,42
"24622","Tydus","M",40,35,75
"24623","Tye","F",5,5,10
"24624","Tye","M",70,63,133
"24625","Tyeson","M",11,10,21
"24626","Tyger","M",15,10,25
"24627","Tyion","M",9,18,27
"24628","Tyjae","F",10,5,15
"24629","Tyjae","M",8,8,16
"24630","Tyjon","M",6,5,11
"24631","Tyjuan","M",20,25,45
"24632","Tyke","M",8,6,14
"24633","Tykeem","M",7,7,14
"24634","Tyking","M",6,6,12
"24635","Tyla","F",51,45,96
"24636","Tylah","F",34,27,61
"24637","Tylan","M",124,114,238
"24638","Tyland","M",7,5,12
"24639","Tylar","F",30,29,59
"24640","Tylar","M",21,19,40
"24641","Tylasia","F",10,6,16
"24642","Tylayah","F",6,5,11
"24643","Tyleah","F",24,35,59
"24644","Tylee","F",59,43,102
"24645","Tylee","M",12,12,24
"24646","Tyleigh","F",10,16,26
"24647","Tylen","M",71,56,127
"24648","Tyler","F",202,190,392
"24649","Tyler","M",5144,4474,9618
"24650","Tylia","F",15,18,33
"24651","Tyliah","F",23,20,43
"24652","Tylie","F",19,17,36
"24653","Tylin","F",6,5,11
"24654","Tylin","M",29,29,58
"24655","Tyliyah","F",17,15,32
"24656","Tylon","M",36,24,60
"24657","Tylor","M",41,37,78
"24658","Tylyn","M",5,6,11
"24659","Tylynn","F",22,19,41
"24660","Tymber","F",30,30,60
"24661","Tymere","M",19,18,37
"24662","Tymier","M",6,8,14
"24663","Tymir","M",38,44,82
"24664","Tymon","M",16,12,28
"24665","Tynan","M",13,11,24
"24666","Tynlee","F",45,49,94
"24667","Tynleigh","F",20,12,32
"24668","Tynley","F",14,6,20
"24669","Tynslee","F",14,12,26
"24670","Tyon","M",19,8,27
"24671","Tyonna","F",20,29,49
"24672","Tyquan","M",43,32,75
"24673","Tyr","M",19,10,29
"24674","Tyra","F",66,61,127
"24675","Tyrah","F",12,7,19
"24676","Tyran","M",32,27,59
"24677","Tyrann","M",14,18,32
"24678","Tyray","M",5,7,12
"24679","Tyre","M",16,20,36
"24680","Tyree","M",203,193,396
"24681","Tyreece","M",9,11,20
"24682","Tyreek","M",20,39,59
"24683","Tyreese","M",18,17,35
"24684","Tyreik","M",5,6,11
"24685","Tyrek","M",17,22,39
"24686","Tyreke","M",16,16,32
"24687","Tyrel","M",24,16,40
"24688","Tyrell","M",171,161,332
"24689","Tyrelle","M",8,5,13
"24690","Tyren","M",43,58,101
"24691","Tyreon","M",5,7,12
"24692","Tyrese","M",114,117,231
"24693","Tyrian","M",14,12,26
"24694","Tyriana","F",5,7,12
"24695","Tyrianna","F",16,8,24
"24696","Tyrice","M",8,11,19
"24697","Tyrie","M",18,14,32
"24698","Tyrik","M",15,7,22
"24699","Tyrin","M",32,41,73
"24700","Tyrion","M",62,57,119
"24701","Tyriq","M",25,39,64
"24702","Tyrique","M",17,18,35
"24703","Tyris","M",13,7,20
"24704","Tyron","M",46,50,96
"24705","Tyrone","M",232,201,433
"24706","Tyrrell","M",9,6,15
"24707","Tyrus","M",75,78,153
"24708","Tyse","M",5,8,13
"24709","Tysean","M",23,15,38
"24710","Tysen","M",50,35,85
"24711","Tyshaun","M",25,29,54
"24712","Tyshawn","M",84,79,163
"24713","Tyshon","M",20,12,32
"24714","Tyshun","M",9,7,16
"24715","Tyson","M",1127,1030,2157
"24716","Tytan","M",74,63,137
"24717","Tyten","M",9,5,14
"24718","Tytiana","F",18,13,31
"24719","Tytianna","F",7,13,20
"24720","Tyton","M",12,10,22
"24721","Tytus","M",82,91,173
"24722","Tyus","M",60,31,91
"24723","Tyvon","M",13,8,21
"24724","Tywan","M",12,15,27
"24725","Tywin","M",5,5,10
"24726","Tywon","M",14,12,26
"24727","Tzion","M",7,6,13
"24728","Tzipora","F",36,42,78
"24729","Tziporah","F",38,30,68
"24730","Tzipporah","F",18,12,30
"24731","Tzippy","F",9,10,19
"24732","Tzirel","F",13,15,28
"24733","Tzivia","F",14,23,37
"24734","Tzvi","M",138,126,264
"24735","Ubaldo","M",18,28,46
"24736","Udochukwu","M",6,5,11
"24737","Ugochukwu","M",10,6,16
"24738","Ugonna","M",9,7,16
"24739","Ula","F",9,8,17
"24740","Ulani","F",13,22,35
"24741","Uliana","F",16,5,21
"24742","Ulices","M",14,21,35
"24743","Ulises","M",237,222,459
"24744","Ulisses","M",27,18,45
"24745","Ulric","M",14,10,24
"24746","Ulrich","M",16,15,31
"24747","Ulrik","M",7,6,13
"24748","Ulyana","F",18,15,33
"24749","Ulyses","M",10,8,18
"24750","Ulysses","M",181,143,324
"24751","Uma","F",66,68,134
"24752","Umair","M",21,28,49
"24753","Umaiza","F",11,12,23
"24754","Umar","M",118,118,236
"24755","Umer","M",12,12,24
"24756","Umi","F",9,5,14
"24757","Umme","F",6,6,12
"24758","Una","F",45,60,105
"24759","Unique","F",137,115,252
"24760","Unique","M",11,10,21
"24761","Unity","F",27,30,57
"24762","Unknown","F",40,32,72
"24763","Unknown","M",56,39,95
"24764","Urban","M",36,35,71
"24765","Uri","F",5,11,16
"24766","Uri","M",29,24,53
"24767","Uriah","F",28,27,55
"24768","Uriah","M",482,526,1008
"24769","Urias","M",15,13,28
"24770","Uriel","F",9,8,17
"24771","Uriel","M",491,552,1043
"24772","Urijah","M",251,215,466
"24773","Uriyah","F",8,15,23
"24774","Uriyah","M",21,30,51
"24775","Ursula","F",41,29,70
"24776","Urvi","F",12,10,22
"24777","Usher","M",45,39,84
"24778","Usman","M",40,46,86
"24779","Uthman","M",13,13,26
"24780","Uzair","M",29,15,44
"24781","Uzay","M",5,9,14
"24782","Uziah","M",7,10,17
"24783","Uziel","M",62,45,107
"24784","Uzziah","M",49,43,92
"24785","Uzziel","M",18,21,39
"24786","Vaani","F",18,28,46
"24787","Vaanya","F",9,13,22
"24788","Vada","F",242,306,548
"24789","Vaden","M",16,13,29
"24790","Vadim","M",13,17,30
"24791","Vaeda","F",45,45,90
"24792","Vahan","M",5,6,11
"24793","Vahe","M",5,7,12
"24794","Vaibhav","M",17,19,36
"24795","Vaida","F",111,95,206
"24796","Vaiden","M",7,9,16
"24797","Vaiga","F",5,5,10
"24798","Vail","F",48,47,95
"24799","Vaishnavi","F",36,36,72
"24800","Vaishvi","F",5,5,10
"24801","Val","M",12,6,18
"24802","Vala","F",6,9,15
"24803","Valarie","F",49,34,83
"24804","Valdemar","M",7,6,13
"24805","Vale","F",44,49,93
"24806","Vale","M",11,6,17
"24807","Valen","F",13,15,28
"24808","Valen","M",49,64,113
"24809","Valena","F",7,6,13
"24810","Valencia","F",105,112,217
"24811","Valente","M",28,32,60
"24812","Valentin","M",232,270,502
"24813","Valentina","F",2745,2908,5653
"24814","Valentine","F",41,37,78
"24815","Valentine","M",31,40,71
"24816","Valentino","M",375,390,765
"24817","Valeri","F",9,12,21
"24818","Valeria","F",1977,2031,4008
"24819","Valerie","F",1877,1949,3826
"24820","Valery","F",205,241,446
"24821","Valeska","F",11,19,30
"24822","Valkyrie","F",41,48,89
"24823","Vallen","M",13,14,27
"24824","Vallerie","F",10,9,19
"24825","Vallery","F",8,8,16
"24826","Valley","F",7,15,22
"24827","Valon","M",7,5,12
"24828","Valor","F",6,14,20
"24829","Valor","M",78,90,168
"24830","Valorie","F",21,23,44
"24831","Valyn","F",11,13,24
"24832","Van","F",24,20,44
"24833","Van","M",271,234,505
"24834","Vance","M",316,244,560
"24835","Vanden","M",5,5,10
"24836","Vander","M",44,54,98
"24837","Vanellope","F",68,49,117
"24838","Vanelope","F",7,9,16
"24839","Vanesa","F",53,41,94
"24840","Vanessa","F",1726,1654,3380
"24841","Vani","F",16,11,27
"24842","Vania","F",62,64,126
"24843","Vaniah","F",7,5,12
"24844","Vanisha","F",5,5,10
"24845","Vanity","F",21,33,54
"24846","Vaniyah","F",8,6,14
"24847","Vann","M",32,36,68
"24848","Vanna","F",49,51,100
"24849","Vannah","F",11,7,18
"24850","Vannesa","F",5,7,12
"24851","Vannessa","F",11,11,22
"24852","Vannia","F",7,8,15
"24853","Vansh","M",38,40,78
"24854","Vanshika","F",8,15,23
"24855","Vanya","F",34,44,78
"24856","Vara","F",6,10,16
"24857","Varad","M",7,5,12
"24858","Vardaan","M",5,13,18
"24859","Varian","M",10,16,26
"24860","Varick","M",9,10,19
"24861","Varnika","F",25,32,57
"24862","Varsha","F",30,16,46
"24863","Varun","M",54,44,98
"24864","Varvara","F",11,17,28
"24865","Vasco","M",6,7,13
"24866","Vash","M",23,13,36
"24867","Vashon","M",7,7,14
"24868","Vashti","F",14,9,23
"24869","Vasili","M",6,9,15
"24870","Vasiliki","F",17,18,35
"24871","Vasilios","M",25,25,50
"24872","Vasilisa","F",20,31,51
"24873","Vasily","M",6,5,11
"24874","Vasti","F",7,8,15
"24875","Vaughan","M",21,13,34
"24876","Vaughn","F",14,24,38
"24877","Vaughn","M",251,259,510
"24878","Vayda","F",175,182,357
"24879","Vayden","M",8,11,19
"24880","Vayla","F",10,17,27
"24881","Ved","M",86,102,188
"24882","Veda","F",289,318,607
"24883","Vedaant","M",6,6,12
"24884","Vedansh","M",25,45,70
"24885","Vedanshi","F",14,7,21
"24886","Vedant","M",50,60,110
"24887","Vedanth","M",20,21,41
"24888","Vedder","M",9,5,14
"24889","Vedh","M",9,23,32
"24890","Vedha","F",12,9,21
"24891","Vedika","F",19,19,38
"24892","Veena","F",5,11,16
"24893","Veer","M",111,142,253
"24894","Veera","F",35,29,64
"24895","Vega","F",34,35,69
"24896","Vega","M",13,10,23
"24897","Vegas","M",11,5,16
"24898","Vegeta","M",5,5,10
"24899","Veida","F",9,9,18
"24900","Vela","F",22,24,46
"24901","Velia","F",9,5,14
"24902","Vella","F",17,20,37
"24903","Velma","F",6,7,13
"24904","Velvet","F",6,8,14
"24905","Venba","F",10,13,23
"24906","Venecia","F",8,11,19
"24907","Venelope","F",10,5,15
"24908","Venessa","F",21,6,27
"24909","Venezia","F",8,8,16
"24910","Venice","F",45,37,82
"24911","Venice","M",7,7,14
"24912","Venna","F",9,16,25
"24913","Venus","F",70,83,153
"24914","Vera","F",1050,1052,2102
"24915","Veralyn","F",7,6,13
"24916","Veralynn","F",5,6,11
"24917","Verena","F",23,18,41
"24918","Verenice","F",12,10,22
"24919","Vergil","M",6,13,19
"24920","Verity","F",60,72,132
"24921","Verna","F",25,38,63
"24922","Vernell","M",7,10,17
"24923","Vernon","M",102,109,211
"24924","Verona","F",24,22,46
"24925","Veronica","F",889,801,1690
"24926","Veronika","F",98,62,160
"24927","Veronique","F",6,8,14
"24928","Vesper","F",45,55,100
"24929","Veya","F",7,5,12
"24930","Veyda","F",23,27,50
"24931","Vi","F",11,13,24
"24932","Via","F",11,12,23
"24933","Viaan","M",150,143,293
"24934","Vian","M",24,27,51
"24935","Viana","F",30,26,56
"24936","Vianca","F",12,13,25
"24937","Vianey","F",75,74,149
"24938","Vianka","F",8,5,13
"24939","Vianna","F",42,45,87
"24940","Vianne","F",13,15,28
"24941","Vianney","F",85,74,159
"24942","Vianny","F",11,11,22
"24943","Vibha","F",33,22,55
"24944","Vibhav","M",19,17,36
"24945","Vic","M",10,20,30
"24946","Vicente","M",332,335,667
"24947","Vicenzo","M",6,5,11
"24948","Vicki","F",11,13,24
"24949","Vickie","F",6,7,13
"24950","Vicktoria","F",5,6,11
"24951","Vicky","F",103,85,188
"24952","Victor","M",2563,2447,5010
"24953","Victoria","F",7600,7267,14867
"24954","Victoriah","F",5,6,11
"24955","Victoriana","F",6,6,12
"24956","Victoriano","M",6,7,13
"24957","Victorious","F",7,6,13
"24958","Victory","F",46,47,93
"24959","Victory","M",14,16,30
"24960","Victorya","F",11,8,19
"24961","Vida","F",187,144,331
"24962","Vidal","M",40,50,90
"24963","Vidalia","F",9,11,20
"24964","Videl","F",14,12,26
"24965","Vidhi","F",13,13,26
"24966","Vidia","F",8,5,13
"24967","Vidur","M",5,7,12
"24968","Vidya","F",16,9,25
"24969","Vidyut","M",6,9,15
"24970","Vidyuth","M",11,9,20
"24971","Vienna","F",296,290,586
"24972","Vienne","F",14,11,25
"24973","Viera","F",11,18,29
"24974","Viet","M",8,6,14
"24975","Viggo","M",41,37,78
"24976","Vigo","M",8,5,13
"24977","Viha","F",17,15,32
"24978","Vihaan","M",414,389,803
"24979","Vihaanreddy","M",8,11,19
"24980","Vihan","M",33,48,81
"24981","Vihana","F",12,12,24
"24982","Vihas","M",6,5,11
"24983","Vijay","M",12,11,23
"24984","Vika","F",9,13,22
"24985","Vikram","M",41,52,93
"24986","Vikrant","M",12,9,21
"24987","Vikranth","M",5,6,11
"24988","Viktor","M",145,159,304
"24989","Viktoria","F",113,97,210
"24990","Viktoriya","F",9,14,23
"24991","Viliami","M",14,16,30
"24992","Vilma","F",17,22,39
"24993","Vin","M",9,13,22
"24994","Vina","F",10,10,20
"24995","Vinay","M",6,12,18
"24996","Vinaya","F",8,6,14
"24997","Vince","M",141,150,291
"24998","Vincen","M",5,5,10
"24999","Vincent","F",6,8,14
"25000","Vincent","M",3709,3806,7515
"25001","Vincente","M",19,25,44
"25002","Vincenza","F",16,13,29
"25003","Vincenzo","M",277,284,561
"25004","Vincy","F",5,10,15
"25005","Vinh","M",34,25,59
"25006","Vinicio","M",9,12,21
"25007","Vinicius","M",7,10,17
"25008","Vinisha","F",7,7,14
"25009","Vinn","M",7,7,14
"25010","Vinnie","M",9,12,21
"25011","Vinny","M",49,32,81
"25012","Vinson","M",22,35,57
"25013","Vinton","M",5,8,13
"25014","Viola","F",189,221,410
"25015","Violet","F",4805,4837,9642
"25016","Violeta","F",220,245,465
"25017","Violett","F",53,58,111
"25018","Violetta","F",109,114,223
"25019","Violette","F",203,196,399
"25020","Viona","F",14,10,24
"25021","Vionna","F",5,6,11
"25022","Vir","M",22,22,44
"25023","Viraaj","M",33,61,94
"25024","Viraat","M",19,19,38
"25025","Viraj","M",87,97,184
"25026","Virat","M",37,44,81
"25027","Viren","M",11,15,26
"25028","Virgil","M",69,87,156
"25029","Virgilio","M",7,5,12
"25030","Virginia","F",598,599,1197
"25031","Viridiana","F",21,21,42
"25032","Vishaan","M",6,5,11
"25033","Vishal","M",14,15,29
"25034","Vishan","M",8,10,18
"25035","Vishnu","M",25,29,54
"25036","Vishruth","M",9,11,20
"25037","Vishwa","M",7,17,24
"25038","Vismaya","F",6,9,15
"25039","Vita","F",30,24,54
"25040","Vitali","M",9,6,15
"25041","Vitalia","F",10,16,26
"25042","Vitaliy","M",18,6,24
"25043","Vitaly","M",9,13,22
"25044","Vito","M",94,98,192
"25045","Vitoria","F",11,9,20
"25046","Vittoria","F",41,42,83
"25047","Vittorio","M",26,23,49
"25048","Viva","F",15,10,25
"25049","Vivaan","M",251,223,474
"25050","Vivan","M",21,44,65
"25051","Vivek","M",18,12,30
"25052","Vivi","F",21,21,42
"25053","Vivia","F",24,16,40
"25054","Vivian","F",3197,3124,6321
"25055","Viviana","F",745,718,1463
"25056","Viviane","F",30,28,58
"25057","Viviani","F",5,5,10
"25058","Viviann","F",25,24,49
"25059","Vivianna","F",197,200,397
"25060","Vivianne","F",149,139,288
"25061","Vivica","F",9,16,25
"25062","Vivie","F",5,9,14
"25063","Vivien","F",241,219,460
"25064","Vivienne","F",1426,1275,2701
"25065","Vivika","F",8,6,14
"25066","Vivin","M",8,8,16
"25067","Vivyan","F",10,7,17
"25068","Viya","F",9,17,26
"25069","Viyaan","M",21,24,45
"25070","Viyan","M",30,22,52
"25071","Viyona","F",12,10,22
"25072","Vlad","M",19,26,45
"25073","Vladimir","M",167,178,345
"25074","Vladislav","M",26,27,53
"25075","Vladyslav","M",6,5,11
"25076","Von","M",45,62,107
"25077","Vonn","M",9,12,21
"25078","Voss","M",7,7,14
"25079","Vraj","M",13,7,20
"25080","Vrinda","F",17,7,24
"25081","Vuk","M",13,13,26
"25082","Vung","F",12,17,29
"25083","Vy","F",27,29,56
"25084","Vyan","M",11,7,18
"25085","Vyla","F",10,11,21
"25086","Vylet","F",5,9,14
"25087","Vyncent","M",6,10,16
"25088","Vyolet","F",6,9,15
"25089","Vyom","M",27,30,57
"25090","Wade","M",553,785,1338
"25091","Wael","M",23,19,42
"25092","Wagner","M",9,11,20
"25093","Wahid","M",5,6,11
"25094","Wake","M",14,17,31
"25095","Wakely","F",7,7,14
"25096","Walden","M",39,40,79
"25097","Waldo","M",8,9,17
"25098","Waleed","M",38,40,78
"25099","Wali","M",39,64,103
"25100","Walid","M",29,27,56
"25101","Walker","F",18,14,32
"25102","Walker","M",1008,1044,2052
"25103","Wallace","M",154,196,350
"25104","Wallis","F",14,8,22
"25105","Wally","M",12,13,25
"25106","Walt","M",21,30,51
"25107","Walter","M",1153,1163,2316
"25108","Walton","M",23,29,52
"25109","Wanda","F",24,30,54
"25110","Wania","F",14,18,32
"25111","Waniya","F",10,11,21
"25112","Ward","F",12,6,18
"25113","Ward","M",27,48,75
"25114","Warda","F",10,10,20
"25115","Wardell","M",6,6,12
"25116","Waris","M",6,22,28
"25117","Warner","M",78,83,161
"25118","Warren","M",771,823,1594
"25119","Warrick","M",14,13,27
"25120","Warrior","M",8,8,16
"25121","Waseem","M",23,31,54
"25122","Washington","M",11,11,22
"25123","Wassim","M",9,14,23
"25124","Wateen","F",8,12,20
"25125","Watson","M",122,119,241
"25126","Waverley","F",14,10,24
"25127","Waverly","F",121,224,345
"25128","Waverly","M",6,5,11
"25129","Wayde","M",37,37,74
"25130","Wayden","M",8,6,14
"25131","Waylan","M",43,43,86
"25132","Wayland","M",39,41,80
"25133","Waylen","M",61,68,129
"25134","Waylin","M",21,24,45
"25135","Waylon","F",12,22,34
"25136","Waylon","M",1760,2041,3801
"25137","Waylyn","F",5,5,10
"25138","Waylyn","M",6,12,18
"25139","Waylynn","F",7,15,22
"25140","Wayne","M",322,327,649
"25141","Webb","M",16,18,34
"25142","Weber","M",5,5,10
"25143","Webster","M",7,15,22
"25144","Wednesday","F",61,50,111
"25145","Weiland","M",7,10,17
"25146","Weldon","M",31,43,74
"25147","Welles","M",19,32,51
"25148","Wellington","M",22,32,54
"25149","Wells","F",7,12,19
"25150","Wells","M",89,123,212
"25151","Wendall","M",10,10,20
"25152","Wendell","M",76,88,164
"25153","Wendi","F",6,7,13
"25154","Wendy","F",288,328,616
"25155","Werner","M",10,14,24
"25156","Wes","M",143,159,302
"25157","Wesam","M",15,22,37
"25158","Weslee","F",11,10,21
"25159","Weslee","M",32,41,73
"25160","Wesleigh","F",13,22,35
"25161","Wesley","F",44,63,107
"25162","Wesley","M",3222,3407,6629
"25163","Weslie","F",18,22,40
"25164","Wesly","M",7,21,28
"25165","Weslyn","F",28,50,78
"25166","Weslyn","M",6,9,15
"25167","Weslynn","F",24,44,68
"25168","Wesson","M",185,204,389
"25169","West","M",75,72,147
"25170","Westen","M",77,62,139
"25171","Westin","M",320,274,594
"25172","Westlee","M",7,6,13
"25173","Westley","M",199,234,433
"25174","Westly","M",11,14,25
"25175","Westlyn","F",5,24,29
"25176","Westlynn","F",5,8,13
"25177","Weston","F",5,9,14
"25178","Weston","M",3318,3383,6701
"25179","Westyn","F",6,22,28
"25180","Westyn","M",123,132,255
"25181","Weyland","M",10,14,24
"25182","Weylin","M",7,18,25
"25183","Weylyn","M",11,11,22
"25184","Whalen","M",9,5,14
"25185","Wheeler","M",19,20,39
"25186","Whelan","M",6,5,11
"25187","Whisper","F",11,5,16
"25188","Whit","M",28,29,57
"25189","Whitaker","M",37,47,84
"25190","Whitfield","M",5,6,11
"25191","Whitlee","F",41,31,72
"25192","Whitleigh","F",15,13,28
"25193","Whitley","F",222,250,472
"25194","Whitley","M",16,33,49
"25195","Whitman","M",31,36,67
"25196","Whitney","F",446,373,819
"25197","Whitney","M",7,12,19
"25198","Whitt","M",17,7,24
"25199","Whittaker","M",13,25,38
"25200","Whitten","M",25,20,45
"25201","Whyatt","M",15,12,27
"25202","Wiktoria","F",6,6,12
"25203","Wil","M",18,19,37
"25204","Wilber","M",40,35,75
"25205","Wilbert","M",30,37,67
"25206","Wilberth","M",6,5,11
"25207","Wilbur","M",30,24,54
"25208","Wilder","F",22,38,60
"25209","Wilder","M",215,337,552
"25210","Wiley","F",15,8,23
"25211","Wiley","M",134,126,260
"25212","Wilford","M",10,8,18
"25213","Wilfred","M",23,32,55
"25214","Wilfredo","M",45,53,98
"25215","Wilhelm","M",21,24,45
"25216","Wilhelmina","F",134,114,248
"25217","Wiliam","M",12,11,23
"25218","Wilian","M",7,5,12
"25219","Wilkes","M",8,16,24
"25220","Wilkin","M",7,6,13
"25221","Will","M",268,274,542
"25222","Willa","F",672,682,1354
"25223","Willam","M",5,7,12
"25224","Willamina","F",21,26,47
"25225","Willard","M",44,47,91
"25226","Willem","M",67,70,137
"25227","Willemina","F",9,7,16
"25228","William","F",15,19,34
"25229","William","M",15863,15668,31531
"25230","Williams","M",45,36,81
"25231","Willian","M",21,22,43
"25232","Willie","M",304,290,594
"25233","Willis","M",73,68,141
"25234","Willo","F",9,13,22
"25235","Willow","F",2793,3086,5879
"25236","Willow","M",14,17,31
"25237","Wills","M",6,7,13
"25238","Willson","M",9,13,22
"25239","Willy","M",30,26,56
"25240","Wilma","F",30,21,51
"25241","Wilman","M",8,6,14
"25242","Wilmar","M",7,6,13
"25243","Wilmary","F",5,5,10
"25244","Wilmer","M",103,108,211
"25245","Wilson","M",433,438,871
"25246","Wilton","M",25,17,42
"25247","Wimberly","F",7,5,12
"25248","Win","M",5,7,12
"25249","Winchester","M",9,9,18
"25250","Windsor","F",32,35,67
"25251","Windsor","M",11,14,25
"25252","Windy","F",7,6,13
"25253","Winifred","F",159,146,305
"25254","Winn","M",11,9,20
"25255","Winner","F",11,7,18
"25256","Winnie","F",212,233,445
"25257","Winnifred","F",22,28,50
"25258","Winona","F",37,66,103
"25259","Winry","F",60,48,108
"25260","Winslet","F",9,12,21
"25261","Winslow","F",24,28,52
"25262","Winslow","M",21,19,40
"25263","Winson","M",10,9,19
"25264","Winston","M",548,645,1193
"25265","Winter","F",565,614,1179
"25266","Winter","M",33,45,78
"25267","Winterrose","F",6,6,12
"25268","Winton","M",10,8,18
"25269","Wisam","M",11,12,23
"25270","Wisdom","F",38,43,81
"25271","Wisdom","M",45,43,88
"25272","Wissam","M",10,10,20
"25273","Witt","M",9,12,21
"25274","Witten","F",6,6,12
"25275","Witten","M",75,74,149
"25276","Wolf","M",61,67,128
"25277","Wolfe","M",10,30,40
"25278","Wolfgang","M",113,117,230
"25279","Woodley","M",6,5,11
"25280","Woodrow","M",59,77,136
"25281","Woods","M",15,17,32
"25282","Woodson","M",18,22,40
"25283","Worth","M",9,12,21
"25284","Wrangler","M",10,17,27
"25285","Wren","F",403,589,992
"25286","Wren","M",65,87,152
"25287","Wrenley","F",16,23,39
"25288","Wrenly","F",7,16,23
"25289","Wrenn","F",13,26,39
"25290","Wrenna","F",14,10,24
"25291","Wright","M",13,14,27
"25292","Wrigley","F",15,18,33
"25293","Wrigley","M",22,30,52
"25294","Wryn","F",5,7,12
"25295","Wyat","M",12,6,18
"25296","Wyatt","F",63,78,141
"25297","Wyatt","M",9635,9514,19149
"25298","Wyatte","M",8,6,14
"25299","Wyeth","M",13,14,27
"25300","Wyett","M",23,16,39
"25301","Wylan","M",16,14,30
"25302","Wyland","M",25,24,49
"25303","Wylder","F",9,13,22
"25304","Wylder","M",47,71,118
"25305","Wylee","F",12,17,29
"25306","Wylee","M",15,26,41
"25307","Wylie","F",28,26,54
"25308","Wylie","M",74,98,172
"25309","Wyllow","F",10,17,27
"25310","Wyman","M",9,9,18
"25311","Wyn","M",10,6,16
"25312","Wynn","F",51,43,94
"25313","Wynn","M",66,51,117
"25314","Wynne","F",25,39,64
"25315","Wynnie","F",7,14,21
"25316","Wynona","F",12,11,23
"25317","Wynston","M",21,31,52
"25318","Wynter","F",360,397,757
"25319","Wynter","M",9,11,20
"25320","Wynton","M",10,7,17
"25321","Xabi","M",12,10,22
"25322","Xachary","M",8,10,18
"25323","Xaden","M",19,12,31
"25324","Xadrian","M",20,17,37
"25325","Xaela","F",5,5,10
"25326","Xaelah","F",5,5,10
"25327","Xaiden","M",86,72,158
"25328","Xaidyn","M",10,10,20
"25329","Xain","M",7,5,12
"25330","Xaine","M",5,5,10
"25331","Xaire","M",5,7,12
"25332","Xaiver","M",12,21,33
"25333","Xamir","M",6,5,11
"25334","Xander","M",1923,1988,3911
"25335","Xandra","F",11,12,23
"25336","Xandria","F",24,20,44
"25337","Xandyr","M",5,7,12
"25338","Xane","M",31,27,58
"25339","Xaniyah","F",6,9,15
"25340","Xanthe","F",6,6,12
"25341","Xara","F",12,19,31
"25342","Xareni","F",14,30,44
"25343","Xaria","F",41,41,82
"25344","Xariah","F",17,15,32
"25345","Xariyah","F",6,8,14
"25346","Xavi","M",132,122,254
"25347","Xavia","F",14,14,28
"25348","Xavian","M",58,64,122
"25349","Xaviar","M",13,13,26
"25350","Xavien","M",40,47,87
"25351","Xavier","F",5,7,12
"25352","Xavier","M",4626,4560,9186
"25353","Xavion","M",74,60,134
"25354","Xavior","M",32,38,70
"25355","Xavius","M",6,5,11
"25356","Xavyer","M",10,11,21
"25357","Xayden","M",51,44,95
"25358","Xayla","F",11,10,21
"25359","Xaylee","F",5,6,11
"25360","Xayne","M",14,11,25
"25361","Xayvion","M",12,13,25
"25362","Xela","F",10,9,19
"25363","Xena","F",93,111,204
"25364","Xenia","F",61,54,115
"25365","Xerxes","M",14,13,27
"25366","Xhaiden","M",12,9,21
"25367","Xia","F",25,27,52
"25368","Xiamara","F",5,14,19
"25369","Xian","M",14,11,25
"25370","Xiana","F",8,9,17
"25371","Xianna","F",8,8,16
"25372","Xiara","F",7,10,17
"25373","Ximena","F",2598,2673,5271
"25374","Ximenna","F",16,29,45
"25375","Xin","F",7,11,18
"25376","Xinyi","F",13,10,23
"25377","Xiomara","F",220,257,477
"25378","Xion","M",32,44,76
"25379","Xitlali","F",114,98,212
"25380","Xitlalli","F",9,15,24
"25381","Xitlaly","F",52,54,106
"25382","Xochilt","F",12,15,27
"25383","Xochitl","F",96,82,178
"25384","Xoe","F",26,23,49
"25385","Xoey","F",17,24,41
"25386","Xoie","F",8,5,13
"25387","Xola","F",9,7,16
"25388","Xolani","F",15,8,23
"25389","Xxavier","M",10,6,16
"25390","Xya","F",6,8,14
"25391","Xyla","F",67,64,131
"25392","Xylah","F",11,16,27
"25393","Xylan","M",7,11,18
"25394","Xyler","M",13,12,25
"25395","Xylia","F",27,15,42
"25396","Xyliana","F",5,8,13
"25397","Xylon","M",5,6,11
"25398","Xyon","M",6,5,11
"25399","Xzaiden","M",6,6,12
"25400","Xzander","M",42,37,79
"25401","Xzaria","F",6,7,13
"25402","Xzavian","M",17,12,29
"25403","Xzaviar","M",5,8,13
"25404","Xzavien","M",14,11,25
"25405","Xzavier","M",335,287,622
"25406","Xzavion","M",24,22,46
"25407","Xzavior","M",13,12,25
"25408","Xzayden","M",5,8,13
"25409","Xzayvier","M",15,6,21
"25410","Xzayvion","M",15,12,27
"25411","Yaa","F",11,5,16
"25412","Yaakov","M",207,156,363
"25413","Yaasir","M",9,6,15
"25414","Yachet","F",17,10,27
"25415","Yaciel","M",5,5,10
"25416","Yacine","F",5,9,14
"25417","Yacine","M",9,11,20
"25418","Yacob","M",10,8,18
"25419","Yacoub","M",12,10,22
"25420","Yacqub","M",8,6,14
"25421","Yadelin","F",8,5,13
"25422","Yaden","M",6,7,13
"25423","Yadhira","F",6,8,14
"25424","Yadiel","M",213,176,389
"25425","Yadier","M",60,45,105
"25426","Yadir","M",8,14,22
"25427","Yadira","F",76,73,149
"25428","Yadriel","M",26,22,48
"25429","Yael","F",105,124,229
"25430","Yael","M",178,181,359
"25431","Yaeli","F",7,8,15
"25432","Yaelis","F",13,20,33
"25433","Yaelle","F",7,6,13
"25434","Yafet","M",23,28,51
"25435","Yago","M",11,19,30
"25436","Yahaira","F",52,64,116
"25437","Yahel","M",40,23,63
"25438","Yaheli","F",5,5,10
"25439","Yahia","M",32,42,74
"25440","Yahir","M",389,325,714
"25441","Yahli","F",5,6,11
"25442","Yahmir","M",7,10,17
"25443","Yahshua","M",13,24,37
"25444","Yahvi","F",6,5,11
"25445","Yahya","M",211,224,435
"25446","Yahye","M",15,20,35
"25447","Yaiden","M",15,15,30
"25448","Yailin","F",7,17,24
"25449","Yailyn","F",7,9,16
"25450","Yair","M",160,150,310
"25451","Yaira","F",9,16,25
"25452","Yaiza","F",83,53,136
"25453","Yajaira","F",31,47,78
"25454","Yakelin","F",16,7,23
"25455","Yakira","F",20,17,37
"25456","Yakov","M",112,106,218
"25457","Yakub","M",11,5,16
"25458","Yalaina","F",5,5,10
"25459","Yalda","F",8,5,13
"25460","Yale","M",10,5,15
"25461","Yalena","F",11,15,26
"25462","Yalexa","F",10,7,17
"25463","Yali","F",5,7,12
"25464","Yalina","F",6,7,13
"25465","Yalini","F",11,7,18
"25466","Yalissa","F",5,6,11
"25467","Yalitza","F",14,15,29
"25468","Yamajesty","M",5,5,10
"25469","Yaman","M",5,12,17
"25470","Yamari","F",7,5,12
"25471","Yamato","M",10,7,17
"25472","Yamen","M",26,26,52
"25473","Yamil","M",26,34,60
"25474","Yamila","F",14,76,90
"25475","Yamile","F",10,7,17
"25476","Yamilet","F",124,134,258
"25477","Yamileth","F",325,295,620
"25478","Yamilett","F",14,11,25
"25479","Yamilette","F",8,14,22
"25480","Yamilex","F",11,19,30
"25481","Yamin","M",15,11,26
"25482","Yamina","F",8,11,19
"25483","Yaminah","F",14,9,23
"25484","Yamir","M",36,35,71
"25485","Yan","F",5,6,11
"25486","Yan","M",18,30,48
"25487","Yana","F",101,87,188
"25488","Yancarlos","M",6,10,16
"25489","Yancey","M",7,5,12
"25490","Yancy","F",8,8,16
"25491","Yancy","M",7,7,14
"25492","Yandel","M",125,114,239
"25493","Yandiel","M",13,11,24
"25494","Yandriel","M",10,11,21
"25495","Yaneisy","F",13,11,24
"25496","Yanel","F",5,6,11
"25497","Yaneli","F",150,128,278
"25498","Yanelie","F",5,5,10
"25499","Yanelis","F",21,17,38
"25500","Yaneliz","F",15,9,24
"25501","Yanelli","F",12,9,21
"25502","Yanelly","F",27,18,45
"25503","Yanely","F",70,50,120
"25504","Yanessa","F",18,8,26
"25505","Yanet","F",46,38,84
"25506","Yaneth","F",21,27,48
"25507","Yani","F",9,14,23
"25508","Yani","M",8,7,15
"25509","Yaniel","M",38,28,66
"25510","Yanira","F",20,31,51
"25511","Yanis","M",29,26,55
"25512","Yanitza","F",12,7,19
"25513","Yaniv","M",8,6,14
"25514","Yaniyah","F",5,8,13
"25515","Yanky","M",7,8,15
"25516","Yann","M",8,17,25
"25517","Yanna","F",15,17,32
"25518","Yanni","F",11,13,24
"25519","Yanni","M",12,18,30
"25520","Yannick","M",39,54,93
"25521","Yannis","M",13,10,23
"25522","Yanuel","M",24,17,41
"25523","Yaphet","M",9,10,19
"25524","Yaqub","M",31,27,58
"25525","Yaquelin","F",19,16,35
"25526","Yara","F",199,177,376
"25527","Yarah","F",11,11,22
"25528","Yarden","F",7,6,13
"25529","Yared","M",20,13,33
"25530","Yarel","F",18,14,32
"25531","Yarel","M",14,15,29
"25532","Yareli","F",312,351,663
"25533","Yarelin","F",5,5,10
"25534","Yarelis","F",19,14,33
"25535","Yareliz","F",7,10,17
"25536","Yarelly","F",7,5,12
"25537","Yarely","F",132,126,258
"25538","Yareni","F",36,37,73
"25539","Yareth","F",11,7,18
"25540","Yareth","M",27,26,53
"25541","Yaretzi","F",808,677,1485
"25542","Yaretzy","F",164,172,336
"25543","Yarexi","F",10,11,21
"25544","Yari","F",16,24,40
"25545","Yariah","F",5,7,12
"25546","Yariana","F",11,10,21
"25547","Yariel","M",104,101,205
"25548","Yarielis","F",19,18,37
"25549","Yarieliz","F",10,8,18
"25550","Yarielys","F",10,11,21
"25551","Yaritza","F",289,205,494
"25552","Yaritzel","F",15,6,21
"25553","Yaritzi","F",22,14,36
"25554","Yaritzy","F",10,11,21
"25555","Yarlin","F",7,6,13
"25556","Yaron","M",12,11,23
"25557","Yaroslav","M",13,17,30
"25558","Yaseen","M",176,167,343
"25559","Yasemin","F",11,10,21
"25560","Yaser","M",8,23,31
"25561","Yash","M",64,73,137
"25562","Yashas","M",6,6,12
"25563","Yashika","F",15,25,40
"25564","Yashua","M",8,11,19
"25565","Yashvi","F",30,29,59
"25566","Yasiel","M",48,39,87
"25567","Yasiin","M",8,9,17
"25568","Yasin","M",103,113,216
"25569","Yasir","M",116,114,230
"25570","Yaslin","F",29,15,44
"25571","Yaslyn","F",8,14,22
"25572","Yasmani","M",8,9,17
"25573","Yasmeen","F",119,93,212
"25574","Yasmin","F",290,291,581
"25575","Yasmina","F",67,56,123
"25576","Yasmine","F",157,163,320
"25577","Yasna","F",5,9,14
"25578","Yassen","M",5,7,12
"25579","Yasser","M",44,60,104
"25580","Yassin","M",55,64,119
"25581","Yassine","M",36,18,54
"25582","Yassir","M",11,17,28
"25583","Yassmine","F",6,5,11
"25584","Yates","M",8,16,24
"25585","Yatzari","F",5,6,11
"25586","Yatzary","F",7,8,15
"25587","Yatzil","F",37,56,93
"25588","Yatziri","F",82,99,181
"25589","Yatziry","F",39,36,75
"25590","Yaw","M",12,9,21
"25591","Yaxeni","F",7,8,15
"25592","Yaxiel","M",13,12,25
"25593","Yazaira","F",81,13,94
"25594","Yazan","M",96,83,179
"25595","Yazbeth","F",5,5,10
"25596","Yazeed","M",17,16,33
"25597","Yazen","M",18,15,33
"25598","Yazhini","F",5,12,17
"25599","Yazid","M",14,17,31
"25600","Yaziel","M",25,15,40
"25601","Yazleemar","F",31,7,38
"25602","Yazleen","F",17,7,24
"25603","Yazlin","F",19,11,30
"25604","Yazlyn","F",8,10,18
"25605","Yazlynn","F",10,12,22
"25606","Yazmeen","F",5,11,16
"25607","Yazmin","F",171,179,350
"25608","Yazmine","F",45,48,93
"25609","Yazmyn","F",7,5,12
"25610","Ye","M",7,5,12
"25611","Yecheskel","M",9,13,22
"25612","Yechezkel","M",28,18,46
"25613","Yechiel","M",67,59,126
"25614","Yedidya","M",7,5,12
"25615","Yehia","M",7,12,19
"25616","Yehoshua","M",73,69,142
"25617","Yehuda","M",224,233,457
"25618","Yehudah","M",21,11,32
"25619","Yehudis","F",70,62,132
"25620","Yehya","M",7,8,15
"25621","Yeicob","M",8,6,14
"25622","Yeiden","M",24,19,43
"25623","Yeilani","F",6,5,11
"25624","Yeilin","F",16,20,36
"25625","Yeily","F",7,15,22
"25626","Yeilyn","F",11,13,24
"25627","Yeimi","F",13,10,23
"25628","Yeimy","F",20,30,50
"25629","Yeiren","M",17,6,23
"25630","Yeiri","F",6,5,11
"25631","Yeison","M",26,22,48
"25632","Yekusiel","M",6,5,11
"25633","Yelena","F",39,56,95
"25634","Yelina","F",9,5,14
"25635","Yelitza","F",43,34,77
"25636","Yeltsin","M",7,5,12
"25637","Yemariam","F",9,14,23
"25638","Yemaya","F",18,18,36
"25639","Yen","F",7,7,14
"25640","Yena","F",11,8,19
"25641","Yenifer","F",6,9,15
"25642","Yenty","F",5,9,14
"25643","Yerachmiel","M",9,13,22
"25644","Yeraldi","F",5,9,14
"25645","Yeraldin","F",7,10,17
"25646","Yeraldine","F",6,8,14
"25647","Yeray","M",42,27,69
"25648","Yeremy","M",6,8,14
"25649","Yerick","M",7,10,17
"25650","Yeriel","M",18,10,28
"25651","Yerik","M",41,48,89
"25652","Yesenia","F",181,182,363
"25653","Yeshaya","M",23,29,52
"25654","Yeshia","F",11,16,27
"25655","Yeshua","M",115,147,262
"25656","Yesica","F",20,9,29
"25657","Yesli","F",7,17,24
"25658","Yeslin","F",9,6,15
"25659","Yesly","F",15,9,24
"25660","Yessenia","F",61,54,115
"25661","Yessica","F",33,28,61
"25662","Yetzael","M",14,8,22
"25663","Yetzali","F",35,32,67
"25664","Yeudiel","M",8,11,19
"25665","Yeva","F",12,22,34
"25666","Yi","F",9,8,17
"25667","Yi","M",15,11,26
"25668","Yianni","M",18,17,35
"25669","Yiannis","M",13,12,25
"25670","Yichen","F",6,8,14
"25671","Yichen","M",9,12,21
"25672","Yicheng","M",5,6,11
"25673","Yida","M",15,10,25
"25674","Yiddy","M",5,5,10
"25675","Yidel","M",11,6,17
"25676","Yides","F",42,34,76
"25677","Yifan","M",5,10,15
"25678","Yigit","M",9,5,14
"25679","Yilia","F",9,16,25
"25680","Yilin","F",9,12,21
"25681","Yiming","M",5,7,12
"25682","Yina","F",6,5,11
"25683","Yinuo","F",5,5,10
"25684","Yiran","F",8,6,14
"25685","Yisel","F",16,10,26
"25686","Yishai","M",18,15,33
"25687","Yisrael","M",57,66,123
"25688","Yisroel","M",212,208,420
"25689","Yissel","F",8,12,20
"25690","Yitta","F",13,8,21
"25691","Yittel","F",10,7,17
"25692","Yitty","F",65,78,143
"25693","Yitzchak","M",36,44,80
"25694","Yitzchok","M",151,144,295
"25695","Yitzel","F",9,7,16
"25696","Yitzhak","M",12,12,24
"25697","Yixin","F",7,8,15
"25698","Yiyang","M",8,5,13
"25699","Yiyi","F",5,8,13
"25700","Yizel","F",10,6,16
"25701","Yliana","F",17,16,33
"25702","Yoali","F",10,7,17
"25703","Yoan","M",14,7,21
"25704","Yoana","F",22,16,38
"25705","Yoandri","M",23,97,120
"25706","Yoanna","F",15,7,22
"25707","Yoav","M",8,8,16
"25708","Yobani","M",8,13,21
"25709","Yocelin","F",21,19,40
"25710","Yocelyn","F",18,23,41
"25711","Yochanan","M",10,7,17
"25712","Yocheved","F",75,71,146
"25713","Yoel","M",134,151,285
"25714","Yogi","M",8,10,18
"25715","Yohan","M",67,53,120
"25716","Yohana","F",42,41,83
"25717","Yohanan","M",7,9,16
"25718","Yohann","M",19,9,28
"25719","Yohanna","F",41,37,78
"25720","Yohannes","M",15,24,39
"25721","Yolanda","F",107,99,206
"25722","Yoltzin","F",6,7,13
"25723","Yomar","M",14,11,25
"25724","Yona","F",9,7,16
"25725","Yona","M",8,15,23
"25726","Yonael","M",25,12,37
"25727","Yonah","M",20,21,41
"25728","Yonas","M",7,12,19
"25729","Yonason","M",7,7,14
"25730","Yonatan","M",78,65,143
"25731","Yonathan","M",33,38,71
"25732","Yoni","M",14,15,29
"25733","Yonis","M",23,12,35
"25734","Yony","M",5,6,11
"25735","Yoona","F",11,8,19
"25736","Yordan","M",9,13,22
"25737","Yordany","M",6,5,11
"25738","Yordi","M",15,8,23
"25739","Yordy","M",7,6,13
"25740","York","M",7,12,19
"25741","Yorleny","F",7,6,13
"25742","Yosef","M",350,354,704
"25743","Yoselin","F",151,149,300
"25744","Yoseline","F",11,6,17
"25745","Yoselyn","F",41,37,78
"25746","Yoseph","M",28,20,48
"25747","Yosgart","M",8,8,16
"25748","Yoshi","M",5,6,11
"25749","Yoshua","M",16,20,36
"25750","Yosiah","M",14,15,29
"25751","Yosif","M",6,7,13
"25752","Yosmar","M",7,6,13
"25753","Yossef","M",6,7,13
"25754","Yosselin","F",13,11,24
"25755","Yosselyn","F",7,5,12
"25756","Yossi","M",19,27,46
"25757","Yostin","M",14,9,23
"25758","Yosuf","M",6,5,11
"25759","Youcef","M",6,7,13
"25760","Younes","M",22,22,44
"25761","Young","M",12,5,17
"25762","Younis","M",25,36,61
"25763","Younus","M",5,7,12
"25764","Yousaf","M",12,12,24
"25765","Yousef","M",296,308,604
"25766","Yousif","M",110,95,205
"25767","Yousof","M",9,10,19
"25768","Yousra","F",11,23,34
"25769","Youssef","M",185,191,376
"25770","Yousuf","M",81,81,162
"25771","Yovana","F",6,5,11
"25772","Yovani","M",46,40,86
"25773","Yovanna","F",5,8,13
"25774","Yovanni","M",20,12,32
"25775","Yovanny","M",9,10,19
"25776","Yovany","M",17,13,30
"25777","Ysabel","F",25,17,42
"25778","Ysabella","F",65,48,113
"25779","Ysabelle","F",18,14,32
"25780","Yu","M",9,11,20
"25781","Yuan","M",11,8,19
"25782","Yudith","F",9,10,19
"25783","Yug","M",36,48,84
"25784","Yugan","M",6,10,16
"25785","Yui","F",29,31,60
"25786","Yuka","F",7,5,12
"25787","Yukari","F",6,10,16
"25788","Yuki","F",21,30,51
"25789","Yuki","M",12,18,30
"25790","Yuktha","F",8,8,16
"25791","Yuli","F",16,15,31
"25792","Yulia","F",22,20,42
"25793","Yulian","M",26,22,48
"25794","Yuliana","F",163,199,362
"25795","Yulianna","F",68,61,129
"25796","Yuliet","F",10,9,19
"25797","Yulieth","F",10,15,25
"25798","Yulisa","F",28,24,52
"25799","Yulissa","F",122,86,208
"25800","Yuliza","F",12,10,22
"25801","Yuma","F",5,9,14
"25802","Yuma","M",16,14,30
"25803","Yumi","F",28,35,63
"25804","Yumiko","F",6,6,12
"25805","Yumna","F",13,22,35
"25806","Yuna","F",121,142,263
"25807","Yunalesca","F",6,7,13
"25808","Yuniel","M",8,8,16
"25809","Yunior","M",6,9,15
"25810","Yunis","M",15,27,42
"25811","Yunuen","F",7,5,12
"25812","Yunus","M",42,52,94
"25813","Yurem","M",21,14,35
"25814","Yuri","F",77,92,169
"25815","Yuri","M",61,55,116
"25816","Yuriana","F",11,19,30
"25817","Yurianna","F",5,7,12
"25818","Yuridia","F",40,26,66
"25819","Yuriel","M",10,16,26
"25820","Yuritza","F",6,12,18
"25821","Yuritzi","F",25,50,75
"25822","Yuritzy","F",7,13,20
"25823","Yuriy","M",9,9,18
"25824","Yusef","M",75,51,126
"25825","Yusha","M",11,7,18
"25826","Yusif","M",17,27,44
"25827","Yusra","F",105,124,229
"25828","Yussef","M",13,11,24
"25829","Yussuf","M",8,13,21
"25830","Yusuf","M",468,496,964
"25831","Yusuke","M",5,5,10
"25832","Yuto","M",19,10,29
"25833","Yutong","F",6,12,18
"25834","Yuvaan","M",29,71,100
"25835","Yuval","F",5,8,13
"25836","Yuval","M",7,7,14
"25837","Yuvan","M",59,93,152
"25838","Yuvia","F",17,15,32
"25839","Yuvraj","M",59,73,132
"25840","Yuxi","F",9,7,16
"25841","Yuxin","F",7,7,14
"25842","Yvaine","F",10,12,22
"25843","Yvan","M",13,9,22
"25844","Yvana","F",5,6,11
"25845","Yvanna","F",12,12,24
"25846","Yves","M",14,15,29
"25847","Yvette","F",148,111,259
"25848","Yvonne","F",119,122,241
"25849","Ywa","M",5,5,10
"25850","Yzabella","F",18,28,46
"25851","Yzabelle","F",8,7,15
"25852","Zaahir","M",10,7,17
"25853","Zaara","F",40,40,80
"25854","Zabdi","F",5,7,12
"25855","Zabdiel","M",33,111,144
"25856","Zabella","F",5,10,15
"25857","Zabrina","F",9,17,26
"25858","Zac","M",64,74,138
"25859","Zacari","F",5,6,11
"25860","Zacari","M",18,23,41
"25861","Zacariah","M",9,7,16
"25862","Zacarias","M",38,41,79
"25863","Zacary","M",5,8,13
"25864","Zaccai","M",8,11,19
"25865","Zacchaeus","M",49,41,90
"25866","Zaccheus","M",5,7,12
"25867","Zach","M",72,39,111
"25868","Zachari","M",17,14,31
"25869","Zacharia","M",29,29,58
"25870","Zachariah","M",733,696,1429
"25871","Zacharias","M",74,94,168
"25872","Zacharie","M",10,14,24
"25873","Zachary","F",5,9,14
"25874","Zachary","M",4834,4516,9350
"25875","Zacharyah","M",5,7,12
"25876","Zacheriah","M",14,7,21
"25877","Zachery","M",97,85,182
"25878","Zack","M",151,186,337
"25879","Zackari","M",7,6,13
"25880","Zackaria","M",7,9,16
"25881","Zackariah","M",40,26,66
"25882","Zackary","M",320,310,630
"25883","Zackery","M",122,80,202
"25884","Zada","F",52,48,100
"25885","Zadaya","F",11,20,31
"25886","Zade","M",78,52,130
"25887","Zaden","M",122,111,233
"25888","Zadie","F",131,169,300
"25889","Zadiel","M",7,12,19
"25890","Zadkiel","M",20,19,39
"25891","Zadok","M",29,23,52
"25892","Zadrian","M",23,21,44
"25893","Zadyn","M",25,23,48
"25894","Zae","M",5,6,11
"25895","Zaeda","F",5,9,14
"25896","Zaeden","M",47,40,87
"25897","Zaedin","M",5,8,13
"25898","Zaedyn","M",44,51,95
"25899","Zaeem","M",33,21,54
"25900","Zael","M",12,15,27
"25901","Zaela","F",11,9,20
"25902","Zaelee","F",9,9,18
"25903","Zaeleigh","F",8,8,16
"25904","Zaelyn","F",23,22,45
"25905","Zaelyn","M",13,15,28
"25906","Zaelynn","F",24,35,59
"25907","Zaevion","M",15,35,50
"25908","Zafir","M",5,11,16
"25909","Zafira","F",8,6,14
"25910","Zafirah","F",7,10,17
"25911","Zafiro","F",5,5,10
"25912","Zahair","M",5,5,10
"25913","Zahar","M",8,6,14
"25914","Zahara","F",163,164,327
"25915","Zahari","F",17,14,31
"25916","Zahari","M",13,12,25
"25917","Zahava","F",28,32,60
"25918","Zaheer","M",12,11,23
"25919","Zahi","M",5,7,12
"25920","Zahid","M",35,24,59
"25921","Zahir","M",153,175,328
"25922","Zahira","F",36,35,71
"25923","Zahirah","F",7,8,15
"25924","Zahmir","M",14,25,39
"25925","Zahniya","F",5,5,10
"25926","Zahniyah","F",9,5,14
"25927","Zahra","F",411,432,843
"25928","Zahraa","F",62,45,107
"25929","Zahrah","F",11,12,23
"25930","Zahria","F",15,28,43
"25931","Zahriah","F",6,7,13
"25932","Zahriyah","F",5,5,10
"25933","Zai","M",9,9,18
"25934","Zaia","F",16,19,35
"25935","Zaiah","F",11,10,21
"25936","Zaiah","M",6,5,11
"25937","Zaid","M",249,242,491
"25938","Zaida","F",81,78,159
"25939","Zaidan","M",24,37,61
"25940","Zaide","F",5,5,10
"25941","Zaide","M",7,7,14
"25942","Zaidee","F",22,28,50
"25943","Zaiden","M",862,786,1648
"25944","Zaidon","M",11,9,20
"25945","Zaidy","F",8,5,13
"25946","Zaidyn","M",101,105,206
"25947","Zaila","F",35,42,77
"25948","Zailah","F",18,13,31
"25949","Zailee","F",24,34,58
"25950","Zaileigh","F",7,8,15
"25951","Zailen","M",5,8,13
"25952","Zailey","F",45,89,134
"25953","Zaily","F",8,6,14
"25954","Zailyn","F",11,24,35
"25955","Zailyn","M",5,12,17
"25956","Zailynn","F",28,17,45
"25957","Zaim","M",9,12,21
"25958","Zain","F",15,21,36
"25959","Zain","M",346,366,712
"25960","Zaina","F",110,151,261
"25961","Zainab","F",287,300,587
"25962","Zainah","F",16,10,26
"25963","Zaine","M",104,102,206
"25964","Zaineb","F",11,10,21
"25965","Zair","M",21,35,56
"25966","Zaira","F",140,102,242
"25967","Zairah","F",16,11,27
"25968","Zaire","F",23,23,46
"25969","Zaire","M",253,302,555
"25970","Zaiya","F",30,38,68
"25971","Zaiyah","F",7,18,25
"25972","Zaiyden","M",10,16,26
"25973","Zak","M",41,34,75
"25974","Zakai","M",103,140,243
"25975","Zakari","F",11,10,21
"25976","Zakari","M",61,95,156
"25977","Zakaria","F",11,11,22
"25978","Zakaria","M",128,107,235
"25979","Zakaria","M",128,20,148
"25980","Zakariah","M",28,30,58
"25981","Zakarias","M",7,7,14
"25982","Zakariya","F",5,6,11
"25983","Zakariya","M",117,107,224
"25984","Zakariyah","M",12,10,22
"25985","Zakariye","M",6,10,16
"25986","Zakary","M",76,51,127
"25987","Zakayla","F",10,21,31
"25988","Zakery","M",16,5,21
"25989","Zakhai","M",5,6,11
"25990","Zakhari","M",6,11,17
"25991","Zakhi","M",29,23,52
"25992","Zaki","M",54,43,97
"25993","Zakia","F",17,17,34
"25994","Zakiah","F",15,10,25
"25995","Zakiah","F",15,14,29
"25996","Zakiah","M",9,9,18
"25997","Zakir","M",37,23,60
"25998","Zakira","F",13,13,26
"25999","Zakiya","F",69,57,126
"26000","Zakiyah","F",76,71,147
"26001","Zakk","M",15,14,29
"26002","Zakkary","M",19,13,32
"26003","Zakya","F",8,8,16
"26004","Zakyah","F",8,6,14
"26005","Zakyia","F",5,6,11
"26006","Zakyra","F",13,8,21
"26007","Zakyrah","F",6,5,11
"26008","Zala","F",9,14,23
"26009","Zalan","M",7,5,12
"26010","Zalaya","F",21,22,43
"26011","Zalayah","F",32,29,61
"26012","Zale","M",8,6,14
"26013","Zalea","F",8,11,19
"26014","Zaleah","F",21,15,36
"26015","Zaleigh","F",16,13,29
"26016","Zalen","M",15,19,34
"26017","Zaley","F",8,7,15
"26018","Zalia","F",22,19,41
"26019","Zaliah","F",16,8,24
"26020","Zalina","F",9,11,20
"26021","Zaliyah","F",43,53,96
"26022","Zalman","M",22,16,38
"26023","Zalmen","M",23,20,43
"26024","Zalynn","F",7,14,21
"26025","Zamani","F",6,5,11
"26026","Zamantha","F",13,7,20
"26027","Zamar","M",22,23,45
"26028","Zamara","F",32,23,55
"26029","Zamari","F",14,27,41
"26030","Zamari","M",98,56,154
"26031","Zamaria","F",35,17,52
"26032","Zamariah","F",12,7,19
"26033","Zamarion","M",50,49,99
"26034","Zamaya","F",35,38,73
"26035","Zamere","M",8,6,14
"26036","Zamia","F",15,14,29
"26037","Zamiah","F",20,20,40
"26038","Zamier","M",8,8,16
"26039","Zamir","M",192,174,366
"26040","Zamira","F",60,34,94
"26041","Zamirah","F",23,30,53
"26042","Zamire","M",7,8,15
"26043","Zamiya","F",24,35,59
"26044","Zamiyah","F",64,58,122
"26045","Zamoni","F",5,5,10
"26046","Zamora","F",54,61,115
"26047","Zamorah","F",7,8,15
"26048","Zamya","F",40,48,88
"26049","Zamyah","F",14,11,25
"26050","Zamyiah","F",6,7,13
"26051","Zamyra","F",12,16,28
"26052","Zamzam","F",20,13,33
"26053","Zana","F",22,31,53
"26054","Zanae","F",9,10,19
"26055","Zanai","F",8,9,17
"26056","Zanaria","F",11,5,16
"26057","Zanaya","F",30,25,55
"26058","Zanayah","F",8,16,24
"26059","Zandaya","F",10,6,16
"26060","Zanden","M",11,6,17
"26061","Zander","M",1453,1380,2833
"26062","Zandon","M",13,8,21
"26063","Zandra","F",10,6,16
"26064","Zandria","F",11,5,16
"26065","Zandyr","M",6,12,18
"26066","Zane","F",12,8,20
"26067","Zane","M",1661,1851,3512
"26068","Zaneta","F",6,10,16
"26069","Zani","F",7,8,15
"26070","Zani","M",11,14,25
"26071","Zania","F",24,19,43
"26072","Zaniah","F",67,50,117
"26073","Zaniel","M",15,14,29
"26074","Zaniya","F",134,100,234
"26075","Zaniyah","F",338,320,658
"26076","Zanna","F",18,23,41
"26077","Zannah","F",10,10,20
"26078","Zanovia","F",10,18,28
"26079","Zanya","F",14,15,29
"26080","Zanyah","F",29,26,55
"26081","Zanyia","F",7,10,17
"26082","Zanyiah","F",20,17,37
"26083","Zanyla","F",18,22,40
"26084","Zanylah","F",14,26,40
"26085","Zaquan","M",8,10,18
"26086","Zara","F",805,1018,1823
"26087","Zarah","F",118,118,236
"26088","Zarai","F",14,16,30
"26089","Zaraiah","F",5,8,13
"26090","Zaraya","F",19,10,29
"26091","Zarayah","F",14,16,30
"26092","Zareen","F",13,21,34
"26093","Zareena","F",6,6,12
"26094","Zarek","M",31,21,52
"26095","Zari","F",42,44,86
"26096","Zaria","F",318,348,666
"26097","Zariah","F",621,711,1332
"26098","Zarian","M",20,14,34
"26099","Zariana","F",12,15,27
"26100","Zarianna","F",21,18,39
"26101","Zarie","F",8,8,16
"26102","Zariel","F",13,10,23
"26103","Zarielle","F",12,20,32
"26104","Zarif","M",8,7,15
"26105","Zarina","F",95,68,163
"26106","Zarion","M",22,13,35
"26107","Zarius","M",12,9,21
"26108","Zariya","F",88,82,170
"26109","Zariyah","F",377,394,771
"26110","Zaron","M",7,7,14
"26111","Zarrah","F",7,12,19
"26112","Zarrar","M",7,6,13
"26113","Zarria","F",9,14,23
"26114","Zarriah","F",17,9,26
"26115","Zarya","F",24,14,38
"26116","Zaryah","F",41,59,100
"26117","Zaryan","M",20,18,38
"26118","Zaryia","F",6,6,12
"26119","Zaryiah","F",24,23,47
"26120","Zatanna","F",6,7,13
"26121","Zaul","M",6,7,13
"26122","Zavannah","F",8,13,21
"26123","Zaveah","F",6,6,12
"26124","Zaven","M",17,22,39
"26125","Zavia","F",5,7,12
"26126","Zavian","M",72,81,153
"26127","Zaviar","M",6,9,15
"26128","Zavien","M",37,43,80
"26129","Zavier","M",260,244,504
"26130","Zavion","M",112,135,247
"26131","Zavior","M",19,13,32
"26132","Zawadi","F",9,10,19
"26133","Zaxton","M",17,30,47
"26134","Zay","M",5,6,11
"26135","Zaya","F",89,181,270
"26136","Zaya","M",8,6,14
"26137","Zayaan","M",16,25,41
"26138","Zayah","F",41,45,86
"26139","Zayan","M",70,72,142
"26140","Zayana","F",21,19,40
"26141","Zayanna","F",16,14,30
"26142","Zayd","M",185,169,354
"26143","Zayda","F",107,100,207
"26144","Zaydah","F",6,6,12
"26145","Zaydan","M",36,51,87
"26146","Zayde","M",27,24,51
"26147","Zaydee","F",27,22,49
"26148","Zayden","F",19,14,33
"26149","Zayden","M",2126,2115,4241
"26150","Zaydenn","M",15,11,26
"26151","Zaydin","M",45,40,85
"26152","Zaydon","M",34,26,60
"26153","Zaydrian","M",19,21,40
"26154","Zaydyn","M",14,21,35
"26155","Zayed","M",30,18,48
"26156","Zayin","M",9,10,19
"26157","Zayla","F",170,186,356
"26158","Zaylah","F",64,51,115
"26159","Zaylan","M",20,18,38
"26160","Zaylani","F",5,13,18
"26161","Zayleah","F",5,5,10
"26162","Zaylee","F",272,349,621
"26163","Zayleen","F",5,11,16
"26164","Zaylei","F",5,11,16
"26165","Zayleigh","F",41,66,107
"26166","Zaylen","F",7,6,13
"26167","Zaylen","M",134,132,266
"26168","Zayley","F",17,24,41
"26169","Zayli","F",15,12,27
"26170","Zaylia","F",9,12,21
"26171","Zaylie","F",48,44,92
"26172","Zaylin","F",16,24,40
"26173","Zaylin","M",31,26,57
"26174","Zaylon","M",23,20,43
"26175","Zaylor","M",5,10,15
"26176","Zaylyn","M",7,8,15
"26177","Zaylynn","F",23,21,44
"26178","Zayn","F",5,7,12
"26179","Zayn","M",406,741,1147
"26180","Zayna","F",82,91,173
"26181","Zaynab","F",133,145,278
"26182","Zaynah","F",44,32,76
"26183","Zayne","F",5,7,12
"26184","Zayne","M",584,686,1270
"26185","Zayneb","F",8,7,15
"26186","Zayon","M",14,10,24
"26187","Zayonna","F",7,7,14
"26188","Zayra","F",40,37,77
"26189","Zayven","M",14,15,29
"26190","Zayveon","M",21,21,42
"26191","Zayvian","M",34,21,55
"26192","Zayvien","M",10,14,24
"26193","Zayvier","M",18,25,43
"26194","Zayvion","M",96,125,221
"26195","Zea","F",10,9,19
"26196","Zeah","F",6,5,11
"26197","Zealand","M",28,23,51
"26198","Zeb","M",16,25,41
"26199","Zebadiah","M",27,18,45
"26200","Zebastian","M",12,8,20
"26201","Zebedee","M",11,10,21
"26202","Zebediah","M",12,20,32
"26203","Zebulon","M",36,24,60
"26204","Zebulun","M",18,19,37
"26205","Zechariah","M",392,322,714
"26206","Zed","M",8,14,22
"26207","Zeddicus","M",9,9,18
"26208","Zedekiah","M",30,32,62
"26209","Zeek","M",20,20,40
"26210","Zeena","F",28,19,47
"26211","Zeenat","F",14,20,34
"26212","Zeeshan","M",20,9,29
"26213","Zeeva","F",10,11,21
"26214","Zehava","F",10,9,19
"26215","Zehra","F",22,20,42
"26216","Zeidy","F",8,7,15
"26217","Zeila","F",6,7,13
"26218","Zein","M",20,25,45
"26219","Zeina","F",35,61,96
"26220","Zeinab","F",30,29,59
"26221","Zekai","M",7,6,13
"26222","Zekariah","M",5,5,10
"26223","Zeke","M",356,394,750
"26224","Zekiah","M",8,11,19
"26225","Zekiel","M",32,27,59
"26226","Zela","F",5,5,10
"26227","Zelda","F",442,420,862
"26228","Zelena","F",19,23,42
"26229","Zelene","F",5,5,10
"26230","Zelia","F",25,22,47
"26231","Zelie","F",50,86,136
"26232","Zelig","M",10,6,16
"26233","Zelina","F",12,13,25
"26234","Zella","F",156,153,309
"26235","Zellie","F",12,11,23
"26236","Zelma","F",13,12,25
"26237","Zema","F",8,10,18
"26238","Zemira","F",23,43,66
"26239","Zemirah","F",35,37,72
"26240","Zemora","F",5,9,14
"26241","Zen","F",23,25,48
"26242","Zen","M",74,73,147
"26243","Zena","F",57,49,106
"26244","Zenaida","F",38,35,73
"26245","Zenaya","F",19,15,34
"26246","Zendaya","F",352,300,652
"26247","Zendayah","F",19,22,41
"26248","Zendeya","F",9,6,15
"26249","Zenia","F",21,24,45
"26250","Zeniah","F",14,21,35
"26251","Zenith","F",9,5,14
"26252","Zenith","M",10,13,23
"26253","Zeniya","F",10,11,21
"26254","Zeniyah","F",20,23,43
"26255","Zenna","F",14,13,27
"26256","Zennia","F",5,5,10
"26257","Zeno","M",23,25,48
"26258","Zenobia","F",42,48,90
"26259","Zenon","M",10,16,26
"26260","Zenovia","F",16,15,31
"26261","Zenya","F",16,9,25
"26262","Zephan","M",23,17,40
"26263","Zephaniah","F",17,28,45
"26264","Zephaniah","M",119,140,259
"26265","Zephora","F",5,7,12
"26266","Zephyr","F",25,20,45
"26267","Zephyr","M",128,124,252
"26268","Zephyra","F",6,6,12
"26269","Zeplin","M",15,12,27
"26270","Zeppelin","F",10,20,30
"26271","Zeppelin","M",70,71,141
"26272","Zepplin","M",5,9,14
"26273","Zera","F",8,10,18
"26274","Zerek","M",5,7,12
"26275","Zerenity","F",29,16,45
"26276","Zeriah","F",15,14,29
"26277","Zerina","F",16,5,21
"26278","Zerrick","M",9,7,16
"26279","Zeta","F",9,10,19
"26280","Zeth","M",26,20,46
"26281","Zethan","M",9,5,14
"26282","Zetta","F",6,15,21
"26283","Zeus","M",116,127,243
"26284","Zev","M",160,157,317
"26285","Zeva","F",19,24,43
"26286","Zeven","M",7,8,15
"26287","Zevi","M",8,6,14
"26288","Zevin","M",7,6,13
"26289","Zeya","F",5,10,15
"26290","Zeyad","M",15,29,44
"26291","Zeyla","F",5,8,13
"26292","Zeyna","F",5,10,15
"26293","Zeynab","F",14,19,33
"26294","Zeynep","F",48,48,96
"26295","Zhaire","M",8,12,20
"26296","Zhane","F",11,14,25
"26297","Zhane","M",16,14,30
"26298","Zhara","F",10,17,27
"26299","Zharia","F",16,14,30
"26300","Zhayden","M",8,12,20
"26301","Zhion","M",12,13,25
"26302","Zhoe","F",12,6,18
"26303","Zhoey","F",5,9,14
"26304","Zhoie","F",6,5,11
"26305","Zhuri","F",32,58,90
"26306","Zhyaire","M",8,8,16
"26307","Zi","M",6,6,12
"26308","Zia","F",130,142,272
"26309","Zia","M",14,9,23
"26310","Ziad","M",36,36,72
"26311","Ziah","F",45,35,80
"26312","Ziah","M",13,8,21
"26313","Ziair","M",6,11,17
"26314","Ziaire","M",21,21,42
"26315","Zian","F",7,6,13
"26316","Zian","M",34,36,70
"26317","Ziana","F",23,33,56
"26318","Zianna","F",25,29,54
"26319","Ziara","F",15,15,30
"26320","Ziare","M",17,17,34
"26321","Zidaan","M",7,11,18
"26322","Zidan","M",34,38,72
"26323","Zidane","M",36,44,80
"26324","Ziggy","M",44,45,89
"26325","Zihan","F",8,7,15
"26326","Zihan","M",5,9,14
"26327","Zihao","M",5,5,10
"26328","Ziheng","M",5,6,11
"26329","Zikora","M",6,9,15
"26330","Zikra","F",5,5,10
"26331","Zilah","F",10,11,21
"26332","Zillah","F",14,17,31
"26333","Zimal","F",12,10,22
"26334","Zimir","M",12,9,21
"26335","Zina","F",25,28,53
"26336","Zinachimdi","F",5,10,15
"26337","Zineb","F",10,9,19
"26338","Zinedine","M",12,11,23
"26339","Ziniyah","F",5,5,10
"26340","Zinnia","F",120,117,237
"26341","Zion","F",307,295,602
"26342","Zion","M",1677,1828,3505
"26343","Ziona","F",27,24,51
"26344","Zionah","F",7,10,17
"26345","Zionna","F",30,29,59
"26346","Zipporah","F",73,70,143
"26347","Zirah","F",5,5,10
"26348","Zissel","F",10,10,20
"26349","Zissy","F",42,22,64
"26350","Zita","F",13,13,26
"26351","Zitlali","F",6,7,13
"26352","Zitlaly","F",9,6,15
"26353","Zitong","F",5,6,11
"26354","Ziv","M",10,7,17
"26355","Ziva","F",140,127,267
"26356","Zivah","F",14,19,33
"26357","Zixuan","F",6,5,11
"26358","Zixuan","M",7,7,14
"26359","Ziya","F",54,95,149
"26360","Ziya","M",7,5,12
"26361","Ziyad","M",58,46,104
"26362","Ziyah","F",55,81,136
"26363","Ziyan","F",13,11,24
"26364","Ziyan","M",11,18,29
"26365","Ziyana","F",19,12,31
"26366","Ziyang","M",6,5,11
"26367","Ziyanna","F",10,13,23
"26368","Ziyon","F",5,13,18
"26369","Ziyon","M",28,32,60
"26370","Ziyonna","F",8,16,24
"26371","Zizi","F",5,5,10
"26372","Zlata","F",28,25,53
"26373","Zlatan","M",16,25,41
"26374","Zlaty","F",6,5,11
"26375","Zniyah","F",8,8,16
"26376","Zo","F",14,18,32
"26377","Zoa","F",8,5,13
"26378","Zoe","F",6032,5706,11738
"26379","Zoe","M",15,14,29
"26380","Zoee","F",66,90,156
"26381","Zoeh","F",10,10,20
"26382","Zoei","F",34,46,80
"26383","Zoeigh","F",8,5,13
"26384","Zoejane","F",8,8,16
"26385","Zoel","F",6,6,12
"26386","Zoel","M",5,5,10
"26387","Zoella","F",20,20,40
"26388","Zoelle","F",37,54,91
"26389","Zoey","F",6927,6414,13341
"26390","Zofia","F",62,87,149
"26391","Zoha","F",42,42,84
"26392","Zohaib","M",13,18,31
"26393","Zohair","M",7,7,14
"26394","Zohan","M",10,26,36
"26395","Zohar","F",14,9,23
"26396","Zohara","F",5,5,10
"26397","Zohra","F",8,13,21
"26398","Zoi","F",35,37,72
"26399","Zoie","F",370,311,681
"26400","Zoiee","F",6,15,21
"26401","Zoiey","F",9,14,23
"26402","Zoii","F",14,9,23
"26403","Zoila","F",22,17,39
"26404","Zola","F",129,185,314
"26405","Zolah","F",6,8,14
"26406","Zolie","F",5,9,14
"26407","Zoltan","M",15,16,31
"26408","Zolton","M",5,5,10
"26409","Zona","F",6,9,15
"26410","Zooey","F",79,59,138
"26411","Zophia","F",44,35,79
"26412","Zora","F",139,163,302
"26413","Zorah","F",12,13,25
"26414","Zoraida","F",13,9,22
"26415","Zoraiz","M",9,7,16
"26416","Zorawar","M",8,18,26
"26417","Zoraya","F",20,22,42
"26418","Zori","F",38,41,79
"26419","Zoria","F",11,10,21
"26420","Zoriah","F",27,33,60
"26421","Zorian","M",19,11,30
"26422","Zoriana","F",8,7,15
"26423","Zorianna","F",5,8,13
"26424","Zorie","F",10,10,20
"26425","Zorina","F",5,6,11
"26426","Zorion","M",10,9,19
"26427","Zosia","F",17,19,36
"26428","Zowie","F",23,24,47
"26429","Zoya","F",173,218,391
"26430","Zriyah","F",5,9,14
"26431","Zsazsa","F",6,8,14
"26432","Zsofia","F",6,6,12
"26433","Zubair","M",27,24,51
"26434","Zubayr","M",16,15,31
"26435","Zubin","M",8,7,15
"26436","Zuhair","M",11,8,19
"26437","Zulay","F",16,23,39
"26438","Zuleica","F",6,7,13
"26439","Zuleika","F",21,25,46
"26440","Zuleima","F",6,10,16
"26441","Zuleimy","F",5,8,13
"26442","Zulema","F",38,37,75
"26443","Zuley","F",14,6,20
"26444","Zuleyka","F",126,103,229
"26445","Zuleyma","F",19,22,41
"26446","Zully","F",14,17,31
"26447","Zuly","F",22,15,37
"26448","Zunaira","F",22,19,41
"26449","Zunairah","F",20,29,49
"26450","Zuree","F",9,5,14
"26451","Zuri","F",712,884,1596
"26452","Zuri","M",15,12,27
"26453","Zuria","F",41,37,78
"26454","Zuriah","F",18,20,38
"26455","Zurich","M",6,5,11
"26456","Zurie","F",23,29,52
"26457","Zuriel","F",19,27,46
"26458","Zuriel","M",56,59,115
"26459","Zurii","F",7,13,20
"26460","Zurisadai","F",19,24,43
"26461","Zuriya","F",5,5,10
"26462","Zuriyah","F",16,9,25
"26463","Zurri","F",8,10,18
"26464","Zury","F",35,30,65
"26465","Zuzanna","F",26,30,56
"26466","Zuzu","F",20,16,36
"26467","Zvi","M",7,13,20
"26468","Zya","F",54,62,116
"26469","Zyad","M",11,7,18
"26470","Zyah","F",15,22,37
"26471","Zyah","M",5,6,11
"26472","Zyair","F",7,7,14
"26473","Zyair","M",64,69,133
"26474","Zyaira","F",6,10,16
"26475","Zyairah","F",8,7,15
"26476","Zyaire","F",23,24,47
"26477","Zyaire","M",190,245,435
"26478","Zyan","F",10,15,25
"26479","Zyan","M",54,74,128
"26480","Zyana","F",87,101,188
"26481","Zyann","F",9,9,18
"26482","Zyanna","F",49,39,88
"26483","Zyannah","F",7,5,12
"26484","Zyanya","F",17,28,45
"26485","Zyasia","F",22,27,49
"26486","Zyden","M",10,13,23
"26487","Zyeir","M",9,9,18
"26488","Zyelle","F",6,9,15
"26489","Zyere","M",15,7,22
"26490","Zyheir","M",10,13,23
"26491","Zyhir","M",11,16,27
"26492","Zyia","F",9,6,15
"26493","Zyiah","F",10,15,25
"26494","Zyier","M",19,20,39
"26495","Zyiere","M",9,7,16
"26496","Zyion","F",7,13,20
"26497","Zyion","M",67,75,142
"26498","Zyionna","F",6,6,12
"26499","Zyir","M",36,40,76
"26500","Zyire","M",24,19,43
"26501","Zykeem","M",8,7,15
"26502","Zykeria","F",10,13,23
"26503","Zyking","M",5,11,16
"26504","Zyla","F",97,100,197
"26505","Zylah","F",55,75,130
"26506","Zylan","M",34,36,70
"26507","Zylar","M",10,6,16
"26508","Zyleah","F",5,12,17
"26509","Zylee","F",13,14,27
"26510","Zyleigh","F",6,6,12
"26511","Zylen","M",71,49,120
"26512","Zyler","M",96,95,191
"26513","Zylie","F",12,10,22
"26514","Zylin","M",9,6,15
"26515","Zylon","M",12,8,20
"26516","Zymarion","M",7,8,15
"26517","Zymeir","M",6,13,19
"26518","Zymere","M",26,25,51
"26519","Zymiah","F",6,5,11
"26520","Zymier","M",10,12,22
"26521","Zymir","M",73,57,130
"26522","Zymire","M",9,9,18
"26523","Zyniah","F",14,6,20
"26524","Zyon","F",29,39,68
"26525","Zyon","M",147,182,329
"26526","Zyonna","F",30,34,64
"26527","Zyquan","M",8,6,14
"26528","Zyra","F",54,38,92
"26529","Zyrah","F",14,14,28
"26530","Zyree","M",8,8,16
"26531","Zyrell","M",11,9,20
"26532","Zyren","M",9,10,19
"26533","Zyria","F",6,11,17
"26534","Zyriah","F",27,24,51
"26535","Zyrion","M",7,8,15
"26536","Zyron","M",15,12,27
"26537","Zyrus","M",5,6,11
